Name,Year,Total_sum,Female_count,Male_count,Female_percentage,Male_percentage,Gender
YVONE,1908,14,14,0,100.0,0.0,Female
ROGATIENNE,1908,4,4,0,100.0,0.0,Female
JEANE,1908,4,4,0,100.0,0.0,Female
ADÈLE,1908,637,637,0,100.0,0.0,Female
BERTRAND,1908,102,0,102,0.0,100.0,Male
YVAN,1908,68,0,68,0.0,100.0,Male
FRANCK,1908,51,0,51,0.0,100.0,Male
ALEXIS,1908,480,0,480,0.0,100.0,Male
OPTAT,1908,203,61,142,30.049261083743843,69.95073891625616,Unisex
EUSTACHE,1908,1376,277,1099,20.13081395348837,79.86918604651163,Unisex
ALIX,1908,37305,28371,8934,76.05146763168477,23.94853236831524,Unisex
TIMOLEON,1908,481,101,380,20.997920997921,79.002079002079,Unisex
NADIA,1909,15,15,0,100.0,0.0,Female
TOSCA,1909,3,3,0,100.0,0.0,Female
DOLLY,1909,3,3,0,100.0,0.0,Female
RUFFINE,1909,4,4,0,100.0,0.0,Female
NICEPHORE,1909,3,0,3,0.0,100.0,Male
VERAN,1909,3,0,3,0.0,100.0,Male
JUVENAL,1909,4,0,4,0.0,100.0,Male
NELLO,1909,7,0,7,0.0,100.0,Male
APPOLINAIRE,1909,632,126,506,19.93670886075949,80.0632911392405,Unisex
CAMILLE,1909,287709,207732,79977,72.20212089298562,27.79787910701437,Unisex
DOMINIQUE,1909,409989,168027,241962,40.98329467375954,59.01670532624046,Unisex
SEPTIME,1909,394,119,275,30.20304568527919,69.79695431472082,Unisex
LOUISIANE,1910,3,3,0,100.0,0.0,Female
ALDEGONDE,1910,6,6,0,100.0,0.0,Female
SARAH,1910,59,59,0,100.0,0.0,Female
LEONCIA,1910,14,14,0,100.0,0.0,Female
ALBERIC,1910,31,0,31,0.0,100.0,Male
AMBROISE,1910,103,0,103,0.0,100.0,Male
CONRAD,1910,15,0,15,0.0,100.0,Male
HILARION,1910,820,111,709,13.53658536585366,86.46341463414635,Male
EUSEBE,1910,1151,212,939,18.41876629018245,81.58123370981755,Unisex
CAMILLE,1910,287709,207732,79977,72.20212089298562,27.79787910701437,Unisex
SERVAIS,1910,812,150,662,18.47290640394089,81.5270935960591,Unisex
HYACINTHE,1910,4679,1173,3506,25.069459286172258,74.93054071382774,Unisex
HERTA,1911,12,12,0,100.0,0.0,Female
GILLETTE,1911,31,31,0,100.0,0.0,Female
PETRONILLE,1911,1350,1230,120,91.11111111111111,8.88888888888889,Female
REMISE,1911,3,3,0,100.0,0.0,Female
GHISLAIN,1911,9,0,9,0.0,100.0,Male
MICHEL,1911,1285,0,1285,0.0,100.0,Male
MARC,1911,238188,261,237927,0.109577308680538,99.89042269131946,Male
ALLAIN,1911,18,0,18,0.0,100.0,Male
ALIX,1911,37305,28371,8934,76.05146763168477,23.94853236831524,Unisex
SULPICE,1911,508,182,326,35.826771653543304,64.1732283464567,Unisex
IRENEE,1911,6155,1854,4301,30.121852152721363,69.87814784727864,Unisex
DOMINIQUE,1911,409989,168027,241962,40.98329467375954,59.01670532624046,Unisex
MAURICETTE,1912,187,187,0,100.0,0.0,Female
PERRINE,1912,41,41,0,100.0,0.0,Female
ELDA,1912,3,3,0,100.0,0.0,Female
OLIVIA,1912,25,25,0,100.0,0.0,Female
EVARISTE,1912,28,0,28,0.0,100.0,Male
HELMUT,1912,13,0,13,0.0,100.0,Male
GONTRAN,1912,25,0,25,0.0,100.0,Male
RODOLPHE,1912,106,0,106,0.0,100.0,Male
ANTONIE,1912,986,749,237,75.9634888438134,24.036511156186613,Unisex
SCHOLASTIQUE,1912,1080,835,245,77.31481481481481,22.685185185185187,Unisex
MEDARD,1912,1076,175,901,16.263940520446095,83.7360594795539,Unisex
CALIXTE,1912,3347,540,2807,16.13385121003884,83.86614878996116,Unisex
ANGELA,1913,28,28,0,100.0,0.0,Female
MARIETTA,1913,5,5,0,100.0,0.0,Female
OBELINE,1913,4,4,0,100.0,0.0,Female
CELIANE,1913,4,4,0,100.0,0.0,Female
JOANNY,1913,81,0,81,0.0,100.0,Male
TRANQUILLE,1913,4,0,4,0.0,100.0,Male
HERBERT,1913,23,0,23,0.0,100.0,Male
CYPRIEN,1913,86,0,86,0.0,100.0,Male
MARIE-JOSEPH,1913,2275,1830,445,80.43956043956044,19.56043956043956,Unisex
ALIX,1913,37305,28371,8934,76.05146763168477,23.94853236831524,Unisex
NONCE,1913,598,172,426,28.762541806020064,71.23745819397993,Unisex
SCHOLASTIQUE,1913,1080,835,245,77.31481481481481,22.685185185185187,Unisex
ROBERTE,1914,126,126,0,100.0,0.0,Female
EDMEE,1914,107,107,0,100.0,0.0,Female
JEANNETTE,1914,109,109,0,100.0,0.0,Female
LUCINE,1914,10,10,0,100.0,0.0,Female
IRMIN,1914,3,0,3,0.0,100.0,Male
MAXIMIN,1914,62,0,62,0.0,100.0,Male
ANGELO,1914,24,0,24,0.0,100.0,Male
JOACHIN,1914,6,0,6,0.0,100.0,Male
LEONIDE,1914,1588,1245,343,78.40050377833752,21.599496221662463,Unisex
CRESCENT,1914,447,87,360,19.463087248322147,80.53691275167785,Unisex
ALIX,1914,37305,28371,8934,76.05146763168477,23.94853236831524,Unisex
NONCE,1914,598,172,426,28.762541806020064,71.23745819397993,Unisex
MARCELINE,1915,120,120,0,100.0,0.0,Female
AGATHE,1915,56,56,0,100.0,0.0,Female
SUZANE,1915,9,9,0,100.0,0.0,Female
ROLLANDE,1915,32,32,0,100.0,0.0,Female
CLET,1915,12,0,12,0.0,100.0,Male
LIN,1915,3,0,3,0.0,100.0,Male
SILVERE,1915,7,0,7,0.0,100.0,Male
GASTON,1915,93849,147,93702,0.1566345938688744,99.84336540613111,Male
HYACINTHE,1915,4679,1173,3506,25.069459286172258,74.93054071382774,Unisex
SAINTE,1915,1055,648,407,61.4218009478673,38.5781990521327,Unisex
SABAS,1915,607,220,387,36.24382207578254,63.75617792421746,Unisex
GEORGE,1915,2417,650,1767,26.89284236657013,73.10715763342988,Unisex
MARIE-HÉLÈNE,1916,5,5,0,100.0,0.0,Female
MODESTINE,1916,3,3,0,100.0,0.0,Female
ANASTASIE,1916,42,42,0,100.0,0.0,Female
LINA,1916,122,122,0,100.0,0.0,Female
BERNADIN,1916,4,0,4,0.0,100.0,Male
NICOMEDE,1916,7,0,7,0.0,100.0,Male
ERWIN,1916,22,0,22,0.0,100.0,Male
DANIEL,1916,365,0,365,0.0,100.0,Male
EUSEBE,1916,1151,212,939,18.41876629018245,81.58123370981755,Unisex
SABAS,1916,607,220,387,36.24382207578254,63.75617792421746,Unisex
SERVAIS,1916,812,150,662,18.47290640394089,81.5270935960591,Unisex
GEORGE,1916,2417,650,1767,26.89284236657013,73.10715763342988,Unisex
EMILIENNE,1917,951,951,0,100.0,0.0,Female
NOELISE,1917,6,6,0,100.0,0.0,Female
GISLAINE,1917,7,7,0,100.0,0.0,Female
AMÉLIE,1917,98201,98078,123,99.8747466930072,0.1252533069928005,Female
PARFAIT,1917,985,94,891,9.543147208121828,90.45685279187818,Male
JAIME,1917,3,0,3,0.0,100.0,Male
FIACRE,1917,9,0,9,0.0,100.0,Male
MARCEL,1917,6423,0,6423,0.0,100.0,Male
CREPIN,1917,606,136,470,22.44224422442244,77.55775577557755,Unisex
PLACIDE,1917,1098,214,884,19.489981785063755,80.51001821493625,Unisex
HONORAT,1917,652,270,382,41.41104294478527,58.58895705521472,Unisex
MARY,1917,6861,5830,1031,84.97303600058301,15.026963999416996,Unisex
GRATIANNE,1918,4,4,0,100.0,0.0,Female
JUSTINA,1918,15,15,0,100.0,0.0,Female
LIDIE,1918,4,4,0,100.0,0.0,Female
IRMGARD,1918,6,6,0,100.0,0.0,Female
RAPHAËL,1918,162,0,162,0.0,100.0,Male
VALERY,1918,5530,696,4834,12.585895117540687,87.41410488245931,Male
BERTIN,1918,26,0,26,0.0,100.0,Male
THEOPHILE,1918,151,0,151,0.0,100.0,Male
FIDELE,1918,793,162,631,20.42875157629256,79.57124842370744,Unisex
MAURILLE,1918,834,214,620,25.65947242206235,74.34052757793765,Unisex
FRUCTUEUX,1918,176,33,143,18.75,81.25,Unisex
ANDOCHE,1918,390,140,250,35.8974358974359,64.1025641025641,Unisex
IVETTE,1919,7,7,0,100.0,0.0,Female
ITALIA,1919,5,5,0,100.0,0.0,Female
LUCRECE,1919,8,8,0,100.0,0.0,Female
MARIE-AUGUSTINE,1919,4,4,0,100.0,0.0,Female
SYLVERE,1919,11,0,11,0.0,100.0,Male
FIRMIN,1919,130,0,130,0.0,100.0,Male
FRÉDÉRIC,1919,248,0,248,0.0,100.0,Male
ANASTASE,1919,7,0,7,0.0,100.0,Male
PLACIDE,1919,1098,214,884,19.489981785063755,80.51001821493625,Unisex
GEORGE,1919,2417,650,1767,26.89284236657013,73.10715763342988,Unisex
MAURILLE,1919,834,214,620,25.65947242206235,74.34052757793765,Unisex
APPOLINAIRE,1919,632,126,506,19.93670886075949,80.0632911392405,Unisex
ELAINE,1920,6,6,0,100.0,0.0,Female
ELIZA,1920,4,4,0,100.0,0.0,Female
SYLVAINE,1920,19,19,0,100.0,0.0,Female
MUGUETTE,1920,39,39,0,100.0,0.0,Female
GINES,1920,3,0,3,0.0,100.0,Male
JOSSE,1920,5,0,5,0.0,100.0,Male
DON,1920,31,0,31,0.0,100.0,Male
HOMERE,1920,11,0,11,0.0,100.0,Male
SEPTIME,1920,394,119,275,30.20304568527919,69.79695431472082,Unisex
CARMEL,1920,409,197,212,48.16625916870416,51.83374083129584,Unisex
CALIXTE,1920,3347,540,2807,16.13385121003884,83.86614878996116,Unisex
SULPICE,1920,508,182,326,35.826771653543304,64.1732283464567,Unisex
HORTENSE,1921,154,154,0,100.0,0.0,Female
ANNA,1921,1482,1482,0,100.0,0.0,Female
CHRISTINE,1921,92,92,0,100.0,0.0,Female
MADELEINE,1921,9449,9449,0,100.0,0.0,Female
DÉSIRÉ,1921,459,0,459,0.0,100.0,Male
MARTIAL,1921,295,0,295,0.0,100.0,Male
ARSENE,1921,15051,1013,14038,6.730449803999735,93.26955019600028,Male
RENAUD,1921,16,0,16,0.0,100.0,Male
DOMINIQUE,1921,409989,168027,241962,40.98329467375954,59.01670532624046,Unisex
SERVAIS,1921,812,150,662,18.47290640394089,81.5270935960591,Unisex
BONIFACE,1921,1187,217,970,18.28138163437237,81.71861836562763,Unisex
ANDOCHE,1921,390,140,250,35.8974358974359,64.1025641025641,Unisex
ZULMA,1922,24,24,0,100.0,0.0,Female
BENOITE,1922,27,27,0,100.0,0.0,Female
ASSOMPTION,1922,10,10,0,100.0,0.0,Female
COLETTE,1922,175111,174975,136,99.92233497610088,0.0776650238991268,Female
FLEURY,1922,23,0,23,0.0,100.0,Male
LIE,1922,4,0,4,0.0,100.0,Male
WILFRID,1922,23,0,23,0.0,100.0,Male
JEAN-RAYMOND,1922,3,0,3,0.0,100.0,Male
THIMOTHEE,1922,509,100,409,19.64636542239685,80.35363457760315,Unisex
MAURILLE,1922,834,214,620,25.65947242206235,74.34052757793765,Unisex
ANTONIE,1922,986,749,237,75.9634888438134,24.036511156186613,Unisex
HYACINTHE,1922,4679,1173,3506,25.069459286172258,74.93054071382774,Unisex
MARCELLA,1923,12,12,0,100.0,0.0,Female
EUPHEMIE,1923,5,5,0,100.0,0.0,Female
MINNA,1923,6,6,0,100.0,0.0,Female
JUANA,1923,5,5,0,100.0,0.0,Female
SERGE,1923,219424,285,219139,0.129885518448301,99.8701144815517,Male
PARFAIT,1923,12,0,12,0.0,100.0,Male
KLÉBER,1923,4,0,4,0.0,100.0,Male
PASCAL,1923,174,0,174,0.0,100.0,Male
AMOUR,1923,782,287,495,36.70076726342711,63.29923273657288,Unisex
APPOLINAIRE,1923,632,126,506,19.93670886075949,80.0632911392405,Unisex
MAURILLE,1923,834,214,620,25.65947242206235,74.34052757793765,Unisex
HONORAT,1923,652,270,382,41.41104294478527,58.58895705521472,Unisex
GASTONIA,1924,3,3,0,100.0,0.0,Female
IOLANDA,1924,5,5,0,100.0,0.0,Female
NINA,1924,12,12,0,100.0,0.0,Female
JEANETTE,1924,6,6,0,100.0,0.0,Female
FAUSTIN,1924,28,0,28,0.0,100.0,Male
JULIO,1924,8,0,8,0.0,100.0,Male
LUCET,1924,3,0,3,0.0,100.0,Male
SAINT-JEAN,1924,6,0,6,0.0,100.0,Male
HONORAT,1924,652,270,382,41.41104294478527,58.58895705521472,Unisex
LEU,1924,169,27,142,15.976331360946746,84.02366863905326,Unisex
BONIFACE,1924,1187,217,970,18.28138163437237,81.71861836562763,Unisex
GODFROY,1924,277,69,208,24.90974729241877,75.09025270758123,Unisex
CHANTAL,1925,71,71,0,100.0,0.0,Female
MARDAYE,1925,4,4,0,100.0,0.0,Female
CLADIE,1925,11,11,0,100.0,0.0,Female
ADELAIDE,1925,9937,9668,269,97.29294555700916,2.7070544429908425,Female
ALEX,1925,25,0,25,0.0,100.0,Male
WACLAW,1925,12,0,12,0.0,100.0,Male
LUDWIG,1925,6,0,6,0.0,100.0,Male
EGIDIO,1925,15,0,15,0.0,100.0,Male
FIACRE,1925,253,59,194,23.3201581027668,76.6798418972332,Unisex
PULCHERIE,1925,738,579,159,78.45528455284553,21.54471544715448,Unisex
SERVAIS,1925,812,150,662,18.47290640394089,81.5270935960591,Unisex
CREPIN,1925,606,136,470,22.44224422442244,77.55775577557755,Unisex
DORA,1926,19,19,0,100.0,0.0,Female
SALOMÉ,1926,26,26,0,100.0,0.0,Female
MIECZYSLAWA,1926,4,4,0,100.0,0.0,Female
VINCENZINA,1926,3,3,0,100.0,0.0,Female
AIMABLE,1926,33,0,33,0.0,100.0,Male
JOËL,1926,34,0,34,0.0,100.0,Male
ERICH,1926,11,0,11,0.0,100.0,Male
JACQUY,1926,4,0,4,0.0,100.0,Male
JANY,1926,3897,2256,1641,57.89068514241724,42.10931485758276,Unisex
PULCHERIE,1926,738,579,159,78.45528455284553,21.54471544715448,Unisex
AVIT,1926,485,106,379,21.855670103092784,78.14432989690722,Unisex
TIBURCE,1926,1019,212,807,20.80471050049068,79.19528949950933,Unisex
EDMONDE,1927,117,117,0,100.0,0.0,Female
LUCIANE,1927,5,5,0,100.0,0.0,Female
ELIDE,1927,4,4,0,100.0,0.0,Female
ODA,1927,3,3,0,100.0,0.0,Female
WLADYSLAS,1927,5,0,5,0.0,100.0,Male
ARMEL,1927,38,0,38,0.0,100.0,Male
CECIL,1927,3,0,3,0.0,100.0,Male
OLIVO,1927,3,0,3,0.0,100.0,Male
CALIXTE,1927,3347,540,2807,16.13385121003884,83.86614878996116,Unisex
AMOUR,1927,782,287,495,36.70076726342711,63.29923273657288,Unisex
ALIX,1927,37305,28371,8934,76.05146763168477,23.94853236831524,Unisex
CREPIN,1927,606,136,470,22.44224422442244,77.55775577557755,Unisex
CLEMENCIA,1928,4,4,0,100.0,0.0,Female
INÈS,1928,115,115,0,100.0,0.0,Female
APPOLONIE,1928,8,8,0,100.0,0.0,Female
ALEXINE,1928,13,13,0,100.0,0.0,Female
NICOLAS,1928,406002,279,405723,0.0687188733060428,99.93128112669396,Male
ARMEL,1928,40,0,40,0.0,100.0,Male
SYLVIO,1928,11,0,11,0.0,100.0,Male
OCTAVE,1928,107,0,107,0.0,100.0,Male
JANY,1928,3897,2256,1641,57.89068514241724,42.10931485758276,Unisex
EUSTASE,1928,347,116,231,33.429394812680115,66.57060518731988,Unisex
SULPICE,1928,508,182,326,35.826771653543304,64.1732283464567,Unisex
SABAS,1928,607,220,387,36.24382207578254,63.75617792421746,Unisex
ENNA,1929,3,3,0,100.0,0.0,Female
LYDIA,1929,116,116,0,100.0,0.0,Female
THÉRÈSE,1929,5224,5224,0,100.0,0.0,Female
HELIETTE,1929,16,16,0,100.0,0.0,Female
FRANCO,1929,23,0,23,0.0,100.0,Male
ARMANDO,1929,18,0,18,0.0,100.0,Male
JEAN-MICHEL,1929,17,0,17,0.0,100.0,Male
GUILLERMO,1929,3,0,3,0.0,100.0,Male
MODESTE,1929,1853,656,1197,35.4020507285483,64.59794927145171,Unisex
MESMIN,1929,773,183,590,23.67399741267788,76.32600258732212,Unisex
CANDIDE,1929,1019,686,333,67.32090284592738,32.67909715407262,Unisex
LEONCE,1929,9290,2041,7249,21.96986006458557,78.03013993541443,Unisex
JULIANNA,1930,3,3,0,100.0,0.0,Female
ALFREDA,1930,155,155,0,100.0,0.0,Female
CLELIA,1930,8,8,0,100.0,0.0,Female
BIANCA,1930,5,5,0,100.0,0.0,Female
ALFRED,1930,1096,0,1096,0.0,100.0,Male
VICTORIN,1930,20,0,20,0.0,100.0,Male
SENATEUR,1930,4,0,4,0.0,100.0,Male
VIRGILIO,1930,4,0,4,0.0,100.0,Male
ALIX,1930,37305,28371,8934,76.05146763168477,23.94853236831524,Unisex
MESMIN,1930,773,183,590,23.67399741267788,76.32600258732212,Unisex
AGNAN,1930,455,124,331,27.25274725274725,72.74725274725274,Unisex
ANTONIE,1930,986,749,237,75.9634888438134,24.036511156186613,Unisex
JOZEFA,1931,6,6,0,100.0,0.0,Female
GODELIEVE,1931,4,4,0,100.0,0.0,Female
MARIE-CLAUDE,1931,64,64,0,100.0,0.0,Female
MARYSE,1931,464,464,0,100.0,0.0,Female
ALLAIN,1931,35,0,35,0.0,100.0,Male
ALBAN,1931,28411,92,28319,0.3238182394143113,99.67618176058568,Male
MARCEL,1931,10191,0,10191,0.0,100.0,Male
SANTOS,1931,3,0,3,0.0,100.0,Male
HONORAT,1931,652,270,382,41.41104294478527,58.58895705521472,Unisex
LIE,1931,328,80,248,24.390243902439025,75.60975609756098,Unisex
GABY,1931,4741,2448,2293,51.63467622864375,48.36532377135626,Unisex
EUTROPE,1931,194,70,124,36.08247422680412,63.91752577319587,Unisex
EMMA,1932,225,225,0,100.0,0.0,Female
NOELINE,1932,8,8,0,100.0,0.0,Female
MARIE-AGNÈS,1932,4,4,0,100.0,0.0,Female
EDITHE,1932,60,60,0,100.0,0.0,Female
SALVATORE,1932,9,0,9,0.0,100.0,Male
PAULIN,1932,17,0,17,0.0,100.0,Male
JACQUE,1932,5,0,5,0.0,100.0,Male
TADENSZ,1932,5,0,5,0.0,100.0,Male
MODESTE,1932,1853,656,1197,35.4020507285483,64.59794927145171,Unisex
PHILOGONE,1932,396,183,213,46.21212121212121,53.78787878787878,Unisex
JEANNY,1932,968,718,250,74.17355371900827,25.82644628099173,Unisex
ANTONIE,1932,986,749,237,75.9634888438134,24.036511156186613,Unisex
GIZELLE,1933,4,4,0,100.0,0.0,Female
ALBINA,1933,13,13,0,100.0,0.0,Female
JOËLLE,1933,77,77,0,100.0,0.0,Female
JUDITH,1933,25,25,0,100.0,0.0,Female
ISRAEL,1933,6,0,6,0.0,100.0,Male
DAUPHIN,1933,3,0,3,0.0,100.0,Male
SOSTHENES,1933,5,0,5,0.0,100.0,Male
SALVADOR,1933,19,0,19,0.0,100.0,Male
ALIX,1933,37305,28371,8934,76.05146763168477,23.94853236831524,Unisex
MAURILLE,1933,834,214,620,25.65947242206235,74.34052757793765,Unisex
MARY,1933,6861,5830,1031,84.97303600058301,15.026963999416996,Unisex
EUSTASE,1933,347,116,231,33.429394812680115,66.57060518731988,Unisex
JOSEPHA,1934,45,45,0,100.0,0.0,Female
BEATRIX,1934,31,31,0,100.0,0.0,Female
ESTHER,1934,68,68,0,100.0,0.0,Female
ZENONA,1934,3,3,0,100.0,0.0,Female
AUBERT,1934,5,0,5,0.0,100.0,Male
AME,1934,3,0,3,0.0,100.0,Male
AURÉLIEN,1934,26,0,26,0.0,100.0,Male
ALEXIS,1934,238,0,238,0.0,100.0,Male
GABY,1934,4741,2448,2293,51.63467622864375,48.36532377135626,Unisex
SOSTHENE,1934,1059,185,874,17.469310670443818,82.53068932955618,Unisex
ATTALE,1934,80,27,53,33.75,66.25,Unisex
ALIX,1934,37305,28371,8934,76.05146763168477,23.94853236831524,Unisex
EGLANTINE,1935,15,15,0,100.0,0.0,Female
NICOLETTE,1935,11,11,0,100.0,0.0,Female
DOMINICA,1935,15,15,0,100.0,0.0,Female
BELLA,1935,4,4,0,100.0,0.0,Female
THÉODORE,1935,5,0,5,0.0,100.0,Male
ZYGMUNT,1935,20,0,20,0.0,100.0,Male
YVAN,1935,247,0,247,0.0,100.0,Male
ALOIS,1935,4,0,4,0.0,100.0,Male
AUBIERGE,1935,193,125,68,64.76683937823834,35.233160621761655,Unisex
MODERAN,1935,258,58,200,22.48062015503876,77.51937984496125,Unisex
_PRENOMS_RARES,1935,1760252,908578,851674,51.616359475802334,48.38364052419767,Unisex
SCHOLASTIQUE,1935,1080,835,245,77.31481481481481,22.685185185185187,Unisex
GRACY,1936,3,3,0,100.0,0.0,Female
ALBINE,1936,17,17,0,100.0,0.0,Female
LISIANE,1936,16,16,0,100.0,0.0,Female
NOËLLA,1936,3,3,0,100.0,0.0,Female
TONY,1936,15,0,15,0.0,100.0,Male
MATHURIN,1936,36,0,36,0.0,100.0,Male
JEAN-MARIE,1936,481,0,481,0.0,100.0,Male
RENZO,1936,4,0,4,0.0,100.0,Male
JANY,1936,3897,2256,1641,57.89068514241724,42.10931485758276,Unisex
EUSTACHE,1936,1376,277,1099,20.13081395348837,79.86918604651163,Unisex
ATTALE,1936,80,27,53,33.75,66.25,Unisex
MARIE-JOSEPH,1936,2275,1830,445,80.43956043956044,19.56043956043956,Unisex
FELICIANNE,1937,3,3,0,100.0,0.0,Female
PRISCA,1937,4616,4399,217,95.29896013864818,4.70103986135182,Female
FLORE,1937,22,22,0,100.0,0.0,Female
CELESTE,1937,6500,5947,553,91.49230769230768,8.507692307692308,Female
SAINT-MARTIN,1937,5,0,5,0.0,100.0,Male
REGINALD,1937,3,0,3,0.0,100.0,Male
OTHON,1937,6,0,6,0.0,100.0,Male
ADAM,1937,15,0,15,0.0,100.0,Male
SOCRATE,1937,378,96,282,25.396825396825395,74.60317460317461,Unisex
FAUSTE,1937,179,86,93,48.04469273743017,51.95530726256983,Unisex
IRENEE,1937,6155,1854,4301,30.121852152721363,69.87814784727864,Unisex
EUTROPE,1937,194,70,124,36.08247422680412,63.91752577319587,Unisex
EVELINE,1938,355,355,0,100.0,0.0,Female
EMMY,1938,9,9,0,100.0,0.0,Female
CONCEPTION,1938,12,12,0,100.0,0.0,Female
JUDITH,1938,25,25,0,100.0,0.0,Female
OCTAVE,1938,46,0,46,0.0,100.0,Male
ANSELME,1938,4091,343,3748,8.384258127597164,91.61574187240284,Male
EGON,1938,3,0,3,0.0,100.0,Male
CZESLAW,1938,40,0,40,0.0,100.0,Male
ANDOCHE,1938,390,140,250,35.8974358974359,64.1025641025641,Unisex
AMOUR,1938,782,287,495,36.70076726342711,63.29923273657288,Unisex
MODESTE,1938,1853,656,1197,35.4020507285483,64.59794927145171,Unisex
GODFROY,1938,277,69,208,24.90974729241877,75.09025270758123,Unisex
ANGELINE,1939,31,31,0,100.0,0.0,Female
EMILIENNE,1939,396,396,0,100.0,0.0,Female
GASTONIA,1939,3,3,0,100.0,0.0,Female
JEANNE-MARIE,1939,22,22,0,100.0,0.0,Female
SYLVIAN,1939,4,0,4,0.0,100.0,Male
EUGENIUSZ,1939,3,0,3,0.0,100.0,Male
SÉBASTIEN,1939,304173,122,304051,0.0401087538999187,99.95989124610009,Male
WLADISLAW,1939,11,0,11,0.0,100.0,Male
HONORAT,1939,652,270,382,41.41104294478527,58.58895705521472,Unisex
HYACINTHE,1939,4679,1173,3506,25.069459286172258,74.93054071382774,Unisex
WENCESLAS,1939,877,175,702,19.95438996579248,80.04561003420753,Unisex
NICOMEDE,1939,430,193,237,44.88372093023256,55.11627906976744,Unisex
ANNE,1940,364561,364227,334,99.9083829592304,0.0916170407695831,Female
EVELYNE,1940,627,627,0,100.0,0.0,Female
EDOUARLISE,1940,4,4,0,100.0,0.0,Female
AMÉLIE,1940,98201,98078,123,99.8747466930072,0.1252533069928005,Female
SATURNIN,1940,12,0,12,0.0,100.0,Male
JAKY,1940,25,0,25,0.0,100.0,Male
GUISEPPE,1940,4,0,4,0.0,100.0,Male
RENÉ,1940,516630,397,516233,0.0768441631341579,99.92315583686585,Male
GODFROY,1940,277,69,208,24.90974729241877,75.09025270758123,Unisex
CAMILLE,1940,287709,207732,79977,72.20212089298562,27.79787910701437,Unisex
CLAUDY,1940,2240,835,1405,37.27678571428572,62.72321428571429,Unisex
GEORGE,1940,2417,650,1767,26.89284236657013,73.10715763342988,Unisex
ANIQUE,1941,5,5,0,100.0,0.0,Female
MADELEINE,1941,2615,2615,0,100.0,0.0,Female
LINDA,1941,10,10,0,100.0,0.0,Female
ALFREDA,1941,35,35,0,100.0,0.0,Female
ANTONIO,1941,53,0,53,0.0,100.0,Male
ALCIME,1941,6,0,6,0.0,100.0,Male
ENOGAT,1941,3,0,3,0.0,100.0,Male
FLORENTIN,1941,8,0,8,0.0,100.0,Male
_PRENOMS_RARES,1941,1760252,908578,851674,51.616359475802334,48.38364052419767,Unisex
NAZAIRE,1941,628,97,531,15.445859872611464,84.55414012738854,Unisex
JANNICK,1941,2792,1545,1247,55.336676217765046,44.66332378223496,Unisex
LIE,1941,328,80,248,24.390243902439025,75.60975609756098,Unisex
MARIE-FRANÇOISE,1942,237,237,0,100.0,0.0,Female
ELIZABETH,1942,12,12,0,100.0,0.0,Female
CARINE,1942,4,4,0,100.0,0.0,Female
EVE,1942,35,35,0,100.0,0.0,Female
ADOLPHE,1942,16559,124,16435,0.7488374901866055,99.2511625098134,Male
LIBERTO,1942,3,0,3,0.0,100.0,Male
HENRYK,1942,6,0,6,0.0,100.0,Male
CYRIL,1942,4,0,4,0.0,100.0,Male
JANNY,1942,1044,617,427,59.099616858237546,40.90038314176245,Unisex
PEPIN,1942,533,126,407,23.63977485928705,76.36022514071294,Unisex
SIMPLICE,1942,329,106,223,32.21884498480243,67.78115501519757,Unisex
EUTROPE,1942,194,70,124,36.08247422680412,63.91752577319587,Unisex
MAURICETTE,1943,1184,1184,0,100.0,0.0,Female
HÉLÈNE,1943,281614,281438,176,99.93750310708984,0.0624968929101536,Female
SCHOLASTIE,1943,8,8,0,100.0,0.0,Female
MICHELINE,1943,2378,2378,0,100.0,0.0,Female
SAINT-LOUIS,1943,3,0,3,0.0,100.0,Male
FERDINAND,1943,110,0,110,0.0,100.0,Male
ALBAIN,1943,3,0,3,0.0,100.0,Male
TURENNE,1943,5,0,5,0.0,100.0,Male
MARIE-JOSEPH,1943,2275,1830,445,80.43956043956044,19.56043956043956,Unisex
DANNY,1943,3396,610,2786,17.962308598351,82.037691401649,Unisex
CREPIN,1943,606,136,470,22.44224422442244,77.55775577557755,Unisex
JANICK,1943,4109,2203,1906,53.61401800924799,46.38598199075201,Unisex
FRANCESCA,1944,3,3,0,100.0,0.0,Female
MARIE-ANDRÉE,1944,29,29,0,100.0,0.0,Female
SILVETTE,1944,6,6,0,100.0,0.0,Female
ANNIE-CLAUDE,1944,9,9,0,100.0,0.0,Female
KURT,1944,19,0,19,0.0,100.0,Male
HENRI,1944,406479,184,406295,0.0452667911503423,99.95473320884966,Male
ARSÈNE,1944,3,0,3,0.0,100.0,Male
GAUTHIER,1944,6,0,6,0.0,100.0,Male
MESMIN,1944,773,183,590,23.67399741267788,76.32600258732212,Unisex
JANNICK,1944,2792,1545,1247,55.336676217765046,44.66332378223496,Unisex
JANY,1944,3897,2256,1641,57.89068514241724,42.10931485758276,Unisex
AGNAN,1944,455,124,331,27.25274725274725,72.74725274725274,Unisex
VIOLAINE,1945,10,10,0,100.0,0.0,Female
ROSEMONDE,1945,50,50,0,100.0,0.0,Female
GODELEINE,1945,6,6,0,100.0,0.0,Female
FIDELE,1945,3,3,0,100.0,0.0,Female
NORBERT,1945,26868,128,26740,0.4764031561709096,99.52359684382908,Male
GAËTAN,1945,71,0,71,0.0,100.0,Male
AUGUSTIN,1945,87,0,87,0.0,100.0,Male
RICO,1945,6,0,6,0.0,100.0,Male
YANICK,1945,3028,482,2546,15.918097754293262,84.08190224570674,Unisex
TIMOLEON,1945,481,101,380,20.997920997921,79.002079002079,Unisex
LEONIDE,1945,1588,1245,343,78.40050377833752,21.599496221662463,Unisex
BONIFACE,1945,1187,217,970,18.28138163437237,81.71861836562763,Unisex
NELLA,1946,4,4,0,100.0,0.0,Female
LAURIANNE,1946,3,3,0,100.0,0.0,Female
MARGARET,1946,51,51,0,100.0,0.0,Female
MARLYSE,1946,48,48,0,100.0,0.0,Female
CHRETIEN,1946,10,0,10,0.0,100.0,Male
ROMAN,1946,14,0,14,0.0,100.0,Male
RENAN,1946,4,0,4,0.0,100.0,Male
ANGELIN,1946,3,0,3,0.0,100.0,Male
LEONCE,1946,9290,2041,7249,21.96986006458557,78.03013993541443,Unisex
YANNIC,1946,671,104,567,15.499254843517138,84.50074515648286,Unisex
_PRENOMS_RARES,1946,1760252,908578,851674,51.616359475802334,48.38364052419767,Unisex
DANY,1946,26027,7836,18191,30.10719637299728,69.89280362700273,Unisex
SYLVINE,1947,21,21,0,100.0,0.0,Female
MARJORIE,1947,4,4,0,100.0,0.0,Female
LILA,1947,3,3,0,100.0,0.0,Female
JOËLLE,1947,2590,2590,0,100.0,0.0,Female
PAULIN,1947,26,0,26,0.0,100.0,Male
PATRICK,1947,4862,0,4862,0.0,100.0,Male
ELIOS,1947,4,0,4,0.0,100.0,Male
JEAN-DENIS,1947,26,0,26,0.0,100.0,Male
JANNY,1947,1044,617,427,59.099616858237546,40.90038314176245,Unisex
JOSY,1947,1021,840,181,82.27228207639568,17.72771792360431,Unisex
MARY,1947,6861,5830,1031,84.97303600058301,15.026963999416996,Unisex
_PRENOMS_RARES,1947,1760252,908578,851674,51.616359475802334,48.38364052419767,Unisex
ELODIE,1948,8,8,0,100.0,0.0,Female
MARIE-GERMAINE,1948,7,7,0,100.0,0.0,Female
NICOLETTE,1948,14,14,0,100.0,0.0,Female
ALICE,1948,528,528,0,100.0,0.0,Female
BERNARD,1948,19222,0,19222,0.0,100.0,Male
AHCENE,1948,3,0,3,0.0,100.0,Male
INEL,1948,3,0,3,0.0,100.0,Male
SADI,1948,3,0,3,0.0,100.0,Male
YANICK,1948,3028,482,2546,15.918097754293262,84.08190224570674,Unisex
JANY,1948,3897,2256,1641,57.89068514241724,42.10931485758276,Unisex
JEANNY,1948,968,718,250,74.17355371900827,25.82644628099173,Unisex
DOMINIQUE,1948,409989,168027,241962,40.98329467375954,59.01670532624046,Unisex
LIANE,1949,3,3,0,100.0,0.0,Female
BAPTISTINE,1949,13,13,0,100.0,0.0,Female
ANNE-CHRISTINE,1949,7,7,0,100.0,0.0,Female
LAURENCE,1949,490,490,0,100.0,0.0,Female
DANTE,1949,5,0,5,0.0,100.0,Male
PHILIPPE-MARIE,1949,3,0,3,0.0,100.0,Male
GEO,1949,4,0,4,0.0,100.0,Male
COME,1949,5420,155,5265,2.859778597785978,97.14022140221402,Male
ANONYME,1949,513,197,316,38.40155945419103,61.59844054580896,Unisex
CLAUDE-MARIE,1949,132,102,30,77.27272727272727,22.727272727272727,Unisex
ALIX,1949,37305,28371,8934,76.05146763168477,23.94853236831524,Unisex
SAINTE,1949,1055,648,407,61.4218009478673,38.5781990521327,Unisex
ANETTE,1950,6,6,0,100.0,0.0,Female
ROSITA,1950,60,60,0,100.0,0.0,Female
GWENAELLE,1950,8,8,0,100.0,0.0,Female
LISE-MARIE,1950,4,4,0,100.0,0.0,Female
ANICET,1950,2447,192,2255,7.8463424601552925,92.15365753984472,Male
LUC,1950,975,0,975,0.0,100.0,Male
ERIK,1950,25,0,25,0.0,100.0,Male
CLEBERT,1950,3,0,3,0.0,100.0,Male
ROSARIO,1950,1546,781,765,50.51746442432082,49.48253557567917,Unisex
PATERNE,1950,180,33,147,18.33333333333333,81.66666666666667,Unisex
CLAUDY,1950,2240,835,1405,37.27678571428572,62.72321428571429,Unisex
GEORGE,1950,2417,650,1767,26.89284236657013,73.10715763342988,Unisex
MARIE-AUDE,1951,5,5,0,100.0,0.0,Female
SYLVANIE,1951,8,8,0,100.0,0.0,Female
CELINA,1951,8,8,0,100.0,0.0,Female
AURORA,1951,10,10,0,100.0,0.0,Female
CARMEL,1951,4,0,4,0.0,100.0,Male
SIEGFRIED,1951,7,0,7,0.0,100.0,Male
FORTUNÉ,1951,3,0,3,0.0,100.0,Male
BEN,1951,7,0,7,0.0,100.0,Male
ANONYME,1951,513,197,316,38.40155945419103,61.59844054580896,Unisex
JOSY,1951,1021,840,181,82.27228207639568,17.72771792360431,Unisex
NICAISE,1951,1786,1255,531,70.26875699888018,29.73124300111982,Unisex
LEONCE,1951,9290,2041,7249,21.96986006458557,78.03013993541443,Unisex
MAÏTÉ,1952,7,7,0,100.0,0.0,Female
GUILENE,1952,11,11,0,100.0,0.0,Female
VIRGINIA,1952,8,8,0,100.0,0.0,Female
MIRIANE,1952,6,6,0,100.0,0.0,Female
THEOPHILE,1952,26,0,26,0.0,100.0,Male
JERZY,1952,3,0,3,0.0,100.0,Male
INEL,1952,7,0,7,0.0,100.0,Male
HERBERT,1952,16,0,16,0.0,100.0,Male
ALIX,1952,37305,28371,8934,76.05146763168477,23.94853236831524,Unisex
THIMOTHEE,1952,509,100,409,19.64636542239685,80.35363457760315,Unisex
GEORGE,1952,2417,650,1767,26.89284236657013,73.10715763342988,Unisex
SABAS,1952,607,220,387,36.24382207578254,63.75617792421746,Unisex
GRACIEUSE,1953,33,33,0,100.0,0.0,Female
ELIANNE,1953,22,22,0,100.0,0.0,Female
VERA,1953,9,9,0,100.0,0.0,Female
ADOLPHINE,1953,6,6,0,100.0,0.0,Female
JEAN-ALBERT,1953,8,0,8,0.0,100.0,Male
MAHMOUD,1953,7,0,7,0.0,100.0,Male
FRANÇIS,1953,15,0,15,0.0,100.0,Male
LOTHAIRE,1953,3,0,3,0.0,100.0,Male
JANNY,1953,1044,617,427,59.099616858237546,40.90038314176245,Unisex
NICAISE,1953,1786,1255,531,70.26875699888018,29.73124300111982,Unisex
EUSEBE,1953,1151,212,939,18.41876629018245,81.58123370981755,Unisex
CALIXTE,1953,3347,540,2807,16.13385121003884,83.86614878996116,Unisex
JACQUELINE,1954,5203,5203,0,100.0,0.0,Female
MARLISE,1954,4,4,0,100.0,0.0,Female
LEONA,1954,4,4,0,100.0,0.0,Female
ROSITA,1954,63,63,0,100.0,0.0,Female
GUY-NOËL,1954,5,0,5,0.0,100.0,Male
RICHEMONT,1954,3,0,3,0.0,100.0,Male
PATRICQ,1954,3,0,3,0.0,100.0,Male
LEONCE,1954,12,0,12,0.0,100.0,Male
SCHOLASTIQUE,1954,1080,835,245,77.31481481481481,22.685185185185187,Unisex
MARIE-JOSEPH,1954,2275,1830,445,80.43956043956044,19.56043956043956,Unisex
MARIE-BERNARD,1954,410,337,73,82.1951219512195,17.804878048780488,Unisex
ARIEL,1954,2401,428,1973,17.8259058725531,82.17409412744689,Unisex
ALICE,1955,253,253,0,100.0,0.0,Female
APOLLINE,1955,4,4,0,100.0,0.0,Female
MARIE-LÉONE,1955,5,5,0,100.0,0.0,Female
LUDMILLA,1955,4,4,0,100.0,0.0,Female
WERNER,1955,13,0,13,0.0,100.0,Male
OLLIVIER,1955,16,0,16,0.0,100.0,Male
JOSIAN,1955,37,0,37,0.0,100.0,Male
JEAN-CLAUDE,1955,5804,0,5804,0.0,100.0,Male
ROSARIO,1955,1546,781,765,50.51746442432082,49.48253557567917,Unisex
GABY,1955,4741,2448,2293,51.63467622864375,48.36532377135626,Unisex
CAMILLE,1955,287709,207732,79977,72.20212089298562,27.79787910701437,Unisex
ANONYME,1955,513,197,316,38.40155945419103,61.59844054580896,Unisex
MARIE-REINE,1956,81,81,0,100.0,0.0,Female
AIDA,1956,9,9,0,100.0,0.0,Female
BENEDICTE,1956,278,278,0,100.0,0.0,Female
RENELLE,1956,8,8,0,100.0,0.0,Female
ABDON,1956,869,101,768,11.622554660529344,88.37744533947065,Male
JOAQUIM,1956,3,0,3,0.0,100.0,Male
STEVEN,1956,50,0,50,0.0,100.0,Male
EDVARD,1956,8,0,8,0.0,100.0,Male
IRÉNÉE,1956,198,54,144,27.27272727272727,72.72727272727273,Unisex
CLAUDY,1956,2240,835,1405,37.27678571428572,62.72321428571429,Unisex
GABY,1956,4741,2448,2293,51.63467622864375,48.36532377135626,Unisex
DANICK,1956,205,69,136,33.65853658536586,66.34146341463415,Unisex
HÉLÈNE,1957,281614,281438,176,99.93750310708984,0.0624968929101536,Female
KARIN,1957,22,22,0,100.0,0.0,Female
MONELLE,1957,12,12,0,100.0,0.0,Female
ELIETTE,1957,86,86,0,100.0,0.0,Female
VIDAL,1957,3,0,3,0.0,100.0,Male
ANDRÉ-JEAN,1957,4,0,4,0.0,100.0,Male
RICHEMOND,1957,5,0,5,0.0,100.0,Male
LUCAY,1957,9,0,9,0.0,100.0,Male
JANNY,1957,1044,617,427,59.099616858237546,40.90038314176245,Unisex
HYACINTHE,1957,4679,1173,3506,25.069459286172258,74.93054071382774,Unisex
DANICK,1957,205,69,136,33.65853658536586,66.34146341463415,Unisex
GEORGE,1957,2417,650,1767,26.89284236657013,73.10715763342988,Unisex
MILAGROS,1958,3,3,0,100.0,0.0,Female
JOËLE,1958,4,4,0,100.0,0.0,Female
SYLVIANA,1958,9,9,0,100.0,0.0,Female
SORAYA,1958,30,30,0,100.0,0.0,Female
MOHAND,1958,23,0,23,0.0,100.0,Male
LIONNEL,1958,64,0,64,0.0,100.0,Male
FARRID,1958,3,0,3,0.0,100.0,Male
MATHIEU,1958,152579,195,152384,0.1278026464978797,99.87219735350212,Male
LEONCE,1958,9290,2041,7249,21.96986006458557,78.03013993541443,Unisex
CREPIN,1958,606,136,470,22.44224422442244,77.55775577557755,Unisex
CALIXTE,1958,3347,540,2807,16.13385121003884,83.86614878996116,Unisex
ROSARIO,1958,1546,781,765,50.51746442432082,49.48253557567917,Unisex
GINA,1959,160,160,0,100.0,0.0,Female
LOURDES,1959,4,4,0,100.0,0.0,Female
RALIDA,1959,3,3,0,100.0,0.0,Female
CATHIA,1959,15,15,0,100.0,0.0,Female
SALIM,1959,21,0,21,0.0,100.0,Male
VIANNEY,1959,24,0,24,0.0,100.0,Male
JEAN-DOMINIQUE,1959,48,0,48,0.0,100.0,Male
AZZEDINE,1959,8,0,8,0.0,100.0,Male
HYACINTHE,1959,4679,1173,3506,25.069459286172258,74.93054071382774,Unisex
DOMINIQUE,1959,409989,168027,241962,40.98329467375954,59.01670532624046,Unisex
MARIE-JOSEPH,1959,2275,1830,445,80.43956043956044,19.56043956043956,Unisex
GABRIELE,1959,993,563,430,56.6968781470292,43.3031218529708,Unisex
ANNA-ROSA,1960,4,4,0,100.0,0.0,Female
YVES-LISE,1960,3,3,0,100.0,0.0,Female
CHRYSTINE,1960,4,4,0,100.0,0.0,Female
JESSY,1960,3,3,0,100.0,0.0,Female
YOUNES,1960,3,0,3,0.0,100.0,Male
PIERRE-ETIENNE,1960,4,0,4,0.0,100.0,Male
LOUIS-MARIE,1960,17,0,17,0.0,100.0,Male
MILKO,1960,12,0,12,0.0,100.0,Male
ROSARIO,1960,1546,781,765,50.51746442432082,49.48253557567917,Unisex
MARIE-ANDRÉ,1960,86,59,27,68.6046511627907,31.3953488372093,Unisex
KIM,1960,6518,5270,1248,80.85302239950906,19.146977600490946,Unisex
MARY,1960,6861,5830,1031,84.97303600058301,15.026963999416996,Unisex
ESTELLE,1961,153,153,0,100.0,0.0,Female
PIERRETTE,1961,642,642,0,100.0,0.0,Female
JOCELINE,1961,33,33,0,100.0,0.0,Female
DOLORÈS,1961,19,19,0,100.0,0.0,Female
YAZIDE,1961,7,0,7,0.0,100.0,Male
GERARDO,1961,4,0,4,0.0,100.0,Male
RENAUD,1961,180,0,180,0.0,100.0,Male
SIDI,1961,7,0,7,0.0,100.0,Male
DANY,1961,26027,7836,18191,30.10719637299728,69.89280362700273,Unisex
ARIEL,1961,2401,428,1973,17.8259058725531,82.17409412744689,Unisex
JANNICK,1961,2792,1545,1247,55.336676217765046,44.66332378223496,Unisex
CLARENCE,1961,2943,924,2019,31.39653414882773,68.60346585117227,Unisex
LATEFA,1962,3,3,0,100.0,0.0,Female
CYNTHIA,1962,25,25,0,100.0,0.0,Female
GRACIEUSE,1962,14,14,0,100.0,0.0,Female
KIMBERLY,1962,18,18,0,100.0,0.0,Female
EULOGE,1962,3,0,3,0.0,100.0,Male
BRIAN,1962,15,0,15,0.0,100.0,Male
KOUIDER,1962,7,0,7,0.0,100.0,Male
CEDRIC,1962,32,0,32,0.0,100.0,Male
DANY,1962,26027,7836,18191,30.10719637299728,69.89280362700273,Unisex
JANICK,1962,4109,2203,1906,53.61401800924799,46.38598199075201,Unisex
RAFAELE,1962,320,265,55,82.8125,17.1875,Unisex
ADDA,1962,397,209,188,52.64483627204031,47.3551637279597,Unisex
ANNELIESE,1963,6,6,0,100.0,0.0,Female
LYNN,1963,4,4,0,100.0,0.0,Female
BEGONIA,1963,6,6,0,100.0,0.0,Female
MADLY,1963,5,5,0,100.0,0.0,Female
YANIC,1963,3,0,3,0.0,100.0,Male
LAHCENE,1963,16,0,16,0.0,100.0,Male
SÉBASTIEN,1963,89,0,89,0.0,100.0,Male
HAMID,1963,62,0,62,0.0,100.0,Male
DANICK,1963,205,69,136,33.65853658536586,66.34146341463415,Unisex
ANGE-MARIE,1963,650,290,360,44.61538461538462,55.38461538461539,Unisex
YANIK,1963,330,50,280,15.151515151515152,84.84848484848484,Unisex
YANICK,1963,3028,482,2546,15.918097754293262,84.08190224570674,Unisex
LINE,1964,179,179,0,100.0,0.0,Female
AKIMA,1964,12,12,0,100.0,0.0,Female
DOROTHÉE,1964,28,28,0,100.0,0.0,Female
MERYEM,1964,3,3,0,100.0,0.0,Female
JEAN-DAVID,1964,10,0,10,0.0,100.0,Male
LASZLO,1964,3,0,3,0.0,100.0,Male
JOHNSON,1964,3,0,3,0.0,100.0,Male
SYLVER,1964,3,0,3,0.0,100.0,Male
JANIC,1964,115,56,59,48.69565217391305,51.30434782608696,Unisex
ALIX,1964,37305,28371,8934,76.05146763168477,23.94853236831524,Unisex
NICAISE,1964,1786,1255,531,70.26875699888018,29.73124300111982,Unisex
GEORGIE,1964,255,164,91,64.31372549019608,35.68627450980392,Unisex
JEANNE-MARIE,1965,30,30,0,100.0,0.0,Female
MARIA-ISABEL,1965,11,11,0,100.0,0.0,Female
ARABELLE,1965,3,3,0,100.0,0.0,Female
FRANCELINE,1965,15,15,0,100.0,0.0,Female
SALVATOR,1965,20,0,20,0.0,100.0,Male
AGUSTIN,1965,15,0,15,0.0,100.0,Male
LESLY,1965,3,0,3,0.0,100.0,Male
BERTRAND,1965,1870,0,1870,0.0,100.0,Male
JANNY,1965,1044,617,427,59.099616858237546,40.90038314176245,Unisex
CALIXTE,1965,3347,540,2807,16.13385121003884,83.86614878996116,Unisex
YANICK,1965,3028,482,2546,15.918097754293262,84.08190224570674,Unisex
JANIK,1965,500,287,213,57.4,42.6,Unisex
ZAIYA,1966,4,4,0,100.0,0.0,Female
JOSELYNE,1966,15,15,0,100.0,0.0,Female
NACIRA,1966,4,4,0,100.0,0.0,Female
RAYMONDE,1966,154,154,0,100.0,0.0,Female
RONALD,1966,44,0,44,0.0,100.0,Male
ALFREDO,1966,42,0,42,0.0,100.0,Male
ABDERRAZAK,1966,4,0,4,0.0,100.0,Male
HUGUES,1966,771,0,771,0.0,100.0,Male
JEANNICK,1966,2091,1305,786,62.4103299856528,37.589670014347206,Unisex
DANY,1966,26027,7836,18191,30.10719637299728,69.89280362700273,Unisex
CLARENCE,1966,2943,924,2019,31.39653414882773,68.60346585117227,Unisex
JANNICK,1966,2792,1545,1247,55.336676217765046,44.66332378223496,Unisex
LUIZA,1967,8,8,0,100.0,0.0,Female
ALISSA,1967,3,3,0,100.0,0.0,Female
NEILA,1967,3,3,0,100.0,0.0,Female
ANTONIETTA,1967,26,26,0,100.0,0.0,Female
RACHID,1967,466,0,466,0.0,100.0,Male
ABDELKADER,1967,292,0,292,0.0,100.0,Male
ABDELHAKIM,1967,27,0,27,0.0,100.0,Male
JACINTO,1967,17,0,17,0.0,100.0,Male
PRIVAT,1967,514,87,427,16.926070038910506,83.0739299610895,Unisex
ANGE-MARIE,1967,650,290,360,44.61538461538462,55.38461538461539,Unisex
MARY,1967,6861,5830,1031,84.97303600058301,15.026963999416996,Unisex
IRENEE,1967,6155,1854,4301,30.121852152721363,69.87814784727864,Unisex
AGATHE,1968,56689,56477,212,99.62602974121964,0.373970258780363,Female
MURIELLA,1968,6,6,0,100.0,0.0,Female
MARIE-BENEDICTE,1968,19,19,0,100.0,0.0,Female
JULIE,1968,147,147,0,100.0,0.0,Female
FAUSTINO,1968,8,0,8,0.0,100.0,Male
MIGUEL-ANGEL,1968,3,0,3,0.0,100.0,Male
JORIS,1968,18,0,18,0.0,100.0,Male
NABIL,1968,49,0,49,0.0,100.0,Male
MARIE-BERNARD,1968,410,337,73,82.1951219512195,17.804878048780488,Unisex
MARY,1968,6861,5830,1031,84.97303600058301,15.026963999416996,Unisex
ALIX,1968,37305,28371,8934,76.05146763168477,23.94853236831524,Unisex
JANICK,1968,4109,2203,1906,53.61401800924799,46.38598199075201,Unisex
MARIE-CHRISTIANE,1969,5,5,0,100.0,0.0,Female
GISLENE,1969,4,4,0,100.0,0.0,Female
ANGELA,1969,95,95,0,100.0,0.0,Female
NAYMA,1969,6,6,0,100.0,0.0,Female
JOHN,1969,190,0,190,0.0,100.0,Male
JONATHAN,1969,16,0,16,0.0,100.0,Male
STÈVE,1969,8,0,8,0.0,100.0,Male
ANTONIN,1969,13,0,13,0.0,100.0,Male
JOHANE,1969,818,633,185,77.3838630806846,22.6161369193154,Unisex
ADDA,1969,397,209,188,52.64483627204031,47.3551637279597,Unisex
CARMINE,1969,372,76,296,20.43010752688172,79.56989247311827,Unisex
JANNICK,1969,2792,1545,1247,55.336676217765046,44.66332378223496,Unisex
MIGUY,1970,3,3,0,100.0,0.0,Female
MURIETTA,1970,3,3,0,100.0,0.0,Female
CHARLINE,1970,41,41,0,100.0,0.0,Female
JENNIFER,1970,59,59,0,100.0,0.0,Female
JEAN-CHARLES,1970,573,0,573,0.0,100.0,Male
MAXENCE,1970,63942,808,63134,1.263645178442964,98.73635482155704,Male
ADRIAN,1970,6,0,6,0.0,100.0,Male
BENOIST,1970,26,0,26,0.0,100.0,Male
MORGANN,1970,1229,459,770,37.34743694060212,62.65256305939788,Unisex
JANICK,1970,4109,2203,1906,53.61401800924799,46.38598199075201,Unisex
NICAISE,1970,1786,1255,531,70.26875699888018,29.73124300111982,Unisex
CLARENCE,1970,2943,924,2019,31.39653414882773,68.60346585117227,Unisex
ZAIDA,1971,4,4,0,100.0,0.0,Female
ROSABELLE,1971,11,11,0,100.0,0.0,Female
LOLA,1971,13,13,0,100.0,0.0,Female
MARIA-ANTONIA,1971,5,5,0,100.0,0.0,Female
DELFIN,1971,5,0,5,0.0,100.0,Male
BILLY,1971,4,0,4,0.0,100.0,Male
JEAN-EMMANUEL,1971,55,0,55,0.0,100.0,Male
JOVAN,1971,5,0,5,0.0,100.0,Male
GABY,1971,4741,2448,2293,51.63467622864375,48.36532377135626,Unisex
GREGORIE,1971,211,32,179,15.165876777251183,84.83412322274881,Unisex
ADDA,1971,397,209,188,52.64483627204031,47.3551637279597,Unisex
CLAUDY,1971,2240,835,1405,37.27678571428572,62.72321428571429,Unisex
ILIDIA,1972,3,3,0,100.0,0.0,Female
ELODIE,1972,994,994,0,100.0,0.0,Female
LÉTITIA,1972,7,7,0,100.0,0.0,Female
LÉNA,1972,33,33,0,100.0,0.0,Female
YACIN,1972,7,0,7,0.0,100.0,Male
AMADOR,1972,5,0,5,0.0,100.0,Male
SEBTI,1972,3,0,3,0.0,100.0,Male
AXEL,1972,86980,234,86746,0.2690273626120947,99.73097263738792,Male
THANH,1972,630,259,371,41.11111111111111,58.88888888888889,Unisex
CLAUDY,1972,2240,835,1405,37.27678571428572,62.72321428571429,Unisex
MALLORY,1972,2883,2151,732,74.60978147762746,25.390218522372525,Unisex
MARIE-JOSEPH,1972,2275,1830,445,80.43956043956044,19.56043956043956,Unisex
NAHLA,1973,3,3,0,100.0,0.0,Female
LAMIA,1973,28,28,0,100.0,0.0,Female
MARIE-DOMINIQUE,1973,68,68,0,100.0,0.0,Female
LIZA,1973,26,26,0,100.0,0.0,Female
GRAZIANO,1973,3,0,3,0.0,100.0,Male
MATTHEW,1973,4,0,4,0.0,100.0,Male
FLAVIO,1973,7,0,7,0.0,100.0,Male
HICHAME,1973,13,0,13,0.0,100.0,Male
JEANNY,1973,968,718,250,74.17355371900827,25.82644628099173,Unisex
CAROL,1973,3507,2953,554,84.20302252637582,15.79697747362418,Unisex
_PRENOMS_RARES,1973,1760252,908578,851674,51.616359475802334,48.38364052419767,Unisex
LENAIC,1973,1610,423,1187,26.27329192546584,73.72670807453416,Unisex
YASMINE,1974,93,93,0,100.0,0.0,Female
MILKA,1974,4,4,0,100.0,0.0,Female
HASSINA,1974,32,32,0,100.0,0.0,Female
JASMINE,1974,31,31,0,100.0,0.0,Female
CHRIS,1974,23,0,23,0.0,100.0,Male
FRANCK,1974,6657,0,6657,0.0,100.0,Male
ARISTIDE,1974,8,0,8,0.0,100.0,Male
CHOUKRI,1974,23,0,23,0.0,100.0,Male
LENAIC,1974,1610,423,1187,26.27329192546584,73.72670807453416,Unisex
LENAICK,1974,695,402,293,57.84172661870504,42.15827338129496,Unisex
DOMINIQUE,1974,409989,168027,241962,40.98329467375954,59.01670532624046,Unisex
YAEL,1974,6161,3036,3125,49.27771465671157,50.72228534328843,Unisex
ROSE-HÉLÈNE,1975,5,5,0,100.0,0.0,Female
MARIE-EDWIGE,1975,3,3,0,100.0,0.0,Female
LOÉTITIA,1975,5,5,0,100.0,0.0,Female
VICKY,1975,27,27,0,100.0,0.0,Female
LAMBERT,1975,4,0,4,0.0,100.0,Male
JEAN-MARIE,1975,521,0,521,0.0,100.0,Male
MODESTO,1975,3,0,3,0.0,100.0,Male
CÉSAR,1975,6,0,6,0.0,100.0,Male
LENAIK,1975,280,203,77,72.5,27.500000000000004,Unisex
DANNY,1975,3396,610,2786,17.962308598351,82.037691401649,Unisex
JESSY,1975,17091,3993,13098,23.363173600140424,76.63682639985957,Unisex
_PRENOMS_RARES,1975,1760252,908578,851674,51.616359475802334,48.38364052419767,Unisex
RITA,1976,48,48,0,100.0,0.0,Female
KATE,1976,7,7,0,100.0,0.0,Female
SOPHIE,1976,7612,7612,0,100.0,0.0,Female
ALISA,1976,3,3,0,100.0,0.0,Female
HAMDI,1976,7,0,7,0.0,100.0,Male
OUTMANE,1976,3,0,3,0.0,100.0,Male
ANTONY,1976,327,0,327,0.0,100.0,Male
JEAN-DENIS,1976,28,0,28,0.0,100.0,Male
JEANNICK,1976,2091,1305,786,62.4103299856528,37.589670014347206,Unisex
JORDANE,1976,4682,1785,2897,38.12473302007689,61.875266979923104,Unisex
GABY,1976,4741,2448,2293,51.63467622864375,48.36532377135626,Unisex
MALORY,1976,2305,1892,413,82.08242950108459,17.9175704989154,Unisex
GRACE,1977,3,3,0,100.0,0.0,Female
ANGELIKA,1977,3,3,0,100.0,0.0,Female
MICKAELA,1977,5,5,0,100.0,0.0,Female
MARYLOU,1977,3,3,0,100.0,0.0,Female
BULENT,1977,22,0,22,0.0,100.0,Male
JEANNOT,1977,5,0,5,0.0,100.0,Male
ABIB,1977,4,0,4,0.0,100.0,Male
YASSIR,1977,5,0,5,0.0,100.0,Male
_PRENOMS_RARES,1977,1760252,908578,851674,51.616359475802334,48.38364052419767,Unisex
SIDNEY,1977,2484,951,1533,38.28502415458937,61.71497584541063,Unisex
YUKSEL,1977,144,25,119,17.36111111111111,82.63888888888889,Unisex
JOHANE,1977,818,633,185,77.3838630806846,22.6161369193154,Unisex
SAÏDA,1978,22,22,0,100.0,0.0,Female
WAFAA,1978,17,17,0,100.0,0.0,Female
RIME,1978,7,7,0,100.0,0.0,Female
KETY,1978,3,3,0,100.0,0.0,Female
CHARLES-EDOUARD,1978,21,0,21,0.0,100.0,Male
ABOUBACAR,1978,6,0,6,0.0,100.0,Male
JEAN-BASTIEN,1978,3,0,3,0.0,100.0,Male
YUSUF,1978,15,0,15,0.0,100.0,Male
ISA,1978,730,291,439,39.86301369863013,60.136986301369866,Unisex
DANY,1978,26027,7836,18191,30.10719637299728,69.89280362700273,Unisex
LORY,1978,1231,941,290,76.44191714053615,23.55808285946385,Unisex
AMARA,1978,1568,601,967,38.329081632653065,61.670918367346935,Unisex
GERTRUDE,1979,4,4,0,100.0,0.0,Female
MAIVA,1979,3,3,0,100.0,0.0,Female
EMMELINE,1979,26,26,0,100.0,0.0,Female
GULLU,1979,3,3,0,100.0,0.0,Female
PIERRE-JOSEPH,1979,4,0,4,0.0,100.0,Male
MELCHIOR,1979,4,0,4,0.0,100.0,Male
DAVUT,1979,3,0,3,0.0,100.0,Male
PAUL,1979,632,0,632,0.0,100.0,Male
LENAICK,1979,695,402,293,57.84172661870504,42.15827338129496,Unisex
LENAIC,1979,1610,423,1187,26.27329192546584,73.72670807453416,Unisex
MADY,1979,2286,1197,1089,52.362204724409445,47.63779527559055,Unisex
DOMINIQUE,1979,409989,168027,241962,40.98329467375954,59.01670532624046,Unisex
ANNE-LORE,1980,5,5,0,100.0,0.0,Female
NATALI,1980,10,10,0,100.0,0.0,Female
FRANCIANE,1980,12,12,0,100.0,0.0,Female
HALA,1980,9,9,0,100.0,0.0,Female
SOUFYAN,1980,9,0,9,0.0,100.0,Male
EDOUARD,1980,530,0,530,0.0,100.0,Male
PIERRE-ALAIN,1980,42,0,42,0.0,100.0,Male
MOHAMMED,1980,93,0,93,0.0,100.0,Male
HAMIDA,1980,759,628,131,82.74044795783925,17.25955204216074,Unisex
MADY,1980,2286,1197,1089,52.362204724409445,47.63779527559055,Unisex
MALEK,1980,3570,1060,2510,29.69187675070028,70.30812324929971,Unisex
JESSY,1980,17091,3993,13098,23.363173600140424,76.63682639985957,Unisex
MERCEDES,1981,8,8,0,100.0,0.0,Female
AURÉLIE,1981,12358,12358,0,100.0,0.0,Female
SEVIM,1981,5,5,0,100.0,0.0,Female
ROSE,1981,87,87,0,100.0,0.0,Female
MIROSLAV,1981,3,0,3,0.0,100.0,Male
ARNAULT,1981,64,0,64,0.0,100.0,Male
SAMI,1981,197,0,197,0.0,100.0,Male
SLIMANE,1981,64,0,64,0.0,100.0,Male
OUISSAM,1981,216,68,148,31.48148148148148,68.51851851851852,Unisex
HEIDY,1981,271,201,70,74.16974169741697,25.830258302583022,Unisex
HILAL,1981,1545,1011,534,65.4368932038835,34.56310679611651,Unisex
JANNICK,1981,2792,1545,1247,55.336676217765046,44.66332378223496,Unisex
NATALIE,1982,20,20,0,100.0,0.0,Female
ROMAINE,1982,5,5,0,100.0,0.0,Female
ASTRIDE,1982,14,14,0,100.0,0.0,Female
AURELIA,1982,684,684,0,100.0,0.0,Female
MATIAS,1982,4,0,4,0.0,100.0,Male
XABI,1982,3,0,3,0.0,100.0,Male
TIAGO,1982,6,0,6,0.0,100.0,Male
ZOUHIR,1982,18,0,18,0.0,100.0,Male
NAJAH,1982,323,274,49,84.82972136222911,15.1702786377709,Unisex
GABY,1982,4741,2448,2293,51.63467622864375,48.36532377135626,Unisex
SYDNEY,1982,2101,1236,865,58.829128986197055,41.17087101380295,Unisex
CHARLIE,1982,30211,15480,14731,51.23961470987389,48.76038529012611,Unisex
EMELIE,1983,13,13,0,100.0,0.0,Female
ALEXANDRA,1983,93340,93310,30,99.96785943861153,0.0321405613884722,Female
MARYLOU,1983,3,3,0,100.0,0.0,Female
FATIM-ZOHRA,1983,4,4,0,100.0,0.0,Female
BOUBACAR,1983,16,0,16,0.0,100.0,Male
YORO,1983,7,0,7,0.0,100.0,Male
ALVARO,1983,6,0,6,0.0,100.0,Male
YAMANI,1983,3,0,3,0.0,100.0,Male
HILAL,1983,1545,1011,534,65.4368932038835,34.56310679611651,Unisex
LENAICK,1983,695,402,293,57.84172661870504,42.15827338129496,Unisex
CHARLIE,1983,30211,15480,14731,51.23961470987389,48.76038529012611,Unisex
_PRENOMS_RARES,1983,1760252,908578,851674,51.616359475802334,48.38364052419767,Unisex
AIMÉE,1984,20,20,0,100.0,0.0,Female
VERA,1984,14,14,0,100.0,0.0,Female
MARIE-BERNADETTE,1984,3,3,0,100.0,0.0,Female
SALOI,1984,5,5,0,100.0,0.0,Female
MOHAMADOU,1984,10,0,10,0.0,100.0,Male
JACQUES-ALEXANDRE,1984,6,0,6,0.0,100.0,Male
THEOTIME,1984,4,0,4,0.0,100.0,Male
FLORIS,1984,18,0,18,0.0,100.0,Male
KAREL,1984,1060,233,827,21.9811320754717,78.01886792452831,Unisex
GWENHAEL,1984,225,76,149,33.77777777777778,66.22222222222223,Unisex
DANY,1984,26027,7836,18191,30.10719637299728,69.89280362700273,Unisex
KIM,1984,6518,5270,1248,80.85302239950906,19.146977600490946,Unisex
MARJOLÈNE,1985,4,4,0,100.0,0.0,Female
JEZABEL,1985,10,10,0,100.0,0.0,Female
LOU,1985,52743,49058,3685,93.01329086324252,6.986709136757484,Female
ADRIANE,1985,18,18,0,100.0,0.0,Female
CHILDERIC,1985,4,0,4,0.0,100.0,Male
GERRY,1985,3,0,3,0.0,100.0,Male
RONAN,1985,296,0,296,0.0,100.0,Male
CÉLIAN,1985,3,0,3,0.0,100.0,Male
DANY,1985,26027,7836,18191,30.10719637299728,69.89280362700273,Unisex
KIM,1985,6518,5270,1248,80.85302239950906,19.146977600490946,Unisex
ANAEL,1985,2957,1241,1716,41.96821102468719,58.031788975312814,Unisex
MAELIG,1985,554,238,316,42.96028880866426,57.03971119133574,Unisex
FIGEN,1986,4,4,0,100.0,0.0,Female
DORSAF,1986,3,3,0,100.0,0.0,Female
LIO,1986,7,7,0,100.0,0.0,Female
OUMY,1986,6,6,0,100.0,0.0,Female
JEAN-MARTIAL,1986,3,0,3,0.0,100.0,Male
TIMUR,1986,3,0,3,0.0,100.0,Male
ABOULAYE,1986,5,0,5,0.0,100.0,Male
LOTHAIRE,1986,3,0,3,0.0,100.0,Male
MALEK,1986,3570,1060,2510,29.69187675070028,70.30812324929971,Unisex
JANY,1986,3897,2256,1641,57.89068514241724,42.10931485758276,Unisex
GWEN,1986,941,419,522,44.52709883103082,55.47290116896918,Unisex
KANDE,1986,209,98,111,46.889952153110045,53.11004784688996,Unisex
MEIJE,1987,3,3,0,100.0,0.0,Female
HAGER,1987,6,6,0,100.0,0.0,Female
LOBNA,1987,22,22,0,100.0,0.0,Female
LEOCADIE,1987,3,3,0,100.0,0.0,Female
MODIBO,1987,10,0,10,0.0,100.0,Male
TIMMY,1987,6,0,6,0.0,100.0,Male
KADIR,1987,12,0,12,0.0,100.0,Male
SULIMAN,1987,5,0,5,0.0,100.0,Male
YAEL,1987,6161,3036,3125,49.27771465671157,50.72228534328843,Unisex
SULTAN,1987,775,518,257,66.83870967741935,33.16129032258065,Unisex
BERYL,1987,762,607,155,79.65879265091863,20.341207349081365,Unisex
SAMEH,1987,141,93,48,65.95744680851064,34.04255319148936,Unisex
AISATOU,1988,4,4,0,100.0,0.0,Female
LAETITIA,1988,3762,3762,0,100.0,0.0,Female
ROSEMARY,1988,4,4,0,100.0,0.0,Female
CARLOTTA,1988,7,7,0,100.0,0.0,Female
AURÈLE,1988,7,0,7,0.0,100.0,Male
PACO,1988,20,0,20,0.0,100.0,Male
BENJI,1988,3,0,3,0.0,100.0,Male
REYNOLD,1988,3,0,3,0.0,100.0,Male
THIEFAINE,1988,257,50,207,19.45525291828794,80.54474708171206,Unisex
CLAUDY,1988,2240,835,1405,37.27678571428572,62.72321428571429,Unisex
SINA,1988,338,162,176,47.92899408284024,52.071005917159766,Unisex
SAMEH,1988,141,93,48,65.95744680851064,34.04255319148936,Unisex
FLORE,1989,242,242,0,100.0,0.0,Female
BRAHA,1989,3,3,0,100.0,0.0,Female
MANOUCHKA,1989,3,3,0,100.0,0.0,Female
YASSMINA,1989,6,6,0,100.0,0.0,Female
ANDRES,1989,3,0,3,0.0,100.0,Male
PIERRE-VINCENT,1989,6,0,6,0.0,100.0,Male
RAHIM,1989,7,0,7,0.0,100.0,Male
GÉRALD,1989,189,0,189,0.0,100.0,Male
HAMIDA,1989,759,628,131,82.74044795783925,17.25955204216074,Unisex
AMARA,1989,1568,601,967,38.329081632653065,61.670918367346935,Unisex
LOÏS,1989,11236,3416,7820,30.40227839088644,69.59772160911356,Unisex
DANY,1989,26027,7836,18191,30.10719637299728,69.89280362700273,Unisex
CASSIE,1990,19,19,0,100.0,0.0,Female
MELVINE,1990,7,7,0,100.0,0.0,Female
GWENNAËLLE,1990,8,8,0,100.0,0.0,Female
ANNAICK,1990,9,9,0,100.0,0.0,Female
JEAN-SÉBASTIEN,1990,82,0,82,0.0,100.0,Male
JAOUHAR,1990,3,0,3,0.0,100.0,Male
IDIR,1990,27,0,27,0.0,100.0,Male
WOLFGANG,1990,15,0,15,0.0,100.0,Male
GABRIELE,1990,993,563,430,56.6968781470292,43.3031218529708,Unisex
ADDA,1990,397,209,188,52.64483627204031,47.3551637279597,Unisex
MALLORY,1990,2883,2151,732,74.60978147762746,25.390218522372525,Unisex
JODY,1990,896,622,274,69.41964285714286,30.580357142857142,Unisex
MAJDOULINE,1991,9,9,0,100.0,0.0,Female
LUDYVINE,1991,11,11,0,100.0,0.0,Female
NIAME,1991,5,5,0,100.0,0.0,Female
SUZY,1991,65,65,0,100.0,0.0,Female
JOSÉ,1991,134,0,134,0.0,100.0,Male
MALCOLM,1991,26,0,26,0.0,100.0,Male
STYVE,1991,5,0,5,0.0,100.0,Male
AHMET,1991,49,0,49,0.0,100.0,Male
DILAN,1991,1452,360,1092,24.793388429752067,75.20661157024794,Unisex
LORI,1991,430,327,103,76.04651162790698,23.953488372093023,Unisex
LORRY,1991,389,169,220,43.44473007712082,56.555269922879184,Unisex
GILLIAN,1991,947,327,620,34.53009503695882,65.46990496304119,Unisex
MY,1992,3,3,0,100.0,0.0,Female
FERYEL,1992,3,3,0,100.0,0.0,Female
AVELINE,1992,9,9,0,100.0,0.0,Female
SHONA,1992,3,3,0,100.0,0.0,Female
DEMSEY,1992,3,0,3,0.0,100.0,Male
ADOLPHE,1992,4,0,4,0.0,100.0,Male
MARWAN,1992,43,0,43,0.0,100.0,Male
GIOVANNI,1992,268,0,268,0.0,100.0,Male
LE,1992,221,114,107,51.58371040723983,48.41628959276018,Unisex
JANIS,1992,1364,884,480,64.80938416422288,35.19061583577713,Unisex
EVANE,1992,809,612,197,75.64894932014833,24.351050679851667,Unisex
CLARENCE,1992,2943,924,2019,31.39653414882773,68.60346585117227,Unisex
MAILE,1993,6,6,0,100.0,0.0,Female
ROSEMONDE,1993,4,4,0,100.0,0.0,Female
ALIONA,1993,4,4,0,100.0,0.0,Female
KAINA,1993,15,15,0,100.0,0.0,Female
FRANTZ,1993,19,0,19,0.0,100.0,Male
IRFAAN,1993,3,0,3,0.0,100.0,Male
FADY,1993,4,0,4,0.0,100.0,Male
GUINEL,1993,3,0,3,0.0,100.0,Male
JORDANE,1993,4682,1785,2897,38.12473302007689,61.875266979923104,Unisex
MOANA,1993,1034,769,265,74.37137330754352,25.62862669245648,Unisex
GWENN,1993,1848,1201,647,64.98917748917748,35.01082251082251,Unisex
DILAN,1993,1452,360,1092,24.793388429752067,75.20661157024794,Unisex
MATY,1994,3,3,0,100.0,0.0,Female
NAÏMA,1994,22,22,0,100.0,0.0,Female
EMMANUELLA,1994,18,18,0,100.0,0.0,Female
TABATHA,1994,17,17,0,100.0,0.0,Female
ERICK,1994,15,0,15,0.0,100.0,Male
MADJID,1994,25,0,25,0.0,100.0,Male
KAELIG,1994,3,0,3,0.0,100.0,Male
PAUL-MARIE,1994,7,0,7,0.0,100.0,Male
CHRISTY,1994,584,396,188,67.8082191780822,32.19178082191781,Unisex
JORDANE,1994,4682,1785,2897,38.12473302007689,61.875266979923104,Unisex
SWANNY,1994,534,310,224,58.05243445692884,41.94756554307117,Unisex
ADAMA,1994,3805,1078,2727,28.3311432325887,71.6688567674113,Unisex
XENIA,1995,6,6,0,100.0,0.0,Female
KAROLINA,1995,4,4,0,100.0,0.0,Female
MARJOLENE,1995,7,7,0,100.0,0.0,Female
NADIRA,1995,6,6,0,100.0,0.0,Female
NICODEME,1995,8,0,8,0.0,100.0,Male
MASSIS,1995,3,0,3,0.0,100.0,Male
CLIFF,1995,3,0,3,0.0,100.0,Male
GEOFFREY,1995,1047,0,1047,0.0,100.0,Male
ANH,1995,394,164,230,41.62436548223351,58.37563451776649,Unisex
MOANA,1995,1034,769,265,74.37137330754352,25.62862669245648,Unisex
_PRENOMS_RARES,1995,1760252,908578,851674,51.616359475802334,48.38364052419767,Unisex
YAËL,1995,3502,1564,1938,44.66019417475729,55.33980582524271,Unisex
MADDY,1996,9,9,0,100.0,0.0,Female
KHADI,1996,3,3,0,100.0,0.0,Female
ALYCIA,1996,47,47,0,100.0,0.0,Female
EVA-MARIE,1996,9,9,0,100.0,0.0,Female
DUNKAN,1996,5,0,5,0.0,100.0,Male
RENÉ-CLAUDE,1996,3,0,3,0.0,100.0,Male
HELIE,1996,3,0,3,0.0,100.0,Male
FOUED,1996,19,0,19,0.0,100.0,Male
INDY,1996,310,111,199,35.80645161290323,64.19354838709678,Unisex
SASHA,1996,18319,7736,10583,42.22937933293302,57.77062066706697,Unisex
NGOC,1996,641,437,204,68.17472698907956,31.82527301092044,Unisex
GWENN,1996,1848,1201,647,64.98917748917748,35.01082251082251,Unisex
SAHANA,1997,4,4,0,100.0,0.0,Female
LUCYL,1997,6,6,0,100.0,0.0,Female
MAYLEE,1997,3,3,0,100.0,0.0,Female
TENE,1997,5,5,0,100.0,0.0,Female
AKASH,1997,5,0,5,0.0,100.0,Male
DORIANO,1997,3,0,3,0.0,100.0,Male
KENNY,1997,7420,127,7293,1.7115902964959568,98.28840970350404,Male
ADRIEL,1997,8,0,8,0.0,100.0,Male
KIM,1997,6518,5270,1248,80.85302239950906,19.146977600490946,Unisex
DENIZ,1997,1954,675,1279,34.54452405322416,65.45547594677585,Unisex
LENAÏC,1997,163,44,119,26.993865030674847,73.00613496932516,Unisex
DILAN,1997,1452,360,1092,24.793388429752067,75.20661157024794,Unisex
MAËLLA,1998,7,7,0,100.0,0.0,Female
ALBINA,1998,4,4,0,100.0,0.0,Female
SHANIA,1998,5,5,0,100.0,0.0,Female
NESMA,1998,5,5,0,100.0,0.0,Female
PRAVEEN,1998,3,0,3,0.0,100.0,Male
WANISS,1998,5,0,5,0.0,100.0,Male
MARTIN,1998,1368,0,1368,0.0,100.0,Male
ONUR,1998,58,0,58,0.0,100.0,Male
LOGANE,1998,619,495,124,79.96768982229402,20.032310177705977,Unisex
GWENN,1998,1848,1201,647,64.98917748917748,35.01082251082251,Unisex
GWEN,1998,941,419,522,44.52709883103082,55.47290116896918,Unisex
ALIX,1998,37305,28371,8934,76.05146763168477,23.94853236831524,Unisex
ASMAHANE,1999,4,4,0,100.0,0.0,Female
ZEHRA,1999,29,29,0,100.0,0.0,Female
LEELOU,1999,21,21,0,100.0,0.0,Female
LAORA,1999,13,13,0,100.0,0.0,Female
HADY,1999,4,0,4,0.0,100.0,Male
FLORAN,1999,27,0,27,0.0,100.0,Male
ANDREI,1999,10,0,10,0.0,100.0,Male
AFIF,1999,7,0,7,0.0,100.0,Male
SOANE,1999,1340,953,387,71.11940298507463,28.88059701492537,Unisex
MORGANN,1999,1229,459,770,37.34743694060212,62.65256305939788,Unisex
SAFI,1999,393,129,264,32.82442748091603,67.17557251908397,Unisex
JAMIE,1999,683,155,528,22.69399707174232,77.30600292825768,Unisex
ZITA,2000,4,4,0,100.0,0.0,Female
HINATEA,2000,3,3,0,100.0,0.0,Female
BRITNEY,2000,46,46,0,100.0,0.0,Female
VALENE,2000,9,9,0,100.0,0.0,Female
GERAUD,2000,39,0,39,0.0,100.0,Male
COLYN,2000,3,0,3,0.0,100.0,Male
BRAHIMA,2000,11,0,11,0.0,100.0,Male
CYRIL,2000,698,0,698,0.0,100.0,Male
AMOUR,2000,782,287,495,36.70076726342711,63.29923273657288,Unisex
CHARLIE,2000,30211,15480,14731,51.23961470987389,48.76038529012611,Unisex
ANAEL,2000,2957,1241,1716,41.96821102468719,58.031788975312814,Unisex
NEHEMIE,2000,469,250,219,53.30490405117271,46.695095948827294,Unisex
TYANA,2001,9,9,0,100.0,0.0,Female
DILYS,2001,3,3,0,100.0,0.0,Female
ALYSSON,2001,45,45,0,100.0,0.0,Female
ASTRIDE,2001,5,5,0,100.0,0.0,Female
SERCAN,2001,3,0,3,0.0,100.0,Male
KADER,2001,21,0,21,0.0,100.0,Male
LAURIAN,2001,19,0,19,0.0,100.0,Male
ANUJAN,2001,4,0,4,0.0,100.0,Male
SHERIDAN,2001,119,64,55,53.78151260504202,46.21848739495798,Unisex
IHSANE,2001,689,439,250,63.7155297532656,36.2844702467344,Unisex
KEZIAH,2001,1699,467,1232,27.48675691583284,72.51324308416716,Unisex
WISSAM,2001,2491,451,2040,18.105178643115213,81.89482135688479,Unisex
HÉLÈNE,2002,387,387,0,100.0,0.0,Female
CRYSTALE,2002,17,17,0,100.0,0.0,Female
SHANAELLE,2002,5,5,0,100.0,0.0,Female
ALLISSON,2002,5,5,0,100.0,0.0,Female
OTHMANE,2002,38,0,38,0.0,100.0,Male
STEEVENS,2002,5,0,5,0.0,100.0,Male
LUCKA,2002,12,0,12,0.0,100.0,Male
NOAH,2002,65974,537,65437,0.8139570133689029,99.1860429866311,Male
YVANE,2002,775,520,255,67.0967741935484,32.903225806451616,Unisex
BRANDY,2002,283,198,85,69.96466431095406,30.03533568904594,Unisex
CLARENCE,2002,2943,924,2019,31.39653414882773,68.60346585117227,Unisex
ELY,2002,1634,623,1011,38.12729498164015,61.87270501835985,Unisex
BIANCA,2003,54,54,0,100.0,0.0,Female
BERFIN,2003,21,21,0,100.0,0.0,Female
OCEANA,2003,27,27,0,100.0,0.0,Female
ARIGE,2003,10,10,0,100.0,0.0,Female
CHAI,2003,5,0,5,0.0,100.0,Male
MARK,2003,26,0,26,0.0,100.0,Male
SOUMAILA,2003,5,0,5,0.0,100.0,Male
JOSUAH,2003,6,0,6,0.0,100.0,Male
JIHAD,2003,692,175,517,25.289017341040463,74.71098265895954,Unisex
BERYL,2003,762,607,155,79.65879265091863,20.341207349081365,Unisex
WISSAM,2003,2491,451,2040,18.105178643115213,81.89482135688479,Unisex
SWANNY,2003,534,310,224,58.05243445692884,41.94756554307117,Unisex
LAURALEE,2004,16,16,0,100.0,0.0,Female
NESS,2004,32,32,0,100.0,0.0,Female
ERIN,2004,120,120,0,100.0,0.0,Female
AMANDA,2004,76,76,0,100.0,0.0,Female
SHAAD,2004,3,0,3,0.0,100.0,Male
OBED,2004,3,0,3,0.0,100.0,Male
JUDICAEL,2004,43,0,43,0.0,100.0,Male
SOULEYMANE,2004,64,0,64,0.0,100.0,Male
KEZIAH,2004,1699,467,1232,27.48675691583284,72.51324308416716,Unisex
MANAEL,2004,149,23,126,15.436241610738255,84.56375838926175,Unisex
MEWENN,2004,281,96,185,34.16370106761566,65.83629893238434,Unisex
ELYJAH,2004,305,49,256,16.065573770491802,83.93442622950819,Unisex
CONSUELO,2005,4,4,0,100.0,0.0,Female
AODRENN,2005,3,3,0,100.0,0.0,Female
MEDELINE,2005,5,5,0,100.0,0.0,Female
DOROTHEE,2005,11,11,0,100.0,0.0,Female
AARONE,2005,8,0,8,0.0,100.0,Male
LAZAR,2005,12,0,12,0.0,100.0,Male
LOUIS-FERDINAND,2005,3,0,3,0.0,100.0,Male
KERVENS,2005,4,0,4,0.0,100.0,Male
SWANN,2005,8143,2279,5864,27.98722829424045,72.01277170575955,Unisex
CALISTE,2005,141,51,90,36.17021276595745,63.82978723404256,Unisex
ELWEN,2005,275,55,220,20.0,80.0,Unisex
SASHA,2005,18319,7736,10583,42.22937933293302,57.77062066706697,Unisex
LEILANY,2006,3,3,0,100.0,0.0,Female
SORONA,2006,3,3,0,100.0,0.0,Female
CYPRILLE,2006,3,3,0,100.0,0.0,Female
MERINE,2006,22,22,0,100.0,0.0,Female
MANECH,2006,33,0,33,0.0,100.0,Male
TILLIAN,2006,3,0,3,0.0,100.0,Male
ANH,2006,5,0,5,0.0,100.0,Male
MARCEL,2006,45,0,45,0.0,100.0,Male
LENAIK,2006,280,203,77,72.5,27.500000000000004,Unisex
HANINE,2006,371,310,61,83.55795148247978,16.442048517520217,Unisex
MILANE,2006,634,298,336,47.003154574132495,52.99684542586751,Unisex
ELY,2006,1634,623,1011,38.12729498164015,61.87270501835985,Unisex
ASTRIK,2007,4,4,0,100.0,0.0,Female
VANESSA,2007,180,180,0,100.0,0.0,Female
NORHAN,2007,5,5,0,100.0,0.0,Female
ILUNA,2007,4,4,0,100.0,0.0,Female
HAKTAN,2007,4,0,4,0.0,100.0,Male
YARON,2007,11,0,11,0.0,100.0,Male
NEIL,2007,2534,39,2495,1.539068666140489,98.46093133385952,Male
OUSMANE,2007,96,0,96,0.0,100.0,Male
NICKY,2007,573,134,439,23.38568935427574,76.61431064572426,Unisex
ELVAN,2007,378,220,158,58.2010582010582,41.7989417989418,Unisex
KHANH,2007,91,52,39,57.14285714285714,42.85714285714285,Unisex
NOAME,2007,153,100,53,65.359477124183,34.64052287581699,Unisex
YSAURE,2008,10,10,0,100.0,0.0,Female
ELFIE,2008,37,37,0,100.0,0.0,Female
OLIVIA,2008,871,871,0,100.0,0.0,Female
KAELYA,2008,3,3,0,100.0,0.0,Female
KENDAL,2008,8,0,8,0.0,100.0,Male
ALAN,2008,442,0,442,0.0,100.0,Male
ONUR,2008,36,0,36,0.0,100.0,Male
TED,2008,4,0,4,0.0,100.0,Male
NAE,2008,142,94,48,66.19718309859155,33.80281690140845,Unisex
CHANCE,2008,165,51,114,30.909090909090907,69.0909090909091,Unisex
GABY,2008,4741,2448,2293,51.63467622864375,48.36532377135626,Unisex
LOUHANN,2008,187,150,37,80.21390374331551,19.78609625668449,Unisex
LILEA,2009,7,7,0,100.0,0.0,Female
NARJISS,2009,7,7,0,100.0,0.0,Female
MOUNIA,2009,24,24,0,100.0,0.0,Female
ORLA,2009,6,6,0,100.0,0.0,Female
PIERRE-FRANÇOIS,2009,7,0,7,0.0,100.0,Male
TYBO,2009,12,0,12,0.0,100.0,Male
OIHAN,2009,80,0,80,0.0,100.0,Male
CHAFIK,2009,7,0,7,0.0,100.0,Male
ELISHA,2009,425,285,140,67.05882352941175,32.94117647058823,Unisex
NOAME,2009,153,100,53,65.359477124183,34.64052287581699,Unisex
NOHA,2009,3543,766,2777,21.620095963872423,78.37990403612758,Unisex
SIAN,2009,188,132,56,70.2127659574468,29.78723404255319,Unisex
KAHAIA,2010,5,5,0,100.0,0.0,Female
NOELISE,2010,6,6,0,100.0,0.0,Female
TAMARA,2010,125,125,0,100.0,0.0,Female
ASHLYN,2010,3,3,0,100.0,0.0,Female
KEONI,2010,16,0,16,0.0,100.0,Male
ASSAD,2010,11,0,11,0.0,100.0,Male
AMADEO,2010,10,0,10,0.0,100.0,Male
SEMIR,2010,5,0,5,0.0,100.0,Male
NEHEMIE,2010,469,250,219,53.30490405117271,46.695095948827294,Unisex
ELWEN,2010,275,55,220,20.0,80.0,Unisex
KEZIAH,2010,1699,467,1232,27.48675691583284,72.51324308416716,Unisex
JESSY,2010,17091,3993,13098,23.363173600140424,76.63682639985957,Unisex
ARIJ,2011,28,28,0,100.0,0.0,Female
KELIAH,2011,5,5,0,100.0,0.0,Female
OUMEYMA,2011,29,29,0,100.0,0.0,Female
ABBYGAELLE,2011,18,18,0,100.0,0.0,Female
DARRELL,2011,6,0,6,0.0,100.0,Male
MOHAMED-AMINE,2011,281,0,281,0.0,100.0,Male
ATILA,2011,3,0,3,0.0,100.0,Male
ABDELWAKIL,2011,5,0,5,0.0,100.0,Male
LYSSANDRE,2011,574,157,417,27.35191637630662,72.64808362369338,Unisex
LOUNESS,2011,135,26,109,19.25925925925926,80.74074074074075,Unisex
GILLIAN,2011,947,327,620,34.53009503695882,65.46990496304119,Unisex
MALI,2011,251,146,105,58.16733067729084,41.832669322709165,Unisex
BRITANIE,2012,3,3,0,100.0,0.0,Female
ELLA,2012,344,344,0,100.0,0.0,Female
DIKRA,2012,7,7,0,100.0,0.0,Female
MIHRIMAH,2012,4,4,0,100.0,0.0,Female
BÉCHIR,2012,3,0,3,0.0,100.0,Male
LOUÏS,2012,9,0,9,0.0,100.0,Male
TRYSTAN,2012,51,0,51,0.0,100.0,Male
WASIM,2012,7,0,7,0.0,100.0,Male
SWANN,2012,8143,2279,5864,27.98722829424045,72.01277170575955,Unisex
SADIO,2012,1523,895,628,58.76559422193039,41.2344057780696,Unisex
SASCHA,2012,525,132,393,25.142857142857142,74.85714285714286,Unisex
REYHAN,2012,370,280,90,75.67567567567568,24.324324324324326,Unisex
MANISSA,2013,4,4,0,100.0,0.0,Female
TYANA,2013,41,41,0,100.0,0.0,Female
LAYSA,2013,4,4,0,100.0,0.0,Female
CHLOE,2013,330,330,0,100.0,0.0,Female
EPHRAIM,2013,7,0,7,0.0,100.0,Male
ELWAN,2013,21,0,21,0.0,100.0,Male
ELIJAH,2013,3493,257,3236,7.357572287432007,92.642427712568,Male
JEMMY,2013,10,0,10,0.0,100.0,Male
THAYS,2013,372,264,108,70.96774193548387,29.03225806451613,Unisex
KENZY,2013,1392,384,1008,27.58620689655172,72.41379310344827,Unisex
WARIS,2013,133,41,92,30.82706766917293,69.17293233082707,Unisex
LEV,2013,157,56,101,35.6687898089172,64.3312101910828,Unisex
YULIA,2014,10,10,0,100.0,0.0,Female
CATHARINA,2014,3,3,0,100.0,0.0,Female
LEONORE,2014,39,39,0,100.0,0.0,Female
KISLY,2014,4,4,0,100.0,0.0,Female
ENAEL,2014,26,0,26,0.0,100.0,Male
MATHIOU,2014,4,0,4,0.0,100.0,Male
ABDELATIF,2014,5,0,5,0.0,100.0,Male
SHAKIR,2014,3,0,3,0.0,100.0,Male
BROOKLYN,2014,401,244,157,60.84788029925187,39.15211970074813,Unisex
WISSAM,2014,2491,451,2040,18.105178643115213,81.89482135688479,Unisex
MADY,2014,2286,1197,1089,52.362204724409445,47.63779527559055,Unisex
SYAM,2014,190,114,76,60.0,40.0,Unisex
MAELLYS,2015,3,3,0,100.0,0.0,Female
JUANITA,2015,3,3,0,100.0,0.0,Female
MARIAME,2015,85,85,0,100.0,0.0,Female
ELAÏA,2015,68,68,0,100.0,0.0,Female
HANAD,2015,3,0,3,0.0,100.0,Male
FIRAS,2015,47,0,47,0.0,100.0,Male
GLEN,2015,5,0,5,0.0,100.0,Male
KLAUS,2015,5,0,5,0.0,100.0,Male
MANOHA,2015,201,62,139,30.845771144278604,69.15422885572139,Unisex
AKIRA,2015,262,78,184,29.77099236641221,70.22900763358778,Unisex
SULTAN,2015,775,518,257,66.83870967741935,33.16129032258065,Unisex
IHSSANE,2015,424,352,72,83.01886792452831,16.9811320754717,Unisex
KATALYNA,2016,21,21,0,100.0,0.0,Female
GHISLAINE,2016,3,3,0,100.0,0.0,Female
LYRA,2016,16,16,0,100.0,0.0,Female
KHELIA,2016,3,3,0,100.0,0.0,Female
EDINSON,2016,3,0,3,0.0,100.0,Male
RACHIDI,2016,6,0,6,0.0,100.0,Male
ZYAD,2016,87,0,87,0.0,100.0,Male
JULES,2016,5034,0,5034,0.0,100.0,Male
EDENN,2016,318,153,165,48.11320754716981,51.886792452830186,Unisex
ISLEM,2016,2699,701,1998,25.972582437939977,74.02741756206002,Unisex
CYANN,2016,327,277,50,84.70948012232415,15.29051987767584,Unisex
THAYS,2016,372,264,108,70.96774193548387,29.03225806451613,Unisex
ÉLYSE,2017,6,6,0,100.0,0.0,Female
MEILYNE,2017,4,4,0,100.0,0.0,Female
CLÉO,2017,3124,2853,271,91.32522407170296,8.674775928297056,Female
HADIDJA,2017,25,25,0,100.0,0.0,Female
ISAAC,2017,1275,0,1275,0.0,100.0,Male
SELMÈNE,2017,3,0,3,0.0,100.0,Male
TAHAR,2017,23,0,23,0.0,100.0,Male
MASSOUD,2017,4,0,4,0.0,100.0,Male
ZANA,2017,246,179,67,72.76422764227642,27.235772357723576,Unisex
OLWEN,2017,206,135,71,65.53398058252428,34.46601941747573,Unisex
KABA,2017,229,87,142,37.99126637554585,62.00873362445415,Unisex
LOANN,2017,4020,941,3079,23.40796019900497,76.59203980099502,Unisex
ACILE,2018,8,8,0,100.0,0.0,Female
NORMA,2018,8,8,0,100.0,0.0,Female
NOURANE,2018,38,38,0,100.0,0.0,Female
JULIETTE,2018,2163,2163,0,100.0,0.0,Female
PIERRE-EMMANUEL,2018,8,0,8,0.0,100.0,Male
KANDJOURA,2018,6,0,6,0.0,100.0,Male
ENVEL,2018,5,0,5,0.0,100.0,Male
ANISH,2018,5,0,5,0.0,100.0,Male
KAYLANE,2018,117,46,71,39.31623931623932,60.68376068376068,Unisex
SIDJY,2018,159,95,64,59.74842767295597,40.25157232704403,Unisex
MISCHA,2018,106,37,69,34.90566037735849,65.09433962264151,Unisex
TASLIM,2018,276,207,69,75.0,25.0,Unisex
JULIET,2019,11,11,0,100.0,0.0,Female
AËLYNN,2019,9,9,0,100.0,0.0,Female
KAYLIS,2019,5,5,0,100.0,0.0,Female
YSÉ,2019,35,35,0,100.0,0.0,Female
SAÏM,2019,5,0,5,0.0,100.0,Male
AKEEM,2019,6,0,6,0.0,100.0,Male
ALEN,2019,17,0,17,0.0,100.0,Male
LUKAS,2019,221,0,221,0.0,100.0,Male
MOANA,2019,1034,769,265,74.37137330754352,25.62862669245648,Unisex
MILANE,2019,634,298,336,47.003154574132495,52.99684542586751,Unisex
MALONNE,2019,116,36,80,31.03448275862069,68.96551724137932,Unisex
AVERY,2019,77,35,42,45.45454545454545,54.54545454545454,Unisex
LINA,2020,2743,2743,0,100.0,0.0,Female
NAFISSATOU,2020,18,18,0,100.0,0.0,Female
MYLANNA,2020,5,5,0,100.0,0.0,Female
ALEYAH,2020,12,12,0,100.0,0.0,Female
YEZID,2020,3,0,3,0.0,100.0,Male
MORAD,2020,7,0,7,0.0,100.0,Male
KAMEL,2020,39,0,39,0.0,100.0,Male
WILSON,2020,31,0,31,0.0,100.0,Male
NGOC,2020,641,437,204,68.17472698907956,31.82527301092044,Unisex
SHALOM,2020,167,56,111,33.532934131736525,66.46706586826348,Unisex
RAFA,2020,53,23,30,43.39622641509434,56.60377358490566,Unisex
BLESSING,2020,427,344,83,80.56206088992974,19.437939110070257,Unisex
AISSATOU,2021,24,24,0,100.0,0.0,Female
ÉLIANE,2021,13,13,0,100.0,0.0,Female
JANNAT,2021,66,66,0,100.0,0.0,Female
YLLONA,2021,7,7,0,100.0,0.0,Female
MEYSON,2021,14,0,14,0.0,100.0,Male
STEFANO,2021,4,0,4,0.0,100.0,Male
KSAWERY,2021,3,0,3,0.0,100.0,Male
TAHAR,2021,15,0,15,0.0,100.0,Male
DARA,2021,349,151,198,43.26647564469914,56.73352435530086,Unisex
TAÏS,2021,979,689,290,70.3779366700715,29.6220633299285,Unisex
JOA,2021,198,83,115,41.91919191919192,58.08080808080808,Unisex
VICTORY,2021,168,134,34,79.76190476190477,20.23809523809524,Unisex
ESSYA,2022,9,9,0,100.0,0.0,Female
HELGA,2022,4,4,0,100.0,0.0,Female
TASSNIM,2022,17,17,0,100.0,0.0,Female
MAÏVY,2022,7,7,0,100.0,0.0,Female
GIANLUCA,2022,6,0,6,0.0,100.0,Male
ETAN,2022,17,0,17,0.0,100.0,Male
MAZEN,2022,24,0,24,0.0,100.0,Male
ABDOUL-AZIZ,2022,13,0,13,0.0,100.0,Male
KEZIAH,2022,1699,467,1232,27.48675691583284,72.51324308416716,Unisex
ISAÉ,2022,115,81,34,70.43478260869566,29.565217391304348,Unisex
KINSLEY,2022,776,212,564,27.31958762886598,72.68041237113401,Unisex
MALOÉ,2022,1021,734,287,71.89030362389815,28.109696376101866,Unisex
