Name,Year,Total_sum,Female_count,Male_count,Female_percentage,Male_percentage,Gender
JOSEPHA,1908,17,17,0,100.0,0.0,Female
URBANIE,1908,3,3,0,100.0,0.0,Female
VITALINE,1908,24,24,0,100.0,0.0,Female
ALBERTE,1908,96,96,0,100.0,0.0,Female
JUDITH,1908,55,55,0,100.0,0.0,Female
DARIE,1908,4,4,0,100.0,0.0,Female
EUPHRASIE,1908,71,71,0,100.0,0.0,Female
ANNONCIADE,1908,32,32,0,100.0,0.0,Female
ANNITA,1908,12,12,0,100.0,0.0,Female
APPOLONIE,1908,16,16,0,100.0,0.0,Female
ZENOBIE,1908,7,7,0,100.0,0.0,Female
JULIANE,1908,5,5,0,100.0,0.0,Female
BERTILDE,1908,3,3,0,100.0,0.0,Female
SONIA,1908,5,5,0,100.0,0.0,Female
DORIA,1908,29,29,0,100.0,0.0,Female
REMISE,1908,3,3,0,100.0,0.0,Female
MARIE-PAULINE,1908,3,3,0,100.0,0.0,Female
THEODORA,1908,25,25,0,100.0,0.0,Female
ISOLINE,1908,7,7,0,100.0,0.0,Female
JOSEPHINE,1908,2917,2917,0,100.0,0.0,Female
ANITA,1908,38,38,0,100.0,0.0,Female
GERMINALE,1908,3,3,0,100.0,0.0,Female
ALFREDE,1908,3,3,0,100.0,0.0,Female
HERVELINE,1908,11,11,0,100.0,0.0,Female
LISBETH,1908,3,3,0,100.0,0.0,Female
JULIEN,1908,1616,0,1616,0.0,100.0,Male
MARIANO,1908,7,0,7,0.0,100.0,Male
SADI,1908,7,0,7,0.0,100.0,Male
LEONUS,1908,3,0,3,0.0,100.0,Male
MARCIEN,1908,5,0,5,0.0,100.0,Male
ALBIN,1908,59,0,59,0.0,100.0,Male
ALBERT,1908,4699,0,4699,0.0,100.0,Male
BERNARDIN,1908,18,0,18,0.0,100.0,Male
AMAURY,1908,5,0,5,0.0,100.0,Male
LUCIEN,1908,4312,0,4312,0.0,100.0,Male
MATHIAS,1908,63,0,63,0.0,100.0,Male
CASIMIR,1908,102,0,102,0.0,100.0,Male
HYPOLYTE,1908,6,0,6,0.0,100.0,Male
SABAS,1908,3,0,3,0.0,100.0,Male
THEOTIME,1908,4,0,4,0.0,100.0,Male
OSWALD,1908,13,0,13,0.0,100.0,Male
MODERAN,1908,6,0,6,0.0,100.0,Male
HIPPOLYTE,1908,207,0,207,0.0,100.0,Male
WENDELIN,1908,3,0,3,0.0,100.0,Male
STEPHEN,1908,8,0,8,0.0,100.0,Male
NORBERT,1908,191,0,191,0.0,100.0,Male
JOSEPHIN,1908,4,0,4,0.0,100.0,Male
HAROLD,1908,5,0,5,0.0,100.0,Male
BARTHELEMI,1908,14,0,14,0.0,100.0,Male
GEROME,1908,10,0,10,0.0,100.0,Male
CAMILLE,1908,287709,207732,79977,72.20212089298562,27.79787910701437,Unisex
PULCHERIE,1908,738,579,159,78.45528455284553,21.54471544715448,Unisex
PHILOGONE,1908,396,183,213,46.21212121212121,53.78787878787878,Unisex
AVIT,1908,485,106,379,21.855670103092784,78.14432989690722,Unisex
BONIFACE,1908,1187,217,970,18.28138163437237,81.71861836562763,Unisex
SULPICE,1908,508,182,326,35.826771653543304,64.1732283464567,Unisex
WENCESLAS,1908,877,175,702,19.95438996579248,80.04561003420753,Unisex
EULOGE,1908,621,198,423,31.88405797101449,68.11594202898551,Unisex
MESMIN,1908,773,183,590,23.67399741267788,76.32600258732212,Unisex
LEONIDE,1908,1588,1245,343,78.40050377833752,21.599496221662463,Unisex
MODESTE,1908,1853,656,1197,35.4020507285483,64.59794927145171,Unisex
SAINTE,1908,1055,648,407,61.4218009478673,38.5781990521327,Unisex
SEPTIME,1908,394,119,275,30.20304568527919,69.79695431472082,Unisex
LEONCE,1908,9290,2041,7249,21.96986006458557,78.03013993541443,Unisex
MARY,1908,6861,5830,1031,84.97303600058301,15.026963999416996,Unisex
_PRENOMS_RARES,1908,1760252,908578,851674,51.616359475802334,48.38364052419767,Unisex
AMOUR,1908,782,287,495,36.70076726342711,63.29923273657288,Unisex
CRESCENT,1908,447,87,360,19.463087248322147,80.53691275167785,Unisex
HYACINTHE,1908,4679,1173,3506,25.069459286172258,74.93054071382774,Unisex
SCHOLASTIQUE,1908,1080,835,245,77.31481481481481,22.685185185185187,Unisex
NONCE,1908,598,172,426,28.762541806020064,71.23745819397993,Unisex
SOSTHENE,1908,1059,185,874,17.469310670443818,82.53068932955618,Unisex
PLACIDE,1908,1098,214,884,19.489981785063755,80.51001821493625,Unisex
ANTONIE,1908,986,749,237,75.9634888438134,24.036511156186613,Unisex
NICOMEDE,1908,430,193,237,44.88372093023256,55.11627906976744,Unisex
ANGELA,1909,17,17,0,100.0,0.0,Female
LAURETTE,1909,24,24,0,100.0,0.0,Female
ELIZE,1909,4,4,0,100.0,0.0,Female
ROSINE,1909,175,175,0,100.0,0.0,Female
LISE,1909,42,42,0,100.0,0.0,Female
MATHILDE,1909,1008,1008,0,100.0,0.0,Female
EDESE,1909,3,3,0,100.0,0.0,Female
VIVIENNE,1909,21,21,0,100.0,0.0,Female
ZENOBIE,1909,8,8,0,100.0,0.0,Female
DOCTROVEE,1909,3,3,0,100.0,0.0,Female
MARIE-SAINTE,1909,3,3,0,100.0,0.0,Female
NOELE,1909,41,41,0,100.0,0.0,Female
LILLY,1909,7,7,0,100.0,0.0,Female
BARBE,1909,3019,2623,396,86.88307386551838,13.116926134481616,Female
DOROTHE,1909,3,3,0,100.0,0.0,Female
VINCIENNE,1909,3,3,0,100.0,0.0,Female
SIDONIE,1909,184,184,0,100.0,0.0,Female
EUGÉNIE,1909,2419,2419,0,100.0,0.0,Female
MARIE-AUGUSTINE,1909,7,7,0,100.0,0.0,Female
RUFINE,1909,5,5,0,100.0,0.0,Female
SYLVESTINE,1909,5,5,0,100.0,0.0,Female
OLGA,1909,24745,24580,165,99.33319862598503,0.6668013740149525,Female
AURELIA,1909,11,11,0,100.0,0.0,Female
YVETTE,1909,611,611,0,100.0,0.0,Female
JULIENNE,1909,1036,1036,0,100.0,0.0,Female
ROBIN,1909,3,0,3,0.0,100.0,Male
JOANNES,1909,216,0,216,0.0,100.0,Male
PAUL,1909,6604,0,6604,0.0,100.0,Male
SAINT-CYR,1909,3,0,3,0.0,100.0,Male
HOMERE,1909,4,0,4,0.0,100.0,Male
BERTHIER,1909,3,0,3,0.0,100.0,Male
BRUNO,1909,220842,164,220678,0.0742612365401508,99.92573876345983,Male
CONRAD,1909,9,0,9,0.0,100.0,Male
PHILIBERT,1909,78,0,78,0.0,100.0,Male
SALVAT,1909,8,0,8,0.0,100.0,Male
JEAN-ANDRÉ,1909,5,0,5,0.0,100.0,Male
DESIR,1909,11,0,11,0.0,100.0,Male
ADELSON,1909,6,0,6,0.0,100.0,Male
DINO,1909,3,0,3,0.0,100.0,Male
BERNARDIN,1909,16,0,16,0.0,100.0,Male
ANSBERT,1909,3,0,3,0.0,100.0,Male
ROLF,1909,3,0,3,0.0,100.0,Male
CHERI,1909,5,0,5,0.0,100.0,Male
JEAN-CLAUDE,1909,18,0,18,0.0,100.0,Male
OPTAT,1909,4,0,4,0.0,100.0,Male
RENAUD,1909,18,0,18,0.0,100.0,Male
JOANES,1909,5,0,5,0.0,100.0,Male
GABRIEL,1909,1941,0,1941,0.0,100.0,Male
NAPOLEON,1909,9,0,9,0.0,100.0,Male
ALI,1909,6,0,6,0.0,100.0,Male
BONIFACE,1909,1187,217,970,18.28138163437237,81.71861836562763,Unisex
MARY,1909,6861,5830,1031,84.97303600058301,15.026963999416996,Unisex
LEONIDE,1909,1588,1245,343,78.40050377833752,21.599496221662463,Unisex
VENANCE,1909,314,123,191,39.171974522293,60.828025477707,Unisex
ALIX,1909,37305,28371,8934,76.05146763168477,23.94853236831524,Unisex
MARIE-JOSEPH,1909,2275,1830,445,80.43956043956044,19.56043956043956,Unisex
PLACIDE,1909,1098,214,884,19.489981785063755,80.51001821493625,Unisex
IRENEE,1909,6155,1854,4301,30.121852152721363,69.87814784727864,Unisex
ENOGAT,1909,274,80,194,29.1970802919708,70.8029197080292,Unisex
NONCE,1909,598,172,426,28.762541806020064,71.23745819397993,Unisex
SULPICE,1909,508,182,326,35.826771653543304,64.1732283464567,Unisex
CALIXTE,1909,3347,540,2807,16.13385121003884,83.86614878996116,Unisex
EULOGE,1909,621,198,423,31.88405797101449,68.11594202898551,Unisex
EUSEBE,1909,1151,212,939,18.41876629018245,81.58123370981755,Unisex
ANTONIE,1909,986,749,237,75.9634888438134,24.036511156186613,Unisex
NICAISE,1909,1786,1255,531,70.26875699888018,29.73124300111982,Unisex
LEONCE,1909,9290,2041,7249,21.96986006458557,78.03013993541443,Unisex
CANDIDE,1909,1019,686,333,67.32090284592738,32.67909715407262,Unisex
LIE,1909,328,80,248,24.390243902439025,75.60975609756098,Unisex
EUSTACHE,1909,1376,277,1099,20.13081395348837,79.86918604651163,Unisex
_PRENOMS_RARES,1909,1760252,908578,851674,51.616359475802334,48.38364052419767,Unisex
PHILOGONE,1909,396,183,213,46.21212121212121,53.78787878787878,Unisex
GEORGE,1909,2417,650,1767,26.89284236657013,73.10715763342988,Unisex
TIBURCE,1909,1019,212,807,20.80471050049068,79.19528949950933,Unisex
SABAS,1909,607,220,387,36.24382207578254,63.75617792421746,Unisex
MARIE-ROSALIE,1910,3,3,0,100.0,0.0,Female
AMELINA,1910,13,13,0,100.0,0.0,Female
GUILLAUMINE,1910,7,7,0,100.0,0.0,Female
PERINE,1910,6,6,0,100.0,0.0,Female
CAMILLIA,1910,9,9,0,100.0,0.0,Female
LUCE,1910,8936,8291,645,92.78200537153089,7.217994628469114,Female
NICOLINE,1910,3,3,0,100.0,0.0,Female
ADRIENNE,1910,1228,1228,0,100.0,0.0,Female
REYMONDE,1910,19,19,0,100.0,0.0,Female
AZELINE,1910,20,20,0,100.0,0.0,Female
ANTOINETTE,1910,1785,1785,0,100.0,0.0,Female
RAIMONDE,1910,15,15,0,100.0,0.0,Female
RINA,1910,6,6,0,100.0,0.0,Female
OLGA,1910,609,609,0,100.0,0.0,Female
MATHURINE,1910,24,24,0,100.0,0.0,Female
FERDINANDE,1910,10,10,0,100.0,0.0,Female
ALBERTE,1910,112,112,0,100.0,0.0,Female
MAGDELAINE,1910,14,14,0,100.0,0.0,Female
ZILDA,1910,8,8,0,100.0,0.0,Female
SONIA,1910,17,17,0,100.0,0.0,Female
CONSTANCE,1910,166,166,0,100.0,0.0,Female
ADA,1910,6,6,0,100.0,0.0,Female
URANIE,1910,10,10,0,100.0,0.0,Female
BRIGITTE,1910,46,46,0,100.0,0.0,Female
HERMANCE,1910,73,73,0,100.0,0.0,Female
MAX,1910,205,0,205,0.0,100.0,Male
WILHELM,1910,6,0,6,0.0,100.0,Male
SIMON,1910,276,0,276,0.0,100.0,Male
FRANCIS,1910,788,0,788,0.0,100.0,Male
FERRER,1910,8,0,8,0.0,100.0,Male
BERNABE,1910,4,0,4,0.0,100.0,Male
JEAN-CHARLES,1910,5,0,5,0.0,100.0,Male
JEAN-JACQUES,1910,16,0,16,0.0,100.0,Male
EPHREM,1910,5,0,5,0.0,100.0,Male
KLEBER,1910,282,0,282,0.0,100.0,Male
NAPOLEON,1910,11,0,11,0.0,100.0,Male
HUMBERT,1910,7,0,7,0.0,100.0,Male
ENNEMOND,1910,5,0,5,0.0,100.0,Male
LANDRY,1910,7,0,7,0.0,100.0,Male
ARMANDO,1910,4,0,4,0.0,100.0,Male
ARTHEMON,1910,6,0,6,0.0,100.0,Male
EDMOND,1910,54702,109,54593,0.1992614529633286,99.80073854703669,Male
GERAUD,1910,13,0,13,0.0,100.0,Male
HENRI,1910,9354,0,9354,0.0,100.0,Male
IMBERT,1910,3,0,3,0.0,100.0,Male
HENRY,1910,133,0,133,0.0,100.0,Male
STANISLAS,1910,21493,388,21105,1.80523891499558,98.19476108500442,Male
TANGUY,1910,3,0,3,0.0,100.0,Male
JEAN-PAUL,1910,23,0,23,0.0,100.0,Male
HONORIUS,1910,3,0,3,0.0,100.0,Male
MODESTE,1910,1853,656,1197,35.4020507285483,64.59794927145171,Unisex
GEORGE,1910,2417,650,1767,26.89284236657013,73.10715763342988,Unisex
CANDIDE,1910,1019,686,333,67.32090284592738,32.67909715407262,Unisex
ALZIRE,1910,117,83,34,70.94017094017094,29.059829059829063,Unisex
TIBURCE,1910,1019,212,807,20.80471050049068,79.19528949950933,Unisex
AMOUR,1910,782,287,495,36.70076726342711,63.29923273657288,Unisex
ANTONIE,1910,986,749,237,75.9634888438134,24.036511156186613,Unisex
IRENEE,1910,6155,1854,4301,30.121852152721363,69.87814784727864,Unisex
EULOGE,1910,621,198,423,31.88405797101449,68.11594202898551,Unisex
CALIXTE,1910,3347,540,2807,16.13385121003884,83.86614878996116,Unisex
MESMIN,1910,773,183,590,23.67399741267788,76.32600258732212,Unisex
NICOMEDE,1910,430,193,237,44.88372093023256,55.11627906976744,Unisex
MAMERT,1910,224,75,149,33.482142857142854,66.51785714285714,Unisex
SAINTE,1910,1055,648,407,61.4218009478673,38.5781990521327,Unisex
MARY,1910,6861,5830,1031,84.97303600058301,15.026963999416996,Unisex
MEDARD,1910,1076,175,901,16.263940520446095,83.7360594795539,Unisex
THIMOTHEE,1910,509,100,409,19.64636542239685,80.35363457760315,Unisex
FIDELE,1910,793,162,631,20.42875157629256,79.57124842370744,Unisex
SCHOLASTIQUE,1910,1080,835,245,77.31481481481481,22.685185185185187,Unisex
NONCE,1910,598,172,426,28.762541806020064,71.23745819397993,Unisex
SOSTHENE,1910,1059,185,874,17.469310670443818,82.53068932955618,Unisex
DOMINIQUE,1910,409989,168027,241962,40.98329467375954,59.01670532624046,Unisex
LEONIDE,1910,1588,1245,343,78.40050377833752,21.599496221662463,Unisex
ERNESTE,1910,189,104,85,55.02645502645503,44.97354497354497,Unisex
LEONCE,1910,9290,2041,7249,21.96986006458557,78.03013993541443,Unisex
CHERIE,1911,3,3,0,100.0,0.0,Female
BRUNETTE,1911,3,3,0,100.0,0.0,Female
HELYETT,1911,4,4,0,100.0,0.0,Female
IRÈNE,1911,83934,82102,1832,97.81733266614243,2.182667333857555,Female
PEPINA,1911,3,3,0,100.0,0.0,Female
LEONNE,1911,51,51,0,100.0,0.0,Female
RESTITUDE,1911,7,7,0,100.0,0.0,Female
CLEMENCIA,1911,7,7,0,100.0,0.0,Female
FERNANDA,1911,5,5,0,100.0,0.0,Female
BÉATRICE,1911,47,47,0,100.0,0.0,Female
MANON,1911,5,5,0,100.0,0.0,Female
MARIE-FERNANDE,1911,4,4,0,100.0,0.0,Female
MARYVONNE,1911,3,3,0,100.0,0.0,Female
ALBERTINA,1911,3,3,0,100.0,0.0,Female
MARTINE,1911,62,62,0,100.0,0.0,Female
MARIE-LUCIENNE,1911,3,3,0,100.0,0.0,Female
PRAXEDE,1911,3,3,0,100.0,0.0,Female
THEODORINE,1911,10,10,0,100.0,0.0,Female
JOSETTE,1911,80,80,0,100.0,0.0,Female
EUPHEMIE,1911,8,8,0,100.0,0.0,Female
CLADIE,1911,18,18,0,100.0,0.0,Female
ASSOMPTION,1911,5,5,0,100.0,0.0,Female
SIMONE,1911,3581,3581,0,100.0,0.0,Female
ROSETTE,1911,24,24,0,100.0,0.0,Female
LOTTE,1911,5,5,0,100.0,0.0,Female
EDWIN,1911,4,0,4,0.0,100.0,Male
THERESIUS,1911,3,0,3,0.0,100.0,Male
EPIPHANE,1911,647,41,606,6.33693972179289,93.66306027820713,Male
ALCIDE,1911,96,0,96,0.0,100.0,Male
ROMÉO,1911,13,0,13,0.0,100.0,Male
JOANNY,1911,76,0,76,0.0,100.0,Male
RODOLPHE,1911,101,0,101,0.0,100.0,Male
RAPHAËL,1911,151489,237,151252,0.1564470027526751,99.84355299724731,Male
LUIS,1911,5,0,5,0.0,100.0,Male
ROMUALD,1911,12,0,12,0.0,100.0,Male
JACOB,1911,27,0,27,0.0,100.0,Male
VINCENT,1911,232844,372,232472,0.159763618560066,99.84023638143992,Male
FRANÇOIS,1911,398930,252,398678,0.0631689770135111,99.9368310229865,Male
VALERE,1911,3267,196,3071,5.9993878175696365,94.00061218243036,Male
CRESCENT,1911,5,0,5,0.0,100.0,Male
SAINTE-CROIX,1911,9,0,9,0.0,100.0,Male
HEINZ,1911,10,0,10,0.0,100.0,Male
JEREMIE,1911,20,0,20,0.0,100.0,Male
NORBERT,1911,192,0,192,0.0,100.0,Male
SANTO,1911,3,0,3,0.0,100.0,Male
JEHAN,1911,9,0,9,0.0,100.0,Male
SALVAT,1911,3,0,3,0.0,100.0,Male
TREMEUR,1911,5,0,5,0.0,100.0,Male
VITAL,1911,64,0,64,0.0,100.0,Male
WILLI,1911,3,0,3,0.0,100.0,Male
SCHOLASTIQUE,1911,1080,835,245,77.31481481481481,22.685185185185187,Unisex
LEONCE,1911,9290,2041,7249,21.96986006458557,78.03013993541443,Unisex
LEONIDE,1911,1588,1245,343,78.40050377833752,21.599496221662463,Unisex
SAINTE,1911,1055,648,407,61.4218009478673,38.5781990521327,Unisex
AVIT,1911,485,106,379,21.855670103092784,78.14432989690722,Unisex
HONORAT,1911,652,270,382,41.41104294478527,58.58895705521472,Unisex
VENANCE,1911,314,123,191,39.171974522293,60.828025477707,Unisex
CLOUD,1911,101,34,67,33.663366336633665,66.33663366336634,Unisex
PEPIN,1911,533,126,407,23.63977485928705,76.36022514071294,Unisex
MODESTE,1911,1853,656,1197,35.4020507285483,64.59794927145171,Unisex
MARY,1911,6861,5830,1031,84.97303600058301,15.026963999416996,Unisex
MEDARD,1911,1076,175,901,16.263940520446095,83.7360594795539,Unisex
EULOGE,1911,621,198,423,31.88405797101449,68.11594202898551,Unisex
_PRENOMS_RARES,1911,1760252,908578,851674,51.616359475802334,48.38364052419767,Unisex
CAMILLE,1911,287709,207732,79977,72.20212089298562,27.79787910701437,Unisex
ARCADE,1911,883,249,634,28.199320498301244,71.80067950169875,Unisex
CALIXTE,1911,3347,540,2807,16.13385121003884,83.86614878996116,Unisex
ANTONIE,1911,986,749,237,75.9634888438134,24.036511156186613,Unisex
MERY,1911,515,409,106,79.41747572815534,20.58252427184466,Unisex
HYACINTHE,1911,4679,1173,3506,25.069459286172258,74.93054071382774,Unisex
EUSEBE,1911,1151,212,939,18.41876629018245,81.58123370981755,Unisex
FIDELE,1911,793,162,631,20.42875157629256,79.57124842370744,Unisex
APPOLINAIRE,1911,632,126,506,19.93670886075949,80.0632911392405,Unisex
PULCHERIE,1911,738,579,159,78.45528455284553,21.54471544715448,Unisex
BONIFACE,1911,1187,217,970,18.28138163437237,81.71861836562763,Unisex
ARTEMISE,1912,7,7,0,100.0,0.0,Female
MARIE-ANGÈLE,1912,9,9,0,100.0,0.0,Female
LUCETTE,1912,349,349,0,100.0,0.0,Female
LUCILLE,1912,13,13,0,100.0,0.0,Female
ERMINIA,1912,7,7,0,100.0,0.0,Female
INGEBORG,1912,6,6,0,100.0,0.0,Female
GRATIANNE,1912,13,13,0,100.0,0.0,Female
MARCIENNE,1912,4,4,0,100.0,0.0,Female
HONORINE,1912,95,95,0,100.0,0.0,Female
THEOTINE,1912,3,3,0,100.0,0.0,Female
PASCALINE,1912,54,54,0,100.0,0.0,Female
ELMIRE,1912,18,18,0,100.0,0.0,Female
MINATCHY,1912,6,6,0,100.0,0.0,Female
APOLINE,1912,5,5,0,100.0,0.0,Female
ALINE,1912,799,799,0,100.0,0.0,Female
ALVINE,1912,7,7,0,100.0,0.0,Female
ADELINA,1912,27,27,0,100.0,0.0,Female
GISÈLE,1912,803,803,0,100.0,0.0,Female
GUILLAUMETTE,1912,18,18,0,100.0,0.0,Female
ANTOINISE,1912,11,11,0,100.0,0.0,Female
AGNÈS,1912,113215,112939,276,99.75621604911012,0.2437839508898997,Female
IRMINE,1912,9,9,0,100.0,0.0,Female
ANDRÉE,1912,4237,4237,0,100.0,0.0,Female
BÉRÉNICE,1912,5,5,0,100.0,0.0,Female
MODESTINE,1912,7,7,0,100.0,0.0,Female
ARSENE,1912,15051,1013,14038,6.730449803999735,93.26955019600028,Male
MAXENCE,1912,63942,808,63134,1.263645178442964,98.73635482155704,Male
HELMUTH,1912,15,0,15,0.0,100.0,Male
JULES,1912,2425,0,2425,0.0,100.0,Male
EDMOND,1912,1354,0,1354,0.0,100.0,Male
MATHIEU,1912,152579,195,152384,0.1278026464978797,99.87219735350212,Male
ULISSE,1912,5,0,5,0.0,100.0,Male
ACHILLE,1912,227,0,227,0.0,100.0,Male
ABDON,1912,19,0,19,0.0,100.0,Male
ERWIN,1912,23,0,23,0.0,100.0,Male
WILLIBALD,1912,3,0,3,0.0,100.0,Male
ROBERT,1912,419334,152,419182,0.0362479550906914,99.9637520449093,Male
JOANES,1912,7,0,7,0.0,100.0,Male
ENNEMOND,1912,7,0,7,0.0,100.0,Male
HELIER,1912,8,0,8,0.0,100.0,Male
FRANK,1912,9,0,9,0.0,100.0,Male
MATHURIN,1912,6007,75,5932,1.2485433660729148,98.75145663392708,Male
BAYARD,1912,4,0,4,0.0,100.0,Male
SIEGFRIED,1912,8,0,8,0.0,100.0,Male
TUDY,1912,3,0,3,0.0,100.0,Male
SOSTHENES,1912,3,0,3,0.0,100.0,Male
JOACHIM,1912,131,0,131,0.0,100.0,Male
JEROME,1912,106,0,106,0.0,100.0,Male
ANGE,1912,21831,2649,19182,12.134121203792771,87.86587879620723,Male
WENCESLAS,1912,5,0,5,0.0,100.0,Male
EUSEBE,1912,1151,212,939,18.41876629018245,81.58123370981755,Unisex
BABYLAS,1912,330,98,232,29.6969696969697,70.3030303030303,Unisex
HYACINTHE,1912,4679,1173,3506,25.069459286172258,74.93054071382774,Unisex
CREPIN,1912,606,136,470,22.44224422442244,77.55775577557755,Unisex
SABAS,1912,607,220,387,36.24382207578254,63.75617792421746,Unisex
PLACIDE,1912,1098,214,884,19.489981785063755,80.51001821493625,Unisex
SIMPLICE,1912,329,106,223,32.21884498480243,67.78115501519757,Unisex
ALIX,1912,37305,28371,8934,76.05146763168477,23.94853236831524,Unisex
DOMINIQUE,1912,409989,168027,241962,40.98329467375954,59.01670532624046,Unisex
MARIE-JOSEPH,1912,2275,1830,445,80.43956043956044,19.56043956043956,Unisex
LEONCE,1912,9290,2041,7249,21.96986006458557,78.03013993541443,Unisex
_PRENOMS_RARES,1912,1760252,908578,851674,51.616359475802334,48.38364052419767,Unisex
EUTROPE,1912,194,70,124,36.08247422680412,63.91752577319587,Unisex
LEONIDE,1912,1588,1245,343,78.40050377833752,21.599496221662463,Unisex
SAINTE,1912,1055,648,407,61.4218009478673,38.5781990521327,Unisex
EUSTACHE,1912,1376,277,1099,20.13081395348837,79.86918604651163,Unisex
SEPTIME,1912,394,119,275,30.20304568527919,69.79695431472082,Unisex
NICAISE,1912,1786,1255,531,70.26875699888018,29.73124300111982,Unisex
AMOUR,1912,782,287,495,36.70076726342711,63.29923273657288,Unisex
MARY,1912,6861,5830,1031,84.97303600058301,15.026963999416996,Unisex
SULPICE,1912,508,182,326,35.826771653543304,64.1732283464567,Unisex
AVIT,1912,485,106,379,21.855670103092784,78.14432989690722,Unisex
PHILOGONE,1912,396,183,213,46.21212121212121,53.78787878787878,Unisex
NONCE,1912,598,172,426,28.762541806020064,71.23745819397993,Unisex
BONIFACE,1912,1187,217,970,18.28138163437237,81.71861836562763,Unisex
MICHÈLE,1913,7,7,0,100.0,0.0,Female
HERMINIE,1913,27,27,0,100.0,0.0,Female
MARIAYE,1913,4,4,0,100.0,0.0,Female
BERNARDINE,1913,41,41,0,100.0,0.0,Female
EMILIE,1913,823,823,0,100.0,0.0,Female
MARIE-LOUISE,1913,1222,1222,0,100.0,0.0,Female
EDMONDE,1913,86,86,0,100.0,0.0,Female
JANINE,1913,53,53,0,100.0,0.0,Female
NADIA,1913,12,12,0,100.0,0.0,Female
AIDA,1913,11,11,0,100.0,0.0,Female
AMINTHE,1913,6,6,0,100.0,0.0,Female
ELLEN,1913,6,6,0,100.0,0.0,Female
THEODORINE,1913,9,9,0,100.0,0.0,Female
MARIE-ANNA,1913,5,5,0,100.0,0.0,Female
CLAIRETTE,1913,8,8,0,100.0,0.0,Female
MARIE-MARGUERITE,1913,9,9,0,100.0,0.0,Female
SIMONNE,1913,3915,3915,0,100.0,0.0,Female
EGLANTINE,1913,93,93,0,100.0,0.0,Female
NICOLLE,1913,3,3,0,100.0,0.0,Female
LIESELOTTE,1913,5,5,0,100.0,0.0,Female
LEOPOLDINE,1913,22,22,0,100.0,0.0,Female
JULIE,1913,610,610,0,100.0,0.0,Female
CRESCENCE,1913,4,4,0,100.0,0.0,Female
SILVIANE,1913,5,5,0,100.0,0.0,Female
ERMINIE,1913,5,5,0,100.0,0.0,Female
HEINZ,1913,8,0,8,0.0,100.0,Male
FRANZ,1913,4,0,4,0.0,100.0,Male
FLORIS,1913,4,0,4,0.0,100.0,Male
ANSELME,1913,4091,343,3748,8.384258127597164,91.61574187240284,Male
DELPHIN,1913,29,0,29,0.0,100.0,Male
REMO,1913,10,0,10,0.0,100.0,Male
ERASME,1913,5,0,5,0.0,100.0,Male
AGENOR,1913,3,0,3,0.0,100.0,Male
MAURICE,1913,337720,568,337152,0.1681866635082316,99.83181333649178,Male
FLORENT,1913,89,0,89,0.0,100.0,Male
GEROME,1913,9,0,9,0.0,100.0,Male
JEAN-PHILIPPE,1913,3,0,3,0.0,100.0,Male
JEAN-CLAUDE,1913,20,0,20,0.0,100.0,Male
FERNAND,1913,3214,0,3214,0.0,100.0,Male
JEAN-ROBERT,1913,3,0,3,0.0,100.0,Male
JEROME,1913,97,0,97,0.0,100.0,Male
THEODORE,1913,11887,223,11664,1.8759989904938168,98.12400100950616,Male
NONNA,1913,3,0,3,0.0,100.0,Male
HENRI,1913,9375,0,9375,0.0,100.0,Male
RIEUL,1913,4,0,4,0.0,100.0,Male
ARNAULD,1913,3,0,3,0.0,100.0,Male
SOUBAYA,1913,3,0,3,0.0,100.0,Male
EVENOR,1913,6,0,6,0.0,100.0,Male
VOLTAIRE,1913,31,0,31,0.0,100.0,Male
BAPTISTE,1913,246,0,246,0.0,100.0,Male
_PRENOMS_RARES,1913,1760252,908578,851674,51.616359475802334,48.38364052419767,Unisex
HEGESIPPE,1913,176,29,147,16.477272727272727,83.52272727272727,Unisex
ENOGAT,1913,274,80,194,29.1970802919708,70.8029197080292,Unisex
ANDOCHE,1913,390,140,250,35.8974358974359,64.1025641025641,Unisex
HYACINTHE,1913,4679,1173,3506,25.069459286172258,74.93054071382774,Unisex
MARY,1913,6861,5830,1031,84.97303600058301,15.026963999416996,Unisex
APPOLINAIRE,1913,632,126,506,19.93670886075949,80.0632911392405,Unisex
CAMILLE,1913,287709,207732,79977,72.20212089298562,27.79787910701437,Unisex
MEDARD,1913,1076,175,901,16.263940520446095,83.7360594795539,Unisex
WENCESLAS,1913,877,175,702,19.95438996579248,80.04561003420753,Unisex
ARCADE,1913,883,249,634,28.199320498301244,71.80067950169875,Unisex
EULOGE,1913,621,198,423,31.88405797101449,68.11594202898551,Unisex
SOSTHENE,1913,1059,185,874,17.469310670443818,82.53068932955618,Unisex
SABAS,1913,607,220,387,36.24382207578254,63.75617792421746,Unisex
CALIXTE,1913,3347,540,2807,16.13385121003884,83.86614878996116,Unisex
CRESCENT,1913,447,87,360,19.463087248322147,80.53691275167785,Unisex
MODESTE,1913,1853,656,1197,35.4020507285483,64.59794927145171,Unisex
IRENEE,1913,6155,1854,4301,30.121852152721363,69.87814784727864,Unisex
SAINTE,1913,1055,648,407,61.4218009478673,38.5781990521327,Unisex
DOMINIQUE,1913,409989,168027,241962,40.98329467375954,59.01670532624046,Unisex
LEONIDE,1913,1588,1245,343,78.40050377833752,21.599496221662463,Unisex
PHILOGONE,1913,396,183,213,46.21212121212121,53.78787878787878,Unisex
BONIFACE,1913,1187,217,970,18.28138163437237,81.71861836562763,Unisex
SAINTE-CROIX,1913,486,103,383,21.193415637860085,78.80658436213992,Unisex
GEORGE,1913,2417,650,1767,26.89284236657013,73.10715763342988,Unisex
AMANDE,1914,5,5,0,100.0,0.0,Female
ARTHEMISE,1914,17,17,0,100.0,0.0,Female
ALMAIDE,1914,4,4,0,100.0,0.0,Female
IRIDE,1914,3,3,0,100.0,0.0,Female
ELLI,1914,7,7,0,100.0,0.0,Female
BERTHILDE,1914,9,9,0,100.0,0.0,Female
ENGRACE,1914,7,7,0,100.0,0.0,Female
LIBERTE,1914,7,7,0,100.0,0.0,Female
ANNONCIATION,1914,4,4,0,100.0,0.0,Female
ROSITA,1914,9,9,0,100.0,0.0,Female
MARIE-AMÉLIE,1914,3,3,0,100.0,0.0,Female
GERVAISE,1914,20,20,0,100.0,0.0,Female
ISABELLE,1914,390,390,0,100.0,0.0,Female
LOTTE,1914,3,3,0,100.0,0.0,Female
RAMONA,1914,4,4,0,100.0,0.0,Female
DELICE,1914,4,4,0,100.0,0.0,Female
AGNÈS,1914,580,580,0,100.0,0.0,Female
CLAIRETTE,1914,8,8,0,100.0,0.0,Female
BLEUETTE,1914,9,9,0,100.0,0.0,Female
MARIE-GEORGETTE,1914,3,3,0,100.0,0.0,Female
NADIA,1914,18,18,0,100.0,0.0,Female
GUILLEMETTE,1914,16,16,0,100.0,0.0,Female
ADÈLE,1914,45917,45816,101,99.78003789446174,0.2199621055382538,Female
MARIE-GENEVIÈVE,1914,3,3,0,100.0,0.0,Female
ANICETTE,1914,3,3,0,100.0,0.0,Female
BERNADIN,1914,4,0,4,0.0,100.0,Male
ISRAEL,1914,11,0,11,0.0,100.0,Male
DIMITRI,1914,3,0,3,0.0,100.0,Male
ULRICH,1914,4,0,4,0.0,100.0,Male
RENÉ,1914,516630,397,516233,0.0768441631341579,99.92315583686585,Male
GUERRINO,1914,9,0,9,0.0,100.0,Male
WILLIAM,1914,128,0,128,0.0,100.0,Male
DONATIEN,1914,41,0,41,0.0,100.0,Male
EDME,1914,794,73,721,9.193954659949624,90.80604534005036,Male
FRED,1914,3,0,3,0.0,100.0,Male
GEROME,1914,5,0,5,0.0,100.0,Male
WALDECK,1914,3,0,3,0.0,100.0,Male
JEHAN,1914,10,0,10,0.0,100.0,Male
MAXIMILIEN,1914,62,0,62,0.0,100.0,Male
KLEBERT,1914,11,0,11,0.0,100.0,Male
OVIDE,1914,19,0,19,0.0,100.0,Male
MARCEAU,1914,440,0,440,0.0,100.0,Male
ABEL,1914,463,0,463,0.0,100.0,Male
ANGELIN,1914,16,0,16,0.0,100.0,Male
ANASTASE,1914,10,0,10,0.0,100.0,Male
CHRYSOSTOME,1914,4,0,4,0.0,100.0,Male
WILLY,1914,58,0,58,0.0,100.0,Male
EUSEBE,1914,21,0,21,0.0,100.0,Male
FAUSTE,1914,3,0,3,0.0,100.0,Male
KARL,1914,5,0,5,0.0,100.0,Male
_PRENOMS_RARES,1914,1760252,908578,851674,51.616359475802334,48.38364052419767,Unisex
FRUCTUEUX,1914,176,33,143,18.75,81.25,Unisex
DOMINIQUE,1914,409989,168027,241962,40.98329467375954,59.01670532624046,Unisex
FIDELE,1914,793,162,631,20.42875157629256,79.57124842370744,Unisex
SULPICE,1914,508,182,326,35.826771653543304,64.1732283464567,Unisex
GUALBERT,1914,497,85,412,17.102615694164992,82.897384305835,Unisex
NICAISE,1914,1786,1255,531,70.26875699888018,29.73124300111982,Unisex
MEDARD,1914,1076,175,901,16.263940520446095,83.7360594795539,Unisex
AMOUR,1914,782,287,495,36.70076726342711,63.29923273657288,Unisex
ENOGAT,1914,274,80,194,29.1970802919708,70.8029197080292,Unisex
ARCADE,1914,883,249,634,28.199320498301244,71.80067950169875,Unisex
APPOLINAIRE,1914,632,126,506,19.93670886075949,80.0632911392405,Unisex
SAINTE-CROIX,1914,486,103,383,21.193415637860085,78.80658436213992,Unisex
SOSTHENE,1914,1059,185,874,17.469310670443818,82.53068932955618,Unisex
PLACIDE,1914,1098,214,884,19.489981785063755,80.51001821493625,Unisex
BONIFACE,1914,1187,217,970,18.28138163437237,81.71861836562763,Unisex
LEONCE,1914,9290,2041,7249,21.96986006458557,78.03013993541443,Unisex
MAURILLE,1914,834,214,620,25.65947242206235,74.34052757793765,Unisex
PULCHERIE,1914,738,579,159,78.45528455284553,21.54471544715448,Unisex
SEPTIME,1914,394,119,275,30.20304568527919,69.79695431472082,Unisex
HONORAT,1914,652,270,382,41.41104294478527,58.58895705521472,Unisex
CALIXTE,1914,3347,540,2807,16.13385121003884,83.86614878996116,Unisex
MODESTE,1914,1853,656,1197,35.4020507285483,64.59794927145171,Unisex
EULOGE,1914,621,198,423,31.88405797101449,68.11594202898551,Unisex
NICOMEDE,1914,430,193,237,44.88372093023256,55.11627906976744,Unisex
THÉRÈSE,1915,1277,1277,0,100.0,0.0,Female
REMISE,1915,4,4,0,100.0,0.0,Female
INCARNATION,1915,7,7,0,100.0,0.0,Female
CLOTILDE,1915,234,234,0,100.0,0.0,Female
AIMA,1915,3,3,0,100.0,0.0,Female
VITALINE,1915,11,11,0,100.0,0.0,Female
EMA,1915,5,5,0,100.0,0.0,Female
HERMENCE,1915,5,5,0,100.0,0.0,Female
ARMANDE,1915,217,217,0,100.0,0.0,Female
DELPHINE,1915,71,71,0,100.0,0.0,Female
MÉLANIE,1915,223,223,0,100.0,0.0,Female
EDMEE,1915,78,78,0,100.0,0.0,Female
SEBASTIENNE,1915,15,15,0,100.0,0.0,Female
TOUSSAINTE,1915,24,24,0,100.0,0.0,Female
ALEXIA,1915,12,12,0,100.0,0.0,Female
HERMINIE,1915,21,21,0,100.0,0.0,Female
ELIZABETH,1915,12,12,0,100.0,0.0,Female
CLOTHILDE,1915,16,16,0,100.0,0.0,Female
HORTENSIA,1915,3,3,0,100.0,0.0,Female
EMMANUELLE,1915,20,20,0,100.0,0.0,Female
LISELOTTE,1915,25,25,0,100.0,0.0,Female
ANTONINE,1915,50,50,0,100.0,0.0,Female
MARINETTE,1915,45,45,0,100.0,0.0,Female
FEDORA,1915,3,3,0,100.0,0.0,Female
ELISCA,1915,3,3,0,100.0,0.0,Female
PATRICE,1915,138904,794,138110,0.5716178079824915,99.42838219201752,Male
LÉO,1915,51,0,51,0.0,100.0,Male
FRANCO,1915,3,0,3,0.0,100.0,Male
JEAN-JACQUES,1915,8,0,8,0.0,100.0,Male
PROSPER,1915,144,0,144,0.0,100.0,Male
EMMANUEL,1915,136541,142,136399,0.1039980665148197,99.89600193348518,Male
WALTER,1915,40,0,40,0.0,100.0,Male
LANDRY,1915,8,0,8,0.0,100.0,Male
BENJAMIN,1915,151906,158,151748,0.1040116914407594,99.89598830855924,Male
GHISLAIN,1915,3,0,3,0.0,100.0,Male
GUI,1915,4,0,4,0.0,100.0,Male
AURELE,1915,5,0,5,0.0,100.0,Male
MARC,1915,465,0,465,0.0,100.0,Male
BERTRAND,1915,67,0,67,0.0,100.0,Male
JOACHIM,1915,14719,183,14536,1.2432909844418778,98.75670901555812,Male
THEOPHANE,1915,5,0,5,0.0,100.0,Male
JOANNY,1915,57,0,57,0.0,100.0,Male
PACIFIQUE,1915,3,0,3,0.0,100.0,Male
ROCH,1915,21,0,21,0.0,100.0,Male
GERVAIS,1915,5128,52,5076,1.014040561622465,98.98595943837752,Male
IVAN,1915,14,0,14,0.0,100.0,Male
LUCIEN,1915,2799,0,2799,0.0,100.0,Male
DEL,1915,6,0,6,0.0,100.0,Male
AMEDEE,1915,8323,621,7702,7.461251952421002,92.538748047579,Male
HUMBERT,1915,11,0,11,0.0,100.0,Male
ANTONIE,1915,986,749,237,75.9634888438134,24.036511156186613,Unisex
SULPICE,1915,508,182,326,35.826771653543304,64.1732283464567,Unisex
APPOLINAIRE,1915,632,126,506,19.93670886075949,80.0632911392405,Unisex
SCHOLASTIQUE,1915,1080,835,245,77.31481481481481,22.685185185185187,Unisex
EUSTASE,1915,347,116,231,33.429394812680115,66.57060518731988,Unisex
THIMOTHEE,1915,509,100,409,19.64636542239685,80.35363457760315,Unisex
BONIFACE,1915,1187,217,970,18.28138163437237,81.71861836562763,Unisex
LEONCE,1915,9290,2041,7249,21.96986006458557,78.03013993541443,Unisex
NONCE,1915,598,172,426,28.762541806020064,71.23745819397993,Unisex
AMOUR,1915,782,287,495,36.70076726342711,63.29923273657288,Unisex
DOMINIQUE,1915,409989,168027,241962,40.98329467375954,59.01670532624046,Unisex
LEONIDE,1915,1588,1245,343,78.40050377833752,21.599496221662463,Unisex
MODESTE,1915,1853,656,1197,35.4020507285483,64.59794927145171,Unisex
_PRENOMS_RARES,1915,1760252,908578,851674,51.616359475802334,48.38364052419767,Unisex
ARCADE,1915,883,249,634,28.199320498301244,71.80067950169875,Unisex
MODERAN,1915,258,58,200,22.48062015503876,77.51937984496125,Unisex
PHILOGONE,1915,396,183,213,46.21212121212121,53.78787878787878,Unisex
IRENEE,1915,6155,1854,4301,30.121852152721363,69.87814784727864,Unisex
TIBURCE,1915,1019,212,807,20.80471050049068,79.19528949950933,Unisex
PLACIDE,1915,1098,214,884,19.489981785063755,80.51001821493625,Unisex
ANDOCHE,1915,390,140,250,35.8974358974359,64.1025641025641,Unisex
CRESCENT,1915,447,87,360,19.463087248322147,80.53691275167785,Unisex
CAMILLE,1915,287709,207732,79977,72.20212089298562,27.79787910701437,Unisex
CALIXTE,1915,3347,540,2807,16.13385121003884,83.86614878996116,Unisex
MARY,1915,6861,5830,1031,84.97303600058301,15.026963999416996,Unisex
VINCILIA,1916,5,5,0,100.0,0.0,Female
CORALIE,1916,4,4,0,100.0,0.0,Female
MONNA,1916,3,3,0,100.0,0.0,Female
EMMANUELLE,1916,6,6,0,100.0,0.0,Female
ROBERTINE,1916,23,23,0,100.0,0.0,Female
ALICE,1916,1537,1537,0,100.0,0.0,Female
NOELLA,1916,40,40,0,100.0,0.0,Female
VALERINE,1916,7,7,0,100.0,0.0,Female
EVA,1916,128,128,0,100.0,0.0,Female
GERARDE,1916,4,4,0,100.0,0.0,Female
ANNECY,1916,3,3,0,100.0,0.0,Female
IVETTE,1916,8,8,0,100.0,0.0,Female
INGEBORG,1916,6,6,0,100.0,0.0,Female
MARIE-BERTHE,1916,4,4,0,100.0,0.0,Female
YVONE,1916,10,10,0,100.0,0.0,Female
PILAR,1916,16,16,0,100.0,0.0,Female
DENIZE,1916,6,6,0,100.0,0.0,Female
BERTHILE,1916,4,4,0,100.0,0.0,Female
AURELIA,1916,4,4,0,100.0,0.0,Female
SARA,1916,12,12,0,100.0,0.0,Female
MERCEDES,1916,40,40,0,100.0,0.0,Female
COSETTE,1916,5,5,0,100.0,0.0,Female
JEANNIE,1916,15,15,0,100.0,0.0,Female
PULCHERIE,1916,11,11,0,100.0,0.0,Female
LOETITIA,1916,12,12,0,100.0,0.0,Female
KURT,1916,9,0,9,0.0,100.0,Male
GUERINO,1916,5,0,5,0.0,100.0,Male
SYLVERE,1916,3,0,3,0.0,100.0,Male
HUGUES,1916,25826,189,25637,0.7318206458607605,99.26817935413924,Male
RIGOBERT,1916,15,0,15,0.0,100.0,Male
JULLIEN,1916,3,0,3,0.0,100.0,Male
RUFIN,1916,3,0,3,0.0,100.0,Male
WERNER,1916,21,0,21,0.0,100.0,Male
ALCIDE,1916,34,0,34,0.0,100.0,Male
SOUBAYA,1916,3,0,3,0.0,100.0,Male
SÉBASTIEN,1916,71,0,71,0.0,100.0,Male
SEVERE,1916,5,0,5,0.0,100.0,Male
ALBERIE,1916,3,0,3,0.0,100.0,Male
GEDEON,1916,6,0,6,0.0,100.0,Male
SIMILIEN,1916,3,0,3,0.0,100.0,Male
STANISLAS,1916,21493,388,21105,1.80523891499558,98.19476108500442,Male
CLODOMIR,1916,5,0,5,0.0,100.0,Male
ARCHANGE,1916,3,0,3,0.0,100.0,Male
ADRIEN,1916,513,0,513,0.0,100.0,Male
CELESTIN,1916,125,0,125,0.0,100.0,Male
ROCH,1916,23,0,23,0.0,100.0,Male
ARMEL,1916,16,0,16,0.0,100.0,Male
ALDO,1916,4,0,4,0.0,100.0,Male
EDVARD,1916,8,0,8,0.0,100.0,Male
GATIEN,1916,4,0,4,0.0,100.0,Male
HYACINTHE,1916,4679,1173,3506,25.069459286172258,74.93054071382774,Unisex
VENANCE,1916,314,123,191,39.171974522293,60.828025477707,Unisex
NICAISE,1916,1786,1255,531,70.26875699888018,29.73124300111982,Unisex
MERY,1916,515,409,106,79.41747572815534,20.58252427184466,Unisex
SULPICE,1916,508,182,326,35.826771653543304,64.1732283464567,Unisex
IRENEE,1916,6155,1854,4301,30.121852152721363,69.87814784727864,Unisex
PLACIDE,1916,1098,214,884,19.489981785063755,80.51001821493625,Unisex
TIBURCE,1916,1019,212,807,20.80471050049068,79.19528949950933,Unisex
ARCADE,1916,883,249,634,28.199320498301244,71.80067950169875,Unisex
MODESTE,1916,1853,656,1197,35.4020507285483,64.59794927145171,Unisex
MARY,1916,6861,5830,1031,84.97303600058301,15.026963999416996,Unisex
DOMINIQUE,1916,409989,168027,241962,40.98329467375954,59.01670532624046,Unisex
MESMIN,1916,773,183,590,23.67399741267788,76.32600258732212,Unisex
ALIX,1916,37305,28371,8934,76.05146763168477,23.94853236831524,Unisex
FIDELE,1916,793,162,631,20.42875157629256,79.57124842370744,Unisex
APPOLINAIRE,1916,632,126,506,19.93670886075949,80.0632911392405,Unisex
CAMILLE,1916,287709,207732,79977,72.20212089298562,27.79787910701437,Unisex
EUSTASE,1916,347,116,231,33.429394812680115,66.57060518731988,Unisex
AVIT,1916,485,106,379,21.855670103092784,78.14432989690722,Unisex
LEONCE,1916,9290,2041,7249,21.96986006458557,78.03013993541443,Unisex
SOSTHENE,1916,1059,185,874,17.469310670443818,82.53068932955618,Unisex
SAINTE,1916,1055,648,407,61.4218009478673,38.5781990521327,Unisex
ENOGAT,1916,274,80,194,29.1970802919708,70.8029197080292,Unisex
CALIXTE,1916,3347,540,2807,16.13385121003884,83.86614878996116,Unisex
LEONIDE,1916,1588,1245,343,78.40050377833752,21.599496221662463,Unisex
THEOLINE,1917,3,3,0,100.0,0.0,Female
MARCELLINE,1917,120,120,0,100.0,0.0,Female
HENRIETTA,1917,3,3,0,100.0,0.0,Female
MARTHA,1917,28,28,0,100.0,0.0,Female
SATURNINE,1917,3,3,0,100.0,0.0,Female
FIRMINE,1917,6,6,0,100.0,0.0,Female
FLORENCE,1917,52,52,0,100.0,0.0,Female
JULIE,1917,293,293,0,100.0,0.0,Female
PHARAILDE,1917,3,3,0,100.0,0.0,Female
MARIA,1917,1258,1258,0,100.0,0.0,Female
VALÉRIE,1917,253280,253047,233,99.90800694883131,0.091993051168667,Female
CLAUDIA,1917,160,160,0,100.0,0.0,Female
EMELDA,1917,3,3,0,100.0,0.0,Female
SYLVESTINE,1917,4,4,0,100.0,0.0,Female
ANDRELINE,1917,3,3,0,100.0,0.0,Female
ELFRIEDE,1917,29,29,0,100.0,0.0,Female
LUCE,1917,8936,8291,645,92.78200537153089,7.217994628469114,Female
MERY,1917,7,7,0,100.0,0.0,Female
JANINE,1917,84,84,0,100.0,0.0,Female
FANIE,1917,4,4,0,100.0,0.0,Female
THEODOSE,1917,484,417,67,86.15702479338843,13.842975206611571,Female
SYLVANIE,1917,6,6,0,100.0,0.0,Female
FLORESTINE,1917,4,4,0,100.0,0.0,Female
CAMILLIA,1917,3,3,0,100.0,0.0,Female
FLORA,1917,27,27,0,100.0,0.0,Female
COURT,1917,7,0,7,0.0,100.0,Male
AVRIL,1917,3,0,3,0.0,100.0,Male
GATIEN,1917,12,0,12,0.0,100.0,Male
GERHARD,1917,3,0,3,0.0,100.0,Male
HORACE,1917,5,0,5,0.0,100.0,Male
CURT,1917,7,0,7,0.0,100.0,Male
HERMANN,1917,19,0,19,0.0,100.0,Male
LEGER,1917,5,0,5,0.0,100.0,Male
NAZAIRE,1917,4,0,4,0.0,100.0,Male
SYLVAIN,1917,75,0,75,0.0,100.0,Male
GONTRAN,1917,18,0,18,0.0,100.0,Male
LIN,1917,3,0,3,0.0,100.0,Male
MARTIAL,1917,143,0,143,0.0,100.0,Male
ROLF,1917,3,0,3,0.0,100.0,Male
JEAN-LOUIS,1917,42,0,42,0.0,100.0,Male
ULYSSE,1917,34,0,34,0.0,100.0,Male
ISIDOR,1917,3,0,3,0.0,100.0,Male
ADALBERT,1917,7,0,7,0.0,100.0,Male
YVAN,1917,50,0,50,0.0,100.0,Male
FIRMIN,1917,8826,143,8683,1.6202130070246998,98.3797869929753,Male
CASIMIR,1917,7241,279,6962,3.853058969755559,96.14694103024443,Male
OSMIN,1917,5,0,5,0.0,100.0,Male
ANTONIN,1917,187,0,187,0.0,100.0,Male
BAPTISTIN,1917,21,0,21,0.0,100.0,Male
RAMSAMY,1917,4,0,4,0.0,100.0,Male
MESMIN,1917,773,183,590,23.67399741267788,76.32600258732212,Unisex
NICAISE,1917,1786,1255,531,70.26875699888018,29.73124300111982,Unisex
GABY,1917,4741,2448,2293,51.63467622864375,48.36532377135626,Unisex
EUSEBE,1917,1151,212,939,18.41876629018245,81.58123370981755,Unisex
EUSTASE,1917,347,116,231,33.429394812680115,66.57060518731988,Unisex
MAMERT,1917,224,75,149,33.482142857142854,66.51785714285714,Unisex
WENCESLAS,1917,877,175,702,19.95438996579248,80.04561003420753,Unisex
ANDOCHE,1917,390,140,250,35.8974358974359,64.1025641025641,Unisex
CANDIDE,1917,1019,686,333,67.32090284592738,32.67909715407262,Unisex
MODESTE,1917,1853,656,1197,35.4020507285483,64.59794927145171,Unisex
ALIX,1917,37305,28371,8934,76.05146763168477,23.94853236831524,Unisex
IRENEE,1917,6155,1854,4301,30.121852152721363,69.87814784727864,Unisex
TIBURCE,1917,1019,212,807,20.80471050049068,79.19528949950933,Unisex
PHILOGONE,1917,396,183,213,46.21212121212121,53.78787878787878,Unisex
AVIT,1917,485,106,379,21.855670103092784,78.14432989690722,Unisex
CALIXTE,1917,3347,540,2807,16.13385121003884,83.86614878996116,Unisex
GEORGE,1917,2417,650,1767,26.89284236657013,73.10715763342988,Unisex
ENOGAT,1917,274,80,194,29.1970802919708,70.8029197080292,Unisex
SULPICE,1917,508,182,326,35.826771653543304,64.1732283464567,Unisex
EUSTACHE,1917,1376,277,1099,20.13081395348837,79.86918604651163,Unisex
NICOMEDE,1917,430,193,237,44.88372093023256,55.11627906976744,Unisex
DOMINIQUE,1917,409989,168027,241962,40.98329467375954,59.01670532624046,Unisex
LEONCE,1917,9290,2041,7249,21.96986006458557,78.03013993541443,Unisex
NONCE,1917,598,172,426,28.762541806020064,71.23745819397993,Unisex
LEONIDE,1917,1588,1245,343,78.40050377833752,21.599496221662463,Unisex
FERDINANDE,1918,6,6,0,100.0,0.0,Female
DESIREE,1918,111,111,0,100.0,0.0,Female
LISE,1918,42,42,0,100.0,0.0,Female
LÉONTINE,1918,368,368,0,100.0,0.0,Female
NANCY,1918,14,14,0,100.0,0.0,Female
GILDA,1918,7,7,0,100.0,0.0,Female
POLETTE,1918,3,3,0,100.0,0.0,Female
SIMONE,1918,3169,3169,0,100.0,0.0,Female
ERNA,1918,51,51,0,100.0,0.0,Female
ARMANCE,1918,12,12,0,100.0,0.0,Female
JULIENNE,1918,596,596,0,100.0,0.0,Female
NOELIE,1918,100,100,0,100.0,0.0,Female
ANTONIA,1918,130,130,0,100.0,0.0,Female
JUDITH,1918,23,23,0,100.0,0.0,Female
BARBE,1918,3019,2623,396,86.88307386551838,13.116926134481616,Female
HÉLÈNE,1918,281614,281438,176,99.93750310708984,0.0624968929101536,Female
ANASTASIE,1918,51,51,0,100.0,0.0,Female
AMELINA,1918,5,5,0,100.0,0.0,Female
MARIE-ROSE,1918,62,62,0,100.0,0.0,Female
LEONISE,1918,3,3,0,100.0,0.0,Female
ERIKA,1918,11,11,0,100.0,0.0,Female
INNOCENTE,1918,11,11,0,100.0,0.0,Female
JEROMINE,1918,6,6,0,100.0,0.0,Female
ODILE,1918,93538,93149,389,99.584126237465,0.4158737625350125,Female
THERESA,1918,18,18,0,100.0,0.0,Female
GEO,1918,3,0,3,0.0,100.0,Male
VITAL,1918,31,0,31,0.0,100.0,Male
FRANCIS,1918,643,0,643,0.0,100.0,Male
SILVAIN,1918,6,0,6,0.0,100.0,Male
JULIEN,1918,982,0,982,0.0,100.0,Male
AUGUSTIN,1918,301,0,301,0.0,100.0,Male
STEPHAN,1918,6,0,6,0.0,100.0,Male
FREDDY,1918,4,0,4,0.0,100.0,Male
HARRY,1918,7,0,7,0.0,100.0,Male
MODERAN,1918,9,0,9,0.0,100.0,Male
FORTUNE,1918,48,0,48,0.0,100.0,Male
MARCEAU,1918,223,0,223,0.0,100.0,Male
PABLO,1918,3,0,3,0.0,100.0,Male
HYPPOLITE,1918,5,0,5,0.0,100.0,Male
JEAN-CHARLES,1918,3,0,3,0.0,100.0,Male
CARMELIEN,1918,3,0,3,0.0,100.0,Male
JULIO,1918,4,0,4,0.0,100.0,Male
JEAN-JACQUES,1918,12,0,12,0.0,100.0,Male
ALCIME,1918,4,0,4,0.0,100.0,Male
JULLIEN,1918,3,0,3,0.0,100.0,Male
LUDOVIC,1918,127235,112,127123,0.0880260934491295,99.91197390655088,Male
MICHAEL,1918,6,0,6,0.0,100.0,Male
SAUVEUR,1918,43,0,43,0.0,100.0,Male
WILLY,1918,42,0,42,0.0,100.0,Male
CLOTAIRE,1918,34,0,34,0.0,100.0,Male
MARY,1918,6861,5830,1031,84.97303600058301,15.026963999416996,Unisex
IRENEE,1918,6155,1854,4301,30.121852152721363,69.87814784727864,Unisex
NONCE,1918,598,172,426,28.762541806020064,71.23745819397993,Unisex
PULCHERIE,1918,738,579,159,78.45528455284553,21.54471544715448,Unisex
APPOLINAIRE,1918,632,126,506,19.93670886075949,80.0632911392405,Unisex
MESMIN,1918,773,183,590,23.67399741267788,76.32600258732212,Unisex
HONORAT,1918,652,270,382,41.41104294478527,58.58895705521472,Unisex
MODESTE,1918,1853,656,1197,35.4020507285483,64.59794927145171,Unisex
SULPICE,1918,508,182,326,35.826771653543304,64.1732283464567,Unisex
ARCADE,1918,883,249,634,28.199320498301244,71.80067950169875,Unisex
PHILOGONE,1918,396,183,213,46.21212121212121,53.78787878787878,Unisex
MARIE-JOSEPH,1918,2275,1830,445,80.43956043956044,19.56043956043956,Unisex
NICAISE,1918,1786,1255,531,70.26875699888018,29.73124300111982,Unisex
SEPTIME,1918,394,119,275,30.20304568527919,69.79695431472082,Unisex
MAMERT,1918,224,75,149,33.482142857142854,66.51785714285714,Unisex
CAMILLE,1918,287709,207732,79977,72.20212089298562,27.79787910701437,Unisex
LEONCE,1918,9290,2041,7249,21.96986006458557,78.03013993541443,Unisex
EUSEBE,1918,1151,212,939,18.41876629018245,81.58123370981755,Unisex
BONIFACE,1918,1187,217,970,18.28138163437237,81.71861836562763,Unisex
SOSTHENE,1918,1059,185,874,17.469310670443818,82.53068932955618,Unisex
_PRENOMS_RARES,1918,1760252,908578,851674,51.616359475802334,48.38364052419767,Unisex
AMOUR,1918,782,287,495,36.70076726342711,63.29923273657288,Unisex
GABY,1918,4741,2448,2293,51.63467622864375,48.36532377135626,Unisex
ALIX,1918,37305,28371,8934,76.05146763168477,23.94853236831524,Unisex
LEONIDE,1918,1588,1245,343,78.40050377833752,21.599496221662463,Unisex
HELLENE,1919,3,3,0,100.0,0.0,Female
FRANCELINE,1919,17,17,0,100.0,0.0,Female
BERTILLE,1919,7,7,0,100.0,0.0,Female
ISAURE,1919,6,6,0,100.0,0.0,Female
BETTINA,1919,3,3,0,100.0,0.0,Female
LÉONIE,1919,563,563,0,100.0,0.0,Female
DOMINICA,1919,11,11,0,100.0,0.0,Female
STÉPHANIE,1919,53,53,0,100.0,0.0,Female
MARGUERITTE,1919,6,6,0,100.0,0.0,Female
ETIENNISE,1919,6,6,0,100.0,0.0,Female
EDMEE,1919,78,78,0,100.0,0.0,Female
AZELINE,1919,5,5,0,100.0,0.0,Female
SYLVANIE,1919,12,12,0,100.0,0.0,Female
LEOPOLDINE,1919,8,8,0,100.0,0.0,Female
RACHEL,1919,51364,50877,487,99.05186511953896,0.9481348804610232,Female
YOLAINE,1919,4,4,0,100.0,0.0,Female
DORA,1919,13,13,0,100.0,0.0,Female
YVONE,1919,10,10,0,100.0,0.0,Female
EMILIE,1919,471,471,0,100.0,0.0,Female
LUCY,1919,9,9,0,100.0,0.0,Female
XAVIERE,1919,13,13,0,100.0,0.0,Female
LUCILLE,1919,9,9,0,100.0,0.0,Female
LUCIA,1919,47,47,0,100.0,0.0,Female
MATHEE,1919,4,4,0,100.0,0.0,Female
FLORIDA,1919,4,4,0,100.0,0.0,Female
GUALBERT,1919,8,0,8,0.0,100.0,Male
XAVIER,1919,162,0,162,0.0,100.0,Male
SERVAIS,1919,9,0,9,0.0,100.0,Male
FRANÇOIS,1919,398930,252,398678,0.0631689770135111,99.9368310229865,Male
STANISLAS,1919,33,0,33,0.0,100.0,Male
HELIER,1919,8,0,8,0.0,100.0,Male
MARIUS,1919,1069,0,1069,0.0,100.0,Male
ARNOLD,1919,7,0,7,0.0,100.0,Male
PAULIN,1919,44,0,44,0.0,100.0,Male
SAINTE-CROIX,1919,4,0,4,0.0,100.0,Male
ERICH,1919,12,0,12,0.0,100.0,Male
CORENTIN,1919,66,0,66,0.0,100.0,Male
DARIUS,1919,5,0,5,0.0,100.0,Male
RUBENS,1919,3,0,3,0.0,100.0,Male
SAINT-CYR,1919,4,0,4,0.0,100.0,Male
ARSENE,1919,15051,1013,14038,6.730449803999735,93.26955019600028,Male
FRANCIS,1919,660,0,660,0.0,100.0,Male
EDOUARD,1919,885,0,885,0.0,100.0,Male
AMAURY,1919,3,0,3,0.0,100.0,Male
THOMAS,1919,281159,347,280812,0.1234177102635875,99.87658228973642,Male
AMAND,1919,57,0,57,0.0,100.0,Male
ROLLAND,1919,84,0,84,0.0,100.0,Male
ISMAEL,1919,14,0,14,0.0,100.0,Male
SYMPHORIEN,1919,3,0,3,0.0,100.0,Male
CYR,1919,9,0,9,0.0,100.0,Male
WENCESLAS,1919,877,175,702,19.95438996579248,80.04561003420753,Unisex
_PRENOMS_RARES,1919,1760252,908578,851674,51.616359475802334,48.38364052419767,Unisex
EULOGE,1919,621,198,423,31.88405797101449,68.11594202898551,Unisex
SOSTHENE,1919,1059,185,874,17.469310670443818,82.53068932955618,Unisex
MODESTE,1919,1853,656,1197,35.4020507285483,64.59794927145171,Unisex
CANDIDE,1919,1019,686,333,67.32090284592738,32.67909715407262,Unisex
MARY,1919,6861,5830,1031,84.97303600058301,15.026963999416996,Unisex
CAMILLE,1919,287709,207732,79977,72.20212089298562,27.79787910701437,Unisex
MESMIN,1919,773,183,590,23.67399741267788,76.32600258732212,Unisex
ARCADE,1919,883,249,634,28.199320498301244,71.80067950169875,Unisex
HYACINTHE,1919,4679,1173,3506,25.069459286172258,74.93054071382774,Unisex
DOMINIQUE,1919,409989,168027,241962,40.98329467375954,59.01670532624046,Unisex
BABYLAS,1919,330,98,232,29.6969696969697,70.3030303030303,Unisex
SAINTE,1919,1055,648,407,61.4218009478673,38.5781990521327,Unisex
AMOUR,1919,782,287,495,36.70076726342711,63.29923273657288,Unisex
ALIX,1919,37305,28371,8934,76.05146763168477,23.94853236831524,Unisex
FIACRE,1919,253,59,194,23.3201581027668,76.6798418972332,Unisex
SABAS,1919,607,220,387,36.24382207578254,63.75617792421746,Unisex
IRENEE,1919,6155,1854,4301,30.121852152721363,69.87814784727864,Unisex
MARIE-JOSEPH,1919,2275,1830,445,80.43956043956044,19.56043956043956,Unisex
CALIXTE,1919,3347,540,2807,16.13385121003884,83.86614878996116,Unisex
TIBURCE,1919,1019,212,807,20.80471050049068,79.19528949950933,Unisex
LEONCE,1919,9290,2041,7249,21.96986006458557,78.03013993541443,Unisex
NONCE,1919,598,172,426,28.762541806020064,71.23745819397993,Unisex
PHILOGONE,1919,396,183,213,46.21212121212121,53.78787878787878,Unisex
MARIE-THÉRÈSE,1920,693,693,0,100.0,0.0,Female
EUDOXIE,1920,12,12,0,100.0,0.0,Female
CHARLINE,1920,76,76,0,100.0,0.0,Female
GRACE,1920,5,5,0,100.0,0.0,Female
JOSEPHE,1920,4053,3987,66,98.37157660991858,1.6284233900814211,Female
CELINIE,1920,12,12,0,100.0,0.0,Female
ANNE-MARIE,1920,297,297,0,100.0,0.0,Female
ODILLE,1920,25,25,0,100.0,0.0,Female
FLORETTE,1920,6,6,0,100.0,0.0,Female
MARIE-ANGÈLE,1920,6,6,0,100.0,0.0,Female
TOUSSAINTE,1920,37,37,0,100.0,0.0,Female
LILIANNE,1920,15,15,0,100.0,0.0,Female
ELOISE,1920,35,35,0,100.0,0.0,Female
JEANNIE,1920,30,30,0,100.0,0.0,Female
MARCELINE,1920,167,167,0,100.0,0.0,Female
ALIXE,1920,6,6,0,100.0,0.0,Female
MIRIAM,1920,6,6,0,100.0,0.0,Female
VALÉRIE,1920,253280,253047,233,99.90800694883131,0.091993051168667,Female
MAUDE,1920,5,5,0,100.0,0.0,Female
LINA,1920,208,208,0,100.0,0.0,Female
GENEVIÈVE,1920,3629,3629,0,100.0,0.0,Female
CLORINDE,1920,5,5,0,100.0,0.0,Female
VITALINE,1920,7,7,0,100.0,0.0,Female
MARIE-ANTOINETTE,1920,101,101,0,100.0,0.0,Female
MARYSE,1920,6,6,0,100.0,0.0,Female
ISAAC,1920,16,0,16,0.0,100.0,Male
ANATOLE,1920,10123,127,9996,1.254568803714314,98.74543119628568,Male
HUGO,1920,4,0,4,0.0,100.0,Male
BABYLAS,1920,7,0,7,0.0,100.0,Male
SOSTHENES,1920,10,0,10,0.0,100.0,Male
IGNACE,1920,3628,396,3232,10.91510474090408,89.08489525909592,Male
DIMITRI,1920,3,0,3,0.0,100.0,Male
MARCEL,1920,469696,71,469625,0.0151161602398146,99.9848838397602,Male
VALMY,1920,4,0,4,0.0,100.0,Male
VALBERT,1920,3,0,3,0.0,100.0,Male
ELIEN,1920,5,0,5,0.0,100.0,Male
PATRICK,1920,7,0,7,0.0,100.0,Male
RAFAEL,1920,3,0,3,0.0,100.0,Male
SÉBASTIEN,1920,81,0,81,0.0,100.0,Male
GASPARD,1920,20,0,20,0.0,100.0,Male
MARIEN,1920,8,0,8,0.0,100.0,Male
THIMOTHEE,1920,8,0,8,0.0,100.0,Male
MAXIMIN,1920,70,0,70,0.0,100.0,Male
BERNARDIN,1920,19,0,19,0.0,100.0,Male
CONSTANT,1920,338,0,338,0.0,100.0,Male
ERICH,1920,10,0,10,0.0,100.0,Male
PASCAL,1920,130,0,130,0.0,100.0,Male
SILVAIN,1920,9,0,9,0.0,100.0,Male
ARMAND,1920,1321,0,1321,0.0,100.0,Male
TONY,1920,9,0,9,0.0,100.0,Male
CAMILLE,1920,287709,207732,79977,72.20212089298562,27.79787910701437,Unisex
MARY,1920,6861,5830,1031,84.97303600058301,15.026963999416996,Unisex
APPOLINAIRE,1920,632,126,506,19.93670886075949,80.0632911392405,Unisex
DOMINIQUE,1920,409989,168027,241962,40.98329467375954,59.01670532624046,Unisex
LEONCE,1920,9290,2041,7249,21.96986006458557,78.03013993541443,Unisex
MARIE-JOSEPH,1920,2275,1830,445,80.43956043956044,19.56043956043956,Unisex
GABY,1920,4741,2448,2293,51.63467622864375,48.36532377135626,Unisex
PULCHERIE,1920,738,579,159,78.45528455284553,21.54471544715448,Unisex
NICAISE,1920,1786,1255,531,70.26875699888018,29.73124300111982,Unisex
HONORAT,1920,652,270,382,41.41104294478527,58.58895705521472,Unisex
PLACIDE,1920,1098,214,884,19.489981785063755,80.51001821493625,Unisex
VENANCE,1920,314,123,191,39.171974522293,60.828025477707,Unisex
IRENEE,1920,6155,1854,4301,30.121852152721363,69.87814784727864,Unisex
LIN,1920,701,177,524,25.24964336661912,74.75035663338089,Unisex
FRUCTUEUX,1920,176,33,143,18.75,81.25,Unisex
LEONIDE,1920,1588,1245,343,78.40050377833752,21.599496221662463,Unisex
FIDELE,1920,793,162,631,20.42875157629256,79.57124842370744,Unisex
SCHOLASTIQUE,1920,1080,835,245,77.31481481481481,22.685185185185187,Unisex
EUSTASE,1920,347,116,231,33.429394812680115,66.57060518731988,Unisex
SAINTE,1920,1055,648,407,61.4218009478673,38.5781990521327,Unisex
MODESTE,1920,1853,656,1197,35.4020507285483,64.59794927145171,Unisex
EULOGE,1920,621,198,423,31.88405797101449,68.11594202898551,Unisex
HYACINTHE,1920,4679,1173,3506,25.069459286172258,74.93054071382774,Unisex
MEDARD,1920,1076,175,901,16.263940520446095,83.7360594795539,Unisex
ANTONIE,1920,986,749,237,75.9634888438134,24.036511156186613,Unisex
EDITH,1921,601,601,0,100.0,0.0,Female
NOELA,1921,32,32,0,100.0,0.0,Female
MARIE-CAMILLE,1921,3,3,0,100.0,0.0,Female
CLARA,1921,52,52,0,100.0,0.0,Female
NOELINE,1921,27,27,0,100.0,0.0,Female
BENOITE,1921,24,24,0,100.0,0.0,Female
MARIELLE,1921,6,6,0,100.0,0.0,Female
GASTONNE,1921,10,10,0,100.0,0.0,Female
ELIZA,1921,3,3,0,100.0,0.0,Female
FELICIE,1921,213,213,0,100.0,0.0,Female
POLETTE,1921,3,3,0,100.0,0.0,Female
MANUELA,1921,12,12,0,100.0,0.0,Female
EUPHROSINE,1921,3,3,0,100.0,0.0,Female
GRACIEUSE,1921,56,56,0,100.0,0.0,Female
PIA,1921,3,3,0,100.0,0.0,Female
ALIXE,1921,9,9,0,100.0,0.0,Female
PALMYRE,1921,2291,2203,88,96.15888258402444,3.841117415975556,Female
WILFRIDE,1921,3,3,0,100.0,0.0,Female
MIRETTE,1921,4,4,0,100.0,0.0,Female
MARIE-JEANNE,1921,225,225,0,100.0,0.0,Female
SYLVESTINE,1921,4,4,0,100.0,0.0,Female
INNOCENTE,1921,6,6,0,100.0,0.0,Female
CLAIRE,1921,160124,159893,231,99.85573680397692,0.1442631960230821,Female
CLARICE,1921,4,4,0,100.0,0.0,Female
AMANTE,1921,7,7,0,100.0,0.0,Female
RÉMY,1921,74262,110,74152,0.1481242088820662,99.85187579111792,Male
ARCHANGE,1921,7,0,7,0.0,100.0,Male
HILDEBERT,1921,3,0,3,0.0,100.0,Male
LÉANDRE,1921,16715,639,16076,3.8229135507029617,96.17708644929704,Male
PETER,1921,8,0,8,0.0,100.0,Male
SAINTE-CLAIRE,1921,3,0,3,0.0,100.0,Male
MARCEAU,1921,358,0,358,0.0,100.0,Male
SIMON,1921,297,0,297,0.0,100.0,Male
GERY,1921,8,0,8,0.0,100.0,Male
BERANGER,1921,4,0,4,0.0,100.0,Male
RINALDO,1921,3,0,3,0.0,100.0,Male
JANVIER,1921,8,0,8,0.0,100.0,Male
ELISEE,1921,48,0,48,0.0,100.0,Male
JEAN-LOUIS,1921,123,0,123,0.0,100.0,Male
AUGUSTAVE,1921,4,0,4,0.0,100.0,Male
OSVALD,1921,3,0,3,0.0,100.0,Male
AUBERT,1921,11,0,11,0.0,100.0,Male
CARLOS,1921,11,0,11,0.0,100.0,Male
FRED,1921,9,0,9,0.0,100.0,Male
EVRARD,1921,6,0,6,0.0,100.0,Male
SAMSON,1921,1970,107,1863,5.431472081218274,94.56852791878173,Male
JUSTE,1921,10,0,10,0.0,100.0,Male
PETRUS,1921,18,0,18,0.0,100.0,Male
ZACHARIE,1921,5450,192,5258,3.522935779816514,96.47706422018348,Male
HOCHE,1921,3,0,3,0.0,100.0,Male
FIDELE,1921,793,162,631,20.42875157629256,79.57124842370744,Unisex
AMOUR,1921,782,287,495,36.70076726342711,63.29923273657288,Unisex
ARCADE,1921,883,249,634,28.199320498301244,71.80067950169875,Unisex
EULOGE,1921,621,198,423,31.88405797101449,68.11594202898551,Unisex
NICAISE,1921,1786,1255,531,70.26875699888018,29.73124300111982,Unisex
CRESCENT,1921,447,87,360,19.463087248322147,80.53691275167785,Unisex
WENCESLAS,1921,877,175,702,19.95438996579248,80.04561003420753,Unisex
PULCHERIE,1921,738,579,159,78.45528455284553,21.54471544715448,Unisex
MAURILLE,1921,834,214,620,25.65947242206235,74.34052757793765,Unisex
MODESTE,1921,1853,656,1197,35.4020507285483,64.59794927145171,Unisex
AGNAN,1921,455,124,331,27.25274725274725,72.74725274725274,Unisex
PHILOGONE,1921,396,183,213,46.21212121212121,53.78787878787878,Unisex
NICOMEDE,1921,430,193,237,44.88372093023256,55.11627906976744,Unisex
OPTAT,1921,203,61,142,30.049261083743843,69.95073891625616,Unisex
FRUCTUEUX,1921,176,33,143,18.75,81.25,Unisex
THIMOTHEE,1921,509,100,409,19.64636542239685,80.35363457760315,Unisex
LEONIDE,1921,1588,1245,343,78.40050377833752,21.599496221662463,Unisex
EUSTACHE,1921,1376,277,1099,20.13081395348837,79.86918604651163,Unisex
IRENEE,1921,6155,1854,4301,30.121852152721363,69.87814784727864,Unisex
_PRENOMS_RARES,1921,1760252,908578,851674,51.616359475802334,48.38364052419767,Unisex
APPOLINAIRE,1921,632,126,506,19.93670886075949,80.0632911392405,Unisex
ALIX,1921,37305,28371,8934,76.05146763168477,23.94853236831524,Unisex
MARY,1921,6861,5830,1031,84.97303600058301,15.026963999416996,Unisex
LIE,1921,328,80,248,24.390243902439025,75.60975609756098,Unisex
PROSPERE,1921,128,87,41,67.96875,32.03125,Unisex
NOËLLE,1922,133,133,0,100.0,0.0,Female
SIDONIE,1922,92,92,0,100.0,0.0,Female
APOLLINE,1922,4,4,0,100.0,0.0,Female
MIGNONNETTE,1922,3,3,0,100.0,0.0,Female
LETIZIA,1922,3,3,0,100.0,0.0,Female
BATHILDE,1922,4,4,0,100.0,0.0,Female
AIMA,1922,3,3,0,100.0,0.0,Female
YOLANDE,1922,569,569,0,100.0,0.0,Female
STEPHANIA,1922,4,4,0,100.0,0.0,Female
ANETTE,1922,4,4,0,100.0,0.0,Female
SYLVIANE,1922,84,84,0,100.0,0.0,Female
ELLEN,1922,10,10,0,100.0,0.0,Female
ARMANCE,1922,19,19,0,100.0,0.0,Female
EUGÉNIE,1922,1226,1226,0,100.0,0.0,Female
FLORIDA,1922,7,7,0,100.0,0.0,Female
NADIA,1922,17,17,0,100.0,0.0,Female
LIDIA,1922,9,9,0,100.0,0.0,Female
LEONCIE,1922,19,19,0,100.0,0.0,Female
ADELINE,1922,116,116,0,100.0,0.0,Female
SARA,1922,7,7,0,100.0,0.0,Female
MARGUERITTE,1922,17,17,0,100.0,0.0,Female
PIERINA,1922,4,4,0,100.0,0.0,Female
LIDA,1922,3,3,0,100.0,0.0,Female
BARBARA,1922,8,8,0,100.0,0.0,Female
RENETTE,1922,5,5,0,100.0,0.0,Female
JEAN-MARCEL,1922,4,0,4,0.0,100.0,Male
ROMÉO,1922,16,0,16,0.0,100.0,Male
FREDDY,1922,3,0,3,0.0,100.0,Male
VICTORIANO,1922,4,0,4,0.0,100.0,Male
JOFFRE,1922,3,0,3,0.0,100.0,Male
TRISTAN,1922,3,0,3,0.0,100.0,Male
ANGELIN,1922,16,0,16,0.0,100.0,Male
JOAQUIN,1922,14,0,14,0.0,100.0,Male
DENIS,1922,153132,65,153067,0.042447039155761,99.95755296084424,Male
WLADISLAS,1922,4,0,4,0.0,100.0,Male
ALBERTO,1922,5,0,5,0.0,100.0,Male
SYLVESTRE,1922,4075,197,3878,4.834355828220859,95.16564417177914,Male
BENJAMIN,1922,112,0,112,0.0,100.0,Male
ADOLPHE,1922,389,0,389,0.0,100.0,Male
COME,1922,5420,155,5265,2.859778597785978,97.14022140221402,Male
JUDE,1922,4,0,4,0.0,100.0,Male
GUILBERT,1922,3,0,3,0.0,100.0,Male
EWALD,1922,5,0,5,0.0,100.0,Male
EDMOND,1922,1247,0,1247,0.0,100.0,Male
EDWIN,1922,3,0,3,0.0,100.0,Male
JACOB,1922,3570,91,3479,2.549019607843137,97.45098039215686,Male
GENTIL,1922,6,0,6,0.0,100.0,Male
EMILIEN,1922,219,0,219,0.0,100.0,Male
FULBERT,1922,1144,83,1061,7.255244755244755,92.74475524475524,Male
OSMIN,1922,12,0,12,0.0,100.0,Male
HONORAT,1922,652,270,382,41.41104294478527,58.58895705521472,Unisex
LEONCE,1922,9290,2041,7249,21.96986006458557,78.03013993541443,Unisex
PLACIDE,1922,1098,214,884,19.489981785063755,80.51001821493625,Unisex
PEPIN,1922,533,126,407,23.63977485928705,76.36022514071294,Unisex
DOMINIQUE,1922,409989,168027,241962,40.98329467375954,59.01670532624046,Unisex
IRENEE,1922,6155,1854,4301,30.121852152721363,69.87814784727864,Unisex
ALIX,1922,37305,28371,8934,76.05146763168477,23.94853236831524,Unisex
NONCE,1922,598,172,426,28.762541806020064,71.23745819397993,Unisex
LÉONCE,1922,548,123,425,22.445255474452555,77.55474452554745,Unisex
CANDIDE,1922,1019,686,333,67.32090284592738,32.67909715407262,Unisex
MESMIN,1922,773,183,590,23.67399741267788,76.32600258732212,Unisex
LEONIDE,1922,1588,1245,343,78.40050377833752,21.599496221662463,Unisex
SAINTE,1922,1055,648,407,61.4218009478673,38.5781990521327,Unisex
MARY,1922,6861,5830,1031,84.97303600058301,15.026963999416996,Unisex
AGNAN,1922,455,124,331,27.25274725274725,72.74725274725274,Unisex
MERY,1922,515,409,106,79.41747572815534,20.58252427184466,Unisex
ANDOCHE,1922,390,140,250,35.8974358974359,64.1025641025641,Unisex
MODESTE,1922,1853,656,1197,35.4020507285483,64.59794927145171,Unisex
SULPICE,1922,508,182,326,35.826771653543304,64.1732283464567,Unisex
MODERAN,1922,258,58,200,22.48062015503876,77.51937984496125,Unisex
EUSTASE,1922,347,116,231,33.429394812680115,66.57060518731988,Unisex
SABAS,1922,607,220,387,36.24382207578254,63.75617792421746,Unisex
WENCESLAS,1922,877,175,702,19.95438996579248,80.04561003420753,Unisex
AMOUR,1922,782,287,495,36.70076726342711,63.29923273657288,Unisex
ROSARIO,1922,1546,781,765,50.51746442432082,49.48253557567917,Unisex
DENYSE,1923,44,44,0,100.0,0.0,Female
REYMONDE,1923,22,22,0,100.0,0.0,Female
MIREILLE,1923,1041,1041,0,100.0,0.0,Female
PHILOMÈNE,1923,4,4,0,100.0,0.0,Female
JEANE,1923,5,5,0,100.0,0.0,Female
GEORGETTE,1923,4629,4629,0,100.0,0.0,Female
MARIE-GEORGETTE,1923,3,3,0,100.0,0.0,Female
AMANTHE,1923,5,5,0,100.0,0.0,Female
ANGELIQUE,1923,70,70,0,100.0,0.0,Female
BLANDINE,1923,40,40,0,100.0,0.0,Female
HUGUETTE,1923,1427,1427,0,100.0,0.0,Female
ALFREDA,1923,180,180,0,100.0,0.0,Female
MARIE-FRANÇOISE,1923,16,16,0,100.0,0.0,Female
ELODIE,1923,40,40,0,100.0,0.0,Female
CLARISSE,1923,40,40,0,100.0,0.0,Female
NOÉLIE,1923,3,3,0,100.0,0.0,Female
MARINA,1923,9,9,0,100.0,0.0,Female
NOELINE,1923,20,20,0,100.0,0.0,Female
FLORETTE,1923,7,7,0,100.0,0.0,Female
LUCILIA,1923,3,3,0,100.0,0.0,Female
ALBINA,1923,4,4,0,100.0,0.0,Female
MARIE-MAGDELEINE,1923,4,4,0,100.0,0.0,Female
LUCIE,1923,1868,1868,0,100.0,0.0,Female
ANASTASIE,1923,3148,3106,42,98.66581956797968,1.3341804320203303,Female
CONSTANCE,1923,104,104,0,100.0,0.0,Female
ALEXIS,1923,150187,408,149779,0.2716613288766671,99.72833867112332,Male
VALMONT,1923,3,0,3,0.0,100.0,Male
JESUS,1923,17,0,17,0.0,100.0,Male
VALERIEN,1923,3,0,3,0.0,100.0,Male
MARC,1923,1086,0,1086,0.0,100.0,Male
THÉO,1923,8,0,8,0.0,100.0,Male
FERNAND,1923,3274,0,3274,0.0,100.0,Male
SALVATOR,1923,14,0,14,0.0,100.0,Male
WILLIAMS,1923,5,0,5,0.0,100.0,Male
PATRICE,1923,138904,794,138110,0.5716178079824915,99.42838219201752,Male
JOACHIM,1923,14719,183,14536,1.2432909844418778,98.75670901555812,Male
HERALD,1923,3,0,3,0.0,100.0,Male
VALERY,1923,24,0,24,0.0,100.0,Male
JEAN-ALBERT,1923,4,0,4,0.0,100.0,Male
ISIDORE,1923,117,0,117,0.0,100.0,Male
JULIO,1923,7,0,7,0.0,100.0,Male
JOSUE,1923,4,0,4,0.0,100.0,Male
GEOFFROY,1923,8964,121,8843,1.3498438197233378,98.65015618027668,Male
HORACE,1923,14,0,14,0.0,100.0,Male
HERMAND,1923,3,0,3,0.0,100.0,Male
GILLE,1923,3,0,3,0.0,100.0,Male
SYLVIO,1923,7,0,7,0.0,100.0,Male
THEODULE,1923,22,0,22,0.0,100.0,Male
EMMAUS,1923,4,0,4,0.0,100.0,Male
MEDERIC,1923,23,0,23,0.0,100.0,Male
HYACINTHE,1923,4679,1173,3506,25.069459286172258,74.93054071382774,Unisex
OCULI,1923,447,105,342,23.48993288590604,76.51006711409396,Unisex
CANDIDE,1923,1019,686,333,67.32090284592738,32.67909715407262,Unisex
ANTONIE,1923,986,749,237,75.9634888438134,24.036511156186613,Unisex
IRENEE,1923,6155,1854,4301,30.121852152721363,69.87814784727864,Unisex
_PRENOMS_RARES,1923,1760252,908578,851674,51.616359475802334,48.38364052419767,Unisex
MEDARD,1923,1076,175,901,16.263940520446095,83.7360594795539,Unisex
LEONIDE,1923,1588,1245,343,78.40050377833752,21.599496221662463,Unisex
PEPIN,1923,533,126,407,23.63977485928705,76.36022514071294,Unisex
MAMERT,1923,224,75,149,33.482142857142854,66.51785714285714,Unisex
SOSTHENE,1923,1059,185,874,17.469310670443818,82.53068932955618,Unisex
NICOMEDE,1923,430,193,237,44.88372093023256,55.11627906976744,Unisex
SEPTIME,1923,394,119,275,30.20304568527919,69.79695431472082,Unisex
CREPIN,1923,606,136,470,22.44224422442244,77.55775577557755,Unisex
MARIE-JOSEPH,1923,2275,1830,445,80.43956043956044,19.56043956043956,Unisex
CAMILLE,1923,287709,207732,79977,72.20212089298562,27.79787910701437,Unisex
EUSTASE,1923,347,116,231,33.429394812680115,66.57060518731988,Unisex
SAINTE,1923,1055,648,407,61.4218009478673,38.5781990521327,Unisex
AVIT,1923,485,106,379,21.855670103092784,78.14432989690722,Unisex
CARMEL,1923,409,197,212,48.16625916870416,51.83374083129584,Unisex
GABY,1923,4741,2448,2293,51.63467622864375,48.36532377135626,Unisex
FRUCTUEUX,1923,176,33,143,18.75,81.25,Unisex
NICAISE,1923,1786,1255,531,70.26875699888018,29.73124300111982,Unisex
PHILOGONE,1923,396,183,213,46.21212121212121,53.78787878787878,Unisex
ARCADE,1923,883,249,634,28.199320498301244,71.80067950169875,Unisex
LILLY,1924,12,12,0,100.0,0.0,Female
DOROTHEE,1924,15967,15713,254,98.40921901421682,1.590780985783178,Female
FLORINA,1924,8,8,0,100.0,0.0,Female
FRANCISKA,1924,11,11,0,100.0,0.0,Female
ROSA,1924,298,298,0,100.0,0.0,Female
OBELINE,1924,5,5,0,100.0,0.0,Female
GERTRUDE,1924,90,90,0,100.0,0.0,Female
ROSELYNE,1924,23,23,0,100.0,0.0,Female
LAURA,1924,11,11,0,100.0,0.0,Female
AMELINE,1924,5,5,0,100.0,0.0,Female
WILFRIDE,1924,3,3,0,100.0,0.0,Female
ALIDA,1924,32,32,0,100.0,0.0,Female
GHISLAINE,1924,179,179,0,100.0,0.0,Female
NADEGE,1924,29,29,0,100.0,0.0,Female
CÉCILIA,1924,48,48,0,100.0,0.0,Female
EMILIE,1924,466,466,0,100.0,0.0,Female
AIMÉE,1924,639,639,0,100.0,0.0,Female
EUPHRASIE,1924,42,42,0,100.0,0.0,Female
HENRIA,1924,22,22,0,100.0,0.0,Female
VICTORIA,1924,155,155,0,100.0,0.0,Female
SOFIA,1924,6,6,0,100.0,0.0,Female
JEANNINE,1924,5113,5113,0,100.0,0.0,Female
ERNESTE,1924,3,3,0,100.0,0.0,Female
FERDINANDE,1924,6,6,0,100.0,0.0,Female
EUDOXIE,1924,8,8,0,100.0,0.0,Female
JAN,1924,12,0,12,0.0,100.0,Male
WILFRED,1924,3,0,3,0.0,100.0,Male
JOACHIM,1924,14719,183,14536,1.2432909844418778,98.75670901555812,Male
RAMON,1924,24,0,24,0.0,100.0,Male
SIMEON,1924,34,0,34,0.0,100.0,Male
ROMAN,1924,17,0,17,0.0,100.0,Male
ALMIRE,1924,4,0,4,0.0,100.0,Male
ITALO,1924,13,0,13,0.0,100.0,Male
DOMINGO,1924,7,0,7,0.0,100.0,Male
MARC,1924,1067,0,1067,0.0,100.0,Male
ATHANASE,1924,1559,230,1329,14.753046824887749,85.24695317511225,Male
AMADEO,1924,3,0,3,0.0,100.0,Male
OTHON,1924,4,0,4,0.0,100.0,Male
WALTER,1924,34,0,34,0.0,100.0,Male
WILFRID,1924,8282,133,8149,1.605892296546728,98.39410770345329,Male
SYLVERE,1924,20,0,20,0.0,100.0,Male
JUSTE,1924,784,108,676,13.77551020408163,86.22448979591837,Male
JOHAN,1924,6,0,6,0.0,100.0,Male
PANTALEON,1924,3,0,3,0.0,100.0,Male
ADRIEN,1924,754,0,754,0.0,100.0,Male
NONCE,1924,8,0,8,0.0,100.0,Male
CYPRIEN,1924,73,0,73,0.0,100.0,Male
PETER,1924,10,0,10,0.0,100.0,Male
CZESLAW,1924,47,0,47,0.0,100.0,Male
AMÉDÉE,1924,4,0,4,0.0,100.0,Male
PULCHERIE,1924,738,579,159,78.45528455284553,21.54471544715448,Unisex
CAMILLE,1924,287709,207732,79977,72.20212089298562,27.79787910701437,Unisex
ONESIPHORE,1924,139,51,88,36.69064748201439,63.30935251798561,Unisex
ANDOCHE,1924,390,140,250,35.8974358974359,64.1025641025641,Unisex
THEOTINE,1924,147,94,53,63.94557823129252,36.054421768707485,Unisex
CREPIN,1924,606,136,470,22.44224422442244,77.55775577557755,Unisex
PLACIDE,1924,1098,214,884,19.489981785063755,80.51001821493625,Unisex
AMOUR,1924,782,287,495,36.70076726342711,63.29923273657288,Unisex
NICOMEDE,1924,430,193,237,44.88372093023256,55.11627906976744,Unisex
CALIXTE,1924,3347,540,2807,16.13385121003884,83.86614878996116,Unisex
_PRENOMS_RARES,1924,1760252,908578,851674,51.616359475802334,48.38364052419767,Unisex
GEORGE,1924,2417,650,1767,26.89284236657013,73.10715763342988,Unisex
WENCESLAS,1924,877,175,702,19.95438996579248,80.04561003420753,Unisex
MODESTE,1924,1853,656,1197,35.4020507285483,64.59794927145171,Unisex
MARIE-JOSEPH,1924,2275,1830,445,80.43956043956044,19.56043956043956,Unisex
DOMINIQUE,1924,409989,168027,241962,40.98329467375954,59.01670532624046,Unisex
FAUSTE,1924,179,86,93,48.04469273743017,51.95530726256983,Unisex
AGNAN,1924,455,124,331,27.25274725274725,72.74725274725274,Unisex
BABYLAS,1924,330,98,232,29.6969696969697,70.3030303030303,Unisex
EUSTACHE,1924,1376,277,1099,20.13081395348837,79.86918604651163,Unisex
LEONCE,1924,9290,2041,7249,21.96986006458557,78.03013993541443,Unisex
ARCADE,1924,883,249,634,28.199320498301244,71.80067950169875,Unisex
CANDIDE,1924,1019,686,333,67.32090284592738,32.67909715407262,Unisex
SABAS,1924,607,220,387,36.24382207578254,63.75617792421746,Unisex
FIACRE,1924,253,59,194,23.3201581027668,76.6798418972332,Unisex
YVONNE,1925,7021,7021,0,100.0,0.0,Female
JUDITH,1925,32,32,0,100.0,0.0,Female
FLAVIA,1925,4,4,0,100.0,0.0,Female
ROSETTA,1925,3,3,0,100.0,0.0,Female
MARIELLE,1925,4,4,0,100.0,0.0,Female
THERESINE,1925,7,7,0,100.0,0.0,Female
CZESLAWA,1925,21,21,0,100.0,0.0,Female
ANNE,1925,364561,364227,334,99.9083829592304,0.0916170407695831,Female
ROSELIA,1925,3,3,0,100.0,0.0,Female
ANASTHASIE,1925,9,9,0,100.0,0.0,Female
ADELIE,1925,4,4,0,100.0,0.0,Female
ALETH,1925,6,6,0,100.0,0.0,Female
SIDONIE,1925,9013,8890,123,98.63530456007987,1.3646954399201154,Female
ROMANIE,1925,3,3,0,100.0,0.0,Female
CLÉMENCE,1925,287,287,0,100.0,0.0,Female
MATHILDE,1925,594,594,0,100.0,0.0,Female
ELLEN,1925,5,5,0,100.0,0.0,Female
MIECZYSLAWA,1925,3,3,0,100.0,0.0,Female
NELLY,1925,404,404,0,100.0,0.0,Female
CESARINA,1925,8,8,0,100.0,0.0,Female
AUGUSTINE,1925,544,544,0,100.0,0.0,Female
JEANINA,1925,4,4,0,100.0,0.0,Female
ALBA,1925,14,14,0,100.0,0.0,Female
GERALDINE,1925,4,4,0,100.0,0.0,Female
EGLE,1925,3,3,0,100.0,0.0,Female
ALEXIS,1925,351,0,351,0.0,100.0,Male
FERIE,1925,7,0,7,0.0,100.0,Male
LUCET,1925,3,0,3,0.0,100.0,Male
SAINT-MARTIN,1925,4,0,4,0.0,100.0,Male
ROGATIEN,1925,9,0,9,0.0,100.0,Male
HUMBERTO,1925,3,0,3,0.0,100.0,Male
PEDRO,1925,25,0,25,0.0,100.0,Male
GUILLERMO,1925,3,0,3,0.0,100.0,Male
BIENAIME,1925,4,0,4,0.0,100.0,Male
ANNIBAL,1925,3,0,3,0.0,100.0,Male
AGATHON,1925,3,0,3,0.0,100.0,Male
ANTOINE,1925,282413,349,282064,0.1235778806216427,99.87642211937836,Male
LEONUS,1925,7,0,7,0.0,100.0,Male
ERMINIO,1925,6,0,6,0.0,100.0,Male
CESARE,1925,4,0,4,0.0,100.0,Male
GUISLAIN,1925,5,0,5,0.0,100.0,Male
ATHANASE,1925,1559,230,1329,14.753046824887749,85.24695317511225,Male
GUSTAVE,1925,37156,171,36985,0.4602217676822047,99.5397782323178,Male
JAROSLAV,1925,3,0,3,0.0,100.0,Male
LUCIANO,1925,15,0,15,0.0,100.0,Male
OSMIN,1925,6,0,6,0.0,100.0,Male
ARSÈNE,1925,5,0,5,0.0,100.0,Male
PRUDENT,1925,11,0,11,0.0,100.0,Male
GERMAIN,1925,597,0,597,0.0,100.0,Male
GODFROY,1925,4,0,4,0.0,100.0,Male
EULOGE,1925,621,198,423,31.88405797101449,68.11594202898551,Unisex
_PRENOMS_RARES,1925,1760252,908578,851674,51.616359475802334,48.38364052419767,Unisex
DANY,1925,26027,7836,18191,30.10719637299728,69.89280362700273,Unisex
EUSEBE,1925,1151,212,939,18.41876629018245,81.58123370981755,Unisex
SCHOLASTIQUE,1925,1080,835,245,77.31481481481481,22.685185185185187,Unisex
AMOUR,1925,782,287,495,36.70076726342711,63.29923273657288,Unisex
CANDIDE,1925,1019,686,333,67.32090284592738,32.67909715407262,Unisex
ENOGAT,1925,274,80,194,29.1970802919708,70.8029197080292,Unisex
IRENEE,1925,6155,1854,4301,30.121852152721363,69.87814784727864,Unisex
BABYLAS,1925,330,98,232,29.6969696969697,70.3030303030303,Unisex
AVIT,1925,485,106,379,21.855670103092784,78.14432989690722,Unisex
MAURILLE,1925,834,214,620,25.65947242206235,74.34052757793765,Unisex
MODESTE,1925,1853,656,1197,35.4020507285483,64.59794927145171,Unisex
DOCTROVEE,1925,127,67,60,52.75590551181102,47.24409448818898,Unisex
SABAS,1925,607,220,387,36.24382207578254,63.75617792421746,Unisex
GEORGE,1925,2417,650,1767,26.89284236657013,73.10715763342988,Unisex
LEONCE,1925,9290,2041,7249,21.96986006458557,78.03013993541443,Unisex
PIE,1925,251,88,163,35.0597609561753,64.9402390438247,Unisex
SAINTE,1925,1055,648,407,61.4218009478673,38.5781990521327,Unisex
HYACINTHE,1925,4679,1173,3506,25.069459286172258,74.93054071382774,Unisex
FIDELE,1925,793,162,631,20.42875157629256,79.57124842370744,Unisex
PHILOGONE,1925,396,183,213,46.21212121212121,53.78787878787878,Unisex
TIBURCE,1925,1019,212,807,20.80471050049068,79.19528949950933,Unisex
APPOLINAIRE,1925,632,126,506,19.93670886075949,80.0632911392405,Unisex
ANTONIE,1925,986,749,237,75.9634888438134,24.036511156186613,Unisex
SOPHIA,1926,21,21,0,100.0,0.0,Female
VIOLETTA,1926,9,9,0,100.0,0.0,Female
AMALIA,1926,13,13,0,100.0,0.0,Female
VERA,1926,23,23,0,100.0,0.0,Female
CARMELA,1926,15,15,0,100.0,0.0,Female
MARIE-MARTHE,1926,3,3,0,100.0,0.0,Female
CARMELINE,1926,3,3,0,100.0,0.0,Female
ELEONORA,1926,6,6,0,100.0,0.0,Female
GEORGINA,1926,62,62,0,100.0,0.0,Female
ANASTHASIE,1926,7,7,0,100.0,0.0,Female
ADALGISA,1926,7,7,0,100.0,0.0,Female
ROSIANE,1926,4,4,0,100.0,0.0,Female
CONSTANTINE,1926,6,6,0,100.0,0.0,Female
FRÉDÉRIQUE,1926,23,23,0,100.0,0.0,Female
LEOKADJA,1926,3,3,0,100.0,0.0,Female
MARTIALE,1926,5,5,0,100.0,0.0,Female
NOËLLE,1926,188,188,0,100.0,0.0,Female
JANNINE,1926,35,35,0,100.0,0.0,Female
BIANCA,1926,10,10,0,100.0,0.0,Female
VICTOIRE,1926,29257,29103,154,99.47363024233516,0.5263697576648323,Female
LOLITA,1926,5,5,0,100.0,0.0,Female
FLORIA,1926,4,4,0,100.0,0.0,Female
GENOVEFA,1926,9,9,0,100.0,0.0,Female
NADEGE,1926,36,36,0,100.0,0.0,Female
ANTONINE,1926,43,43,0,100.0,0.0,Female
FRITZ,1926,10,0,10,0.0,100.0,Male
ALFONSO,1926,3,0,3,0.0,100.0,Male
MAXIMIN,1926,4188,106,4082,2.531041069723018,97.46895893027698,Male
DOCTROVE,1926,9,0,9,0.0,100.0,Male
ZEPHIR,1926,4,0,4,0.0,100.0,Male
EDMOND,1926,54702,109,54593,0.1992614529633286,99.80073854703669,Male
ENGELBERT,1926,4,0,4,0.0,100.0,Male
JACKIE,1926,31,0,31,0.0,100.0,Male
JONAS,1926,7,0,7,0.0,100.0,Male
GIACOMO,1926,11,0,11,0.0,100.0,Male
DIEUDONNE,1926,11,0,11,0.0,100.0,Male
STEFANO,1926,5,0,5,0.0,100.0,Male
ANGELINO,1926,4,0,4,0.0,100.0,Male
MARCEAU,1926,302,0,302,0.0,100.0,Male
ELSO,1926,3,0,3,0.0,100.0,Male
ALOISE,1926,41,0,41,0.0,100.0,Male
ERIK,1926,3,0,3,0.0,100.0,Male
AMABLE,1926,3,0,3,0.0,100.0,Male
JEAN-MARIUS,1926,3,0,3,0.0,100.0,Male
JOAQUIM,1926,6,0,6,0.0,100.0,Male
ISMAEL,1926,19,0,19,0.0,100.0,Male
GUIDE,1926,6,0,6,0.0,100.0,Male
BELA,1926,6,0,6,0.0,100.0,Male
IVON,1926,4,0,4,0.0,100.0,Male
LEONARDO,1926,7,0,7,0.0,100.0,Male
SCHOLASTIQUE,1926,1080,835,245,77.31481481481481,22.685185185185187,Unisex
HONORAT,1926,652,270,382,41.41104294478527,58.58895705521472,Unisex
GUALBERT,1926,497,85,412,17.102615694164992,82.897384305835,Unisex
CRESCENT,1926,447,87,360,19.463087248322147,80.53691275167785,Unisex
ENOGAT,1926,274,80,194,29.1970802919708,70.8029197080292,Unisex
PIE,1926,251,88,163,35.0597609561753,64.9402390438247,Unisex
NONCE,1926,598,172,426,28.762541806020064,71.23745819397993,Unisex
AGNAN,1926,455,124,331,27.25274725274725,72.74725274725274,Unisex
ANDOCHE,1926,390,140,250,35.8974358974359,64.1025641025641,Unisex
NICAISE,1926,1786,1255,531,70.26875699888018,29.73124300111982,Unisex
GODFROY,1926,277,69,208,24.90974729241877,75.09025270758123,Unisex
CALIXTE,1926,3347,540,2807,16.13385121003884,83.86614878996116,Unisex
DOMINIQUE,1926,409989,168027,241962,40.98329467375954,59.01670532624046,Unisex
LIN,1926,701,177,524,25.24964336661912,74.75035663338089,Unisex
SABAS,1926,607,220,387,36.24382207578254,63.75617792421746,Unisex
_PRENOMS_RARES,1926,1760252,908578,851674,51.616359475802334,48.38364052419767,Unisex
ONESIPHORE,1926,139,51,88,36.69064748201439,63.30935251798561,Unisex
SEPTIME,1926,394,119,275,30.20304568527919,69.79695431472082,Unisex
PHILOGONE,1926,396,183,213,46.21212121212121,53.78787878787878,Unisex
ALIX,1926,37305,28371,8934,76.05146763168477,23.94853236831524,Unisex
AMOUR,1926,782,287,495,36.70076726342711,63.29923273657288,Unisex
WENCESLAS,1926,877,175,702,19.95438996579248,80.04561003420753,Unisex
ROSARIO,1926,1546,781,765,50.51746442432082,49.48253557567917,Unisex
SULPICE,1926,508,182,326,35.826771653543304,64.1732283464567,Unisex
LEONIDE,1926,1588,1245,343,78.40050377833752,21.599496221662463,Unisex
CLAUDINETTE,1927,5,5,0,100.0,0.0,Female
ALCIDIE,1927,3,3,0,100.0,0.0,Female
FRANCETTE,1927,50,50,0,100.0,0.0,Female
EMMANUELLE,1927,25,25,0,100.0,0.0,Female
GEORGINE,1927,26,26,0,100.0,0.0,Female
LUCILE,1927,131,131,0,100.0,0.0,Female
CÉLINE,1927,225,225,0,100.0,0.0,Female
LUCY,1927,8,8,0,100.0,0.0,Female
MATHEA,1927,3,3,0,100.0,0.0,Female
VANIA,1927,4,4,0,100.0,0.0,Female
ADRIENNE,1927,614,614,0,100.0,0.0,Female
MATHILDE,1927,516,516,0,100.0,0.0,Female
IVANA,1927,5,5,0,100.0,0.0,Female
CRISTIANE,1927,4,4,0,100.0,0.0,Female
CHRISTINE,1927,138,138,0,100.0,0.0,Female
JOHANNA,1927,16,16,0,100.0,0.0,Female
SUZI,1927,3,3,0,100.0,0.0,Female
URBAINE,1927,5,5,0,100.0,0.0,Female
CONCHITA,1927,3,3,0,100.0,0.0,Female
LAZARINE,1927,4,4,0,100.0,0.0,Female
ILVA,1927,6,6,0,100.0,0.0,Female
OLIVIA,1927,15,15,0,100.0,0.0,Female
ELIANA,1927,12,12,0,100.0,0.0,Female
JOAN,1927,7,7,0,100.0,0.0,Female
RENELISE,1927,4,4,0,100.0,0.0,Female
FENELON,1927,6,0,6,0.0,100.0,Male
AUBIN,1927,14,0,14,0.0,100.0,Male
BORTOLO,1927,3,0,3,0.0,100.0,Male
MARCO,1927,11,0,11,0.0,100.0,Male
SERGE,1927,2219,0,2219,0.0,100.0,Male
ONESIME,1927,11,0,11,0.0,100.0,Male
GUILLERMO,1927,4,0,4,0.0,100.0,Male
ERICH,1927,8,0,8,0.0,100.0,Male
FERREOL,1927,3,0,3,0.0,100.0,Male
BERTRAND,1927,123,0,123,0.0,100.0,Male
ELIE,1927,45306,1012,44294,2.233699730719993,97.76630026928,Male
AGOSTINO,1927,4,0,4,0.0,100.0,Male
FULGENCE,1927,5,0,5,0.0,100.0,Male
AMAR,1927,3,0,3,0.0,100.0,Male
ROLLAND,1927,181,0,181,0.0,100.0,Male
VICTORIN,1927,22,0,22,0.0,100.0,Male
ARSÈNE,1927,4,0,4,0.0,100.0,Male
CHARLEMAGNE,1927,1062,104,958,9.792843691148777,90.20715630885122,Male
CYRIAQUE,1927,2241,229,2012,10.218652387327086,89.78134761267292,Male
CASIMIR,1927,7241,279,6962,3.853058969755559,96.14694103024443,Male
LEONARDO,1927,9,0,9,0.0,100.0,Male
NORBERT,1927,439,0,439,0.0,100.0,Male
ARNOLD,1927,15,0,15,0.0,100.0,Male
RONALD,1927,10,0,10,0.0,100.0,Male
EDWIN,1927,7,0,7,0.0,100.0,Male
PULCHERIE,1927,738,579,159,78.45528455284553,21.54471544715448,Unisex
TIBURCE,1927,1019,212,807,20.80471050049068,79.19528949950933,Unisex
PEPIN,1927,533,126,407,23.63977485928705,76.36022514071294,Unisex
LEONCE,1927,9290,2041,7249,21.96986006458557,78.03013993541443,Unisex
CANDIDE,1927,1019,686,333,67.32090284592738,32.67909715407262,Unisex
THEOTINE,1927,147,94,53,63.94557823129252,36.054421768707485,Unisex
EUSTACHE,1927,1376,277,1099,20.13081395348837,79.86918604651163,Unisex
SCHOLASTIQUE,1927,1080,835,245,77.31481481481481,22.685185185185187,Unisex
MODESTE,1927,1853,656,1197,35.4020507285483,64.59794927145171,Unisex
CRESCENT,1927,447,87,360,19.463087248322147,80.53691275167785,Unisex
SOSTHENE,1927,1059,185,874,17.469310670443818,82.53068932955618,Unisex
EULOGE,1927,621,198,423,31.88405797101449,68.11594202898551,Unisex
MESMIN,1927,773,183,590,23.67399741267788,76.32600258732212,Unisex
SEPTIME,1927,394,119,275,30.20304568527919,69.79695431472082,Unisex
EUSEBE,1927,1151,212,939,18.41876629018245,81.58123370981755,Unisex
FIACRE,1927,253,59,194,23.3201581027668,76.6798418972332,Unisex
JANY,1927,3897,2256,1641,57.89068514241724,42.10931485758276,Unisex
TIMOLEON,1927,481,101,380,20.997920997921,79.002079002079,Unisex
ANTONIE,1927,986,749,237,75.9634888438134,24.036511156186613,Unisex
MAURILLE,1927,834,214,620,25.65947242206235,74.34052757793765,Unisex
ANDOCHE,1927,390,140,250,35.8974358974359,64.1025641025641,Unisex
ONESIPHORE,1927,139,51,88,36.69064748201439,63.30935251798561,Unisex
PHILOGONE,1927,396,183,213,46.21212121212121,53.78787878787878,Unisex
BABYLAS,1927,330,98,232,29.6969696969697,70.3030303030303,Unisex
AVIT,1927,485,106,379,21.855670103092784,78.14432989690722,Unisex
FERNANDA,1928,5,5,0,100.0,0.0,Female
PIERRETTE,1928,1971,1971,0,100.0,0.0,Female
LAURENCE,1928,224,224,0,100.0,0.0,Female
REYMONDE,1928,18,18,0,100.0,0.0,Female
BIBIANE,1928,4,4,0,100.0,0.0,Female
ANGELINA,1928,67,67,0,100.0,0.0,Female
DANIELA,1928,6,6,0,100.0,0.0,Female
NOELIE,1928,115,115,0,100.0,0.0,Female
HERMANCE,1928,24,24,0,100.0,0.0,Female
ALFREDA,1928,136,136,0,100.0,0.0,Female
JANETTE,1928,5,5,0,100.0,0.0,Female
PHILOMENE,1928,12505,12394,111,99.1123550579768,0.8876449420231908,Female
SIMEONNE,1928,4,4,0,100.0,0.0,Female
FLORIA,1928,8,8,0,100.0,0.0,Female
ELODIE,1928,20,20,0,100.0,0.0,Female
THOMASINE,1928,3,3,0,100.0,0.0,Female
EULALIE,1928,26,26,0,100.0,0.0,Female
BERTINE,1928,5,5,0,100.0,0.0,Female
CHRISTIANA,1928,3,3,0,100.0,0.0,Female
ELISABETHE,1928,3,3,0,100.0,0.0,Female
FLEURINE,1928,10,10,0,100.0,0.0,Female
LEOKADIA,1928,3,3,0,100.0,0.0,Female
RENELIA,1928,3,3,0,100.0,0.0,Female
CANDIDE,1928,6,6,0,100.0,0.0,Female
GINETE,1928,6,6,0,100.0,0.0,Female
BASILE,1928,16300,182,16118,1.116564417177914,98.88343558282207,Male
ROCH,1928,52,0,52,0.0,100.0,Male
BENITO,1928,9,0,9,0.0,100.0,Male
RUDOLPHE,1928,6,0,6,0.0,100.0,Male
IVO,1928,5,0,5,0.0,100.0,Male
FLOREAL,1928,6,0,6,0.0,100.0,Male
JEAN-YVES,1928,8,0,8,0.0,100.0,Male
ELI,1928,5,0,5,0.0,100.0,Male
OSCAR,1928,88,0,88,0.0,100.0,Male
ARMANDO,1928,21,0,21,0.0,100.0,Male
OTTO,1928,5,0,5,0.0,100.0,Male
MICHEL,1928,8825,0,8825,0.0,100.0,Male
EDGARD,1928,102,0,102,0.0,100.0,Male
TURENNE,1928,5,0,5,0.0,100.0,Male
JULOT,1928,6,0,6,0.0,100.0,Male
ANTIDE,1928,3,0,3,0.0,100.0,Male
GAUTHIER,1928,3,0,3,0.0,100.0,Male
ALCIME,1928,13,0,13,0.0,100.0,Male
WLADISLAW,1928,42,0,42,0.0,100.0,Male
BRUNOT,1928,4,0,4,0.0,100.0,Male
PHILIP,1928,4,0,4,0.0,100.0,Male
AUGUSTE,1928,85334,199,85135,0.2332013031148194,99.7667986968852,Male
ALOIS,1928,19,0,19,0.0,100.0,Male
PIOTR,1928,7,0,7,0.0,100.0,Male
MELCHIOR,1928,3,0,3,0.0,100.0,Male
PULCHERIE,1928,738,579,159,78.45528455284553,21.54471544715448,Unisex
PIE,1928,251,88,163,35.0597609561753,64.9402390438247,Unisex
OCULI,1928,447,105,342,23.48993288590604,76.51006711409396,Unisex
LEONCE,1928,9290,2041,7249,21.96986006458557,78.03013993541443,Unisex
SOSTHENE,1928,1059,185,874,17.469310670443818,82.53068932955618,Unisex
SCHOLASTIQUE,1928,1080,835,245,77.31481481481481,22.685185185185187,Unisex
NONCE,1928,598,172,426,28.762541806020064,71.23745819397993,Unisex
SAINTE,1928,1055,648,407,61.4218009478673,38.5781990521327,Unisex
TIBURCE,1928,1019,212,807,20.80471050049068,79.19528949950933,Unisex
MAURILLE,1928,834,214,620,25.65947242206235,74.34052757793765,Unisex
THEOTINE,1928,147,94,53,63.94557823129252,36.054421768707485,Unisex
GEORGE,1928,2417,650,1767,26.89284236657013,73.10715763342988,Unisex
MODESTE,1928,1853,656,1197,35.4020507285483,64.59794927145171,Unisex
FIACRE,1928,253,59,194,23.3201581027668,76.6798418972332,Unisex
MAGLOIRE,1928,673,106,567,15.75037147102526,84.24962852897474,Unisex
AGNAN,1928,455,124,331,27.25274725274725,72.74725274725274,Unisex
AVIT,1928,485,106,379,21.855670103092784,78.14432989690722,Unisex
IRENEE,1928,6155,1854,4301,30.121852152721363,69.87814784727864,Unisex
APPOLINAIRE,1928,632,126,506,19.93670886075949,80.0632911392405,Unisex
GABY,1928,4741,2448,2293,51.63467622864375,48.36532377135626,Unisex
MARY,1928,6861,5830,1031,84.97303600058301,15.026963999416996,Unisex
ANTONIE,1928,986,749,237,75.9634888438134,24.036511156186613,Unisex
DOMINIQUE,1928,409989,168027,241962,40.98329467375954,59.01670532624046,Unisex
EUSTACHE,1928,1376,277,1099,20.13081395348837,79.86918604651163,Unisex
AMOUR,1928,782,287,495,36.70076726342711,63.29923273657288,Unisex
ERICA,1929,10,10,0,100.0,0.0,Female
FRANÇOISE,1929,2397,2397,0,100.0,0.0,Female
TOSCA,1929,10,10,0,100.0,0.0,Female
MARIVONNE,1929,9,9,0,100.0,0.0,Female
IVANA,1929,3,3,0,100.0,0.0,Female
DESPINA,1929,4,4,0,100.0,0.0,Female
FRANCISCA,1929,25,25,0,100.0,0.0,Female
COLOMBA,1929,3,3,0,100.0,0.0,Female
JEANNE,1929,8972,8972,0,100.0,0.0,Female
LOUISE,1929,2535,2535,0,100.0,0.0,Female
JEANETTE,1929,12,12,0,100.0,0.0,Female
MARGUERITTE,1929,7,7,0,100.0,0.0,Female
CONSTANCE,1929,71,71,0,100.0,0.0,Female
BALBINA,1929,3,3,0,100.0,0.0,Female
LÉONIE,1929,290,290,0,100.0,0.0,Female
RENÉE,1929,5618,5618,0,100.0,0.0,Female
ANICETTE,1929,16,16,0,100.0,0.0,Female
CLAUDETTE,1929,563,563,0,100.0,0.0,Female
ERINA,1929,3,3,0,100.0,0.0,Female
OLIVETTE,1929,10,10,0,100.0,0.0,Female
SUZANNA,1929,3,3,0,100.0,0.0,Female
CLEMIRE,1929,3,3,0,100.0,0.0,Female
LUCILLE,1929,6,6,0,100.0,0.0,Female
MAURE,1929,4,4,0,100.0,0.0,Female
IRÈNE,1929,83934,82102,1832,97.81733266614243,2.182667333857555,Female
LÉOPOLD,1929,5,0,5,0.0,100.0,Male
ROLANDO,1929,8,0,8,0.0,100.0,Male
MAXIME,1929,224277,1364,222913,0.6081764960294636,99.39182350397051,Male
GERARDO,1929,4,0,4,0.0,100.0,Male
RICARDO,1929,12,0,12,0.0,100.0,Male
WLADYSLAW,1929,50,0,50,0.0,100.0,Male
HIPPOLYTE,1929,10908,200,10708,1.8335166850018327,98.16648331499816,Male
EPHREM,1929,4,0,4,0.0,100.0,Male
IVES,1929,4,0,4,0.0,100.0,Male
EDGARD,1929,86,0,86,0.0,100.0,Male
ZACHARIE,1929,5450,192,5258,3.522935779816514,96.47706422018348,Male
JOSÉ,1929,58950,1605,57345,2.72264631043257,97.27735368956742,Male
VITO,1929,4,0,4,0.0,100.0,Male
CYR,1929,16,0,16,0.0,100.0,Male
WILHEM,1929,6,0,6,0.0,100.0,Male
MAXIMILIEN,1929,36,0,36,0.0,100.0,Male
LIONEL,1929,211,0,211,0.0,100.0,Male
LUC,1929,65427,126,65301,0.1925810445229033,99.8074189554771,Male
CLET,1929,779,89,690,11.42490372272144,88.57509627727856,Male
LUCIANO,1929,5,0,5,0.0,100.0,Male
CLAUDINET,1929,4,0,4,0.0,100.0,Male
COLBERT,1929,11,0,11,0.0,100.0,Male
EMMAUS,1929,3,0,3,0.0,100.0,Male
VITAL,1929,35,0,35,0.0,100.0,Male
SAINT-ANGE,1929,8,0,8,0.0,100.0,Male
PIE,1929,251,88,163,35.0597609561753,64.9402390438247,Unisex
TIBURCE,1929,1019,212,807,20.80471050049068,79.19528949950933,Unisex
JANY,1929,3897,2256,1641,57.89068514241724,42.10931485758276,Unisex
MODERAN,1929,258,58,200,22.48062015503876,77.51937984496125,Unisex
PHILOGONE,1929,396,183,213,46.21212121212121,53.78787878787878,Unisex
MARY,1929,6861,5830,1031,84.97303600058301,15.026963999416996,Unisex
SERVAIS,1929,812,150,662,18.47290640394089,81.5270935960591,Unisex
CAMILLE,1929,287709,207732,79977,72.20212089298562,27.79787910701437,Unisex
EULOGE,1929,621,198,423,31.88405797101449,68.11594202898551,Unisex
SYLVA,1929,341,283,58,82.99120234604106,17.008797653958943,Unisex
ANDOCHE,1929,390,140,250,35.8974358974359,64.1025641025641,Unisex
ANTONIE,1929,986,749,237,75.9634888438134,24.036511156186613,Unisex
SABAS,1929,607,220,387,36.24382207578254,63.75617792421746,Unisex
HONORAT,1929,652,270,382,41.41104294478527,58.58895705521472,Unisex
HYACINTHE,1929,4679,1173,3506,25.069459286172258,74.93054071382774,Unisex
MAURILLE,1929,834,214,620,25.65947242206235,74.34052757793765,Unisex
LIN,1929,701,177,524,25.24964336661912,74.75035663338089,Unisex
SOCRATE,1929,378,96,282,25.396825396825395,74.60317460317461,Unisex
BONIFACE,1929,1187,217,970,18.28138163437237,81.71861836562763,Unisex
BABYLAS,1929,330,98,232,29.6969696969697,70.3030303030303,Unisex
GEORGE,1929,2417,650,1767,26.89284236657013,73.10715763342988,Unisex
PULCHERIE,1929,738,579,159,78.45528455284553,21.54471544715448,Unisex
ALIX,1929,37305,28371,8934,76.05146763168477,23.94853236831524,Unisex
SULPICE,1929,508,182,326,35.826771653543304,64.1732283464567,Unisex
AMOUR,1929,782,287,495,36.70076726342711,63.29923273657288,Unisex
FABIENNE,1930,55,55,0,100.0,0.0,Female
CASIMIERA,1930,4,4,0,100.0,0.0,Female
ANNIK,1930,44,44,0,100.0,0.0,Female
ODYLE,1930,13,13,0,100.0,0.0,Female
RENELLE,1930,19,19,0,100.0,0.0,Female
LYLIANE,1930,29,29,0,100.0,0.0,Female
URSULA,1930,4,4,0,100.0,0.0,Female
LILLIANE,1930,7,7,0,100.0,0.0,Female
EDMÉE,1930,3,3,0,100.0,0.0,Female
LISELOTTE,1930,4,4,0,100.0,0.0,Female
TERESA,1930,12,12,0,100.0,0.0,Female
LOUISA,1930,66,66,0,100.0,0.0,Female
CHRISTINE,1930,153,153,0,100.0,0.0,Female
MIRANDA,1930,4,4,0,100.0,0.0,Female
NICETTE,1930,5,5,0,100.0,0.0,Female
STEFANIE,1930,3,3,0,100.0,0.0,Female
JOSYANE,1930,9,9,0,100.0,0.0,Female
LIBERTE,1930,3,3,0,100.0,0.0,Female
ARMANDE,1930,237,237,0,100.0,0.0,Female
LINDA,1930,4,4,0,100.0,0.0,Female
GISETTE,1930,5,5,0,100.0,0.0,Female
CHARLOTTE,1930,587,587,0,100.0,0.0,Female
BARBE,1930,3019,2623,396,86.88307386551838,13.116926134481616,Female
MARIE-JOSEE,1930,5,5,0,100.0,0.0,Female
MARIE,1930,2258792,2231909,26883,98.8098505749976,1.1901494250023907,Female
VICENTE,1930,8,0,8,0.0,100.0,Male
IMBERT,1930,3,0,3,0.0,100.0,Male
PRIVAT,1930,5,0,5,0.0,100.0,Male
AMEDEE,1930,8323,621,7702,7.461251952421002,92.538748047579,Male
ARAM,1930,3,0,3,0.0,100.0,Male
ADALBERT,1930,7,0,7,0.0,100.0,Male
DESIR,1930,5,0,5,0.0,100.0,Male
BAPTISTIN,1930,21,0,21,0.0,100.0,Male
MARC,1930,238188,261,237927,0.109577308680538,99.89042269131946,Male
GEOFFROI,1930,8,0,8,0.0,100.0,Male
ALBIN,1930,33,0,33,0.0,100.0,Male
GUALBERT,1930,12,0,12,0.0,100.0,Male
BENJAMIN,1930,67,0,67,0.0,100.0,Male
EDVIN,1930,4,0,4,0.0,100.0,Male
FRANK,1930,15,0,15,0.0,100.0,Male
JEAN-MARCEL,1930,5,0,5,0.0,100.0,Male
MORAND,1930,6,0,6,0.0,100.0,Male
LIVIO,1930,10,0,10,0.0,100.0,Male
RAMON,1930,34,0,34,0.0,100.0,Male
GHISLAIN,1930,31,0,31,0.0,100.0,Male
WILFRID,1930,23,0,23,0.0,100.0,Male
ALI,1930,16,0,16,0.0,100.0,Male
REMO,1930,14,0,14,0.0,100.0,Male
DIMITRI,1930,18,0,18,0.0,100.0,Male
GABIN,1930,48297,162,48135,0.33542456053171,99.6645754394683,Male
GODFROY,1930,277,69,208,24.90974729241877,75.09025270758123,Unisex
PULCHERIE,1930,738,579,159,78.45528455284553,21.54471544715448,Unisex
MAGLOIRE,1930,673,106,567,15.75037147102526,84.24962852897474,Unisex
TIBURCE,1930,1019,212,807,20.80471050049068,79.19528949950933,Unisex
NICAISE,1930,1786,1255,531,70.26875699888018,29.73124300111982,Unisex
BONIFACE,1930,1187,217,970,18.28138163437237,81.71861836562763,Unisex
SOSTHENE,1930,1059,185,874,17.469310670443818,82.53068932955618,Unisex
ANDOCHE,1930,390,140,250,35.8974358974359,64.1025641025641,Unisex
GABY,1930,4741,2448,2293,51.63467622864375,48.36532377135626,Unisex
MARY,1930,6861,5830,1031,84.97303600058301,15.026963999416996,Unisex
BABYLAS,1930,330,98,232,29.6969696969697,70.3030303030303,Unisex
MODERAN,1930,258,58,200,22.48062015503876,77.51937984496125,Unisex
MODESTE,1930,1853,656,1197,35.4020507285483,64.59794927145171,Unisex
LEONCE,1930,9290,2041,7249,21.96986006458557,78.03013993541443,Unisex
MARIE-JOSEPH,1930,2275,1830,445,80.43956043956044,19.56043956043956,Unisex
SAINTE,1930,1055,648,407,61.4218009478673,38.5781990521327,Unisex
HONORAT,1930,652,270,382,41.41104294478527,58.58895705521472,Unisex
ARCADE,1930,883,249,634,28.199320498301244,71.80067950169875,Unisex
JEANNY,1930,968,718,250,74.17355371900827,25.82644628099173,Unisex
LIN,1930,701,177,524,25.24964336661912,74.75035663338089,Unisex
CARMEL,1930,409,197,212,48.16625916870416,51.83374083129584,Unisex
JANY,1930,3897,2256,1641,57.89068514241724,42.10931485758276,Unisex
GEORGE,1930,2417,650,1767,26.89284236657013,73.10715763342988,Unisex
LEONIDE,1930,1588,1245,343,78.40050377833752,21.599496221662463,Unisex
PERPETUE,1930,201,134,67,66.66666666666666,33.33333333333333,Unisex
PERRINE,1931,14,14,0,100.0,0.0,Female
ELIANA,1931,6,6,0,100.0,0.0,Female
ARGENTINE,1931,13,13,0,100.0,0.0,Female
WLADISLAWA,1931,52,52,0,100.0,0.0,Female
ZINA,1931,3,3,0,100.0,0.0,Female
ESTER,1931,5,5,0,100.0,0.0,Female
MARCELLA,1931,14,14,0,100.0,0.0,Female
JOSSELYNE,1931,6,6,0,100.0,0.0,Female
LÉNA,1931,8,8,0,100.0,0.0,Female
AVITE,1931,3,3,0,100.0,0.0,Female
DESIREE,1931,57,57,0,100.0,0.0,Female
VIVETTE,1931,5,5,0,100.0,0.0,Female
GALINA,1931,4,4,0,100.0,0.0,Female
GAETANE,1931,38,38,0,100.0,0.0,Female
ALINE,1931,705,705,0,100.0,0.0,Female
NADIA,1931,72,72,0,100.0,0.0,Female
VIVIENNE,1931,23,23,0,100.0,0.0,Female
ANIK,1931,4,4,0,100.0,0.0,Female
SYLVINA,1931,5,5,0,100.0,0.0,Female
EMILIENNE,1931,756,756,0,100.0,0.0,Female
JOSYANE,1931,14,14,0,100.0,0.0,Female
MARIZE,1931,8,8,0,100.0,0.0,Female
CESLAWA,1931,7,7,0,100.0,0.0,Female
NELLY,1931,425,425,0,100.0,0.0,Female
LEONETTE,1931,3,3,0,100.0,0.0,Female
MATHIEU,1931,108,0,108,0.0,100.0,Male
PRIMO,1931,22,0,22,0.0,100.0,Male
PHILEMON,1931,11,0,11,0.0,100.0,Male
GEORGES,1931,405954,611,405343,0.1505096636564734,99.84949033634352,Male
JEAN-MARC,1931,10,0,10,0.0,100.0,Male
PASCAL,1931,164,0,164,0.0,100.0,Male
RUDOLPH,1931,3,0,3,0.0,100.0,Male
BERNADIN,1931,9,0,9,0.0,100.0,Male
HENRIUS,1931,3,0,3,0.0,100.0,Male
RODOLPHE,1931,121,0,121,0.0,100.0,Male
SALOMON,1931,22,0,22,0.0,100.0,Male
EDWARD,1931,48,0,48,0.0,100.0,Male
CARL,1931,3,0,3,0.0,100.0,Male
ROLAND,1931,3374,0,3374,0.0,100.0,Male
YANNICK,1931,10,0,10,0.0,100.0,Male
NINO,1931,4,0,4,0.0,100.0,Male
THADEE,1931,15,0,15,0.0,100.0,Male
ANGELINO,1931,5,0,5,0.0,100.0,Male
JOSUE,1931,3,0,3,0.0,100.0,Male
JULIEN,1931,930,0,930,0.0,100.0,Male
GREGORIO,1931,6,0,6,0.0,100.0,Male
AMOUR,1931,3,0,3,0.0,100.0,Male
BENOIST,1931,3,0,3,0.0,100.0,Male
DANTE,1931,27,0,27,0.0,100.0,Male
DIEGO,1931,32,0,32,0.0,100.0,Male
EUSTASE,1931,347,116,231,33.429394812680115,66.57060518731988,Unisex
MAUR,1931,144,23,121,15.97222222222222,84.02777777777779,Unisex
GEORGE,1931,2417,650,1767,26.89284236657013,73.10715763342988,Unisex
HYACINTHE,1931,4679,1173,3506,25.069459286172258,74.93054071382774,Unisex
CLAUDY,1931,2240,835,1405,37.27678571428572,62.72321428571429,Unisex
ALIX,1931,37305,28371,8934,76.05146763168477,23.94853236831524,Unisex
SAINTE,1931,1055,648,407,61.4218009478673,38.5781990521327,Unisex
FAUSTE,1931,179,86,93,48.04469273743017,51.95530726256983,Unisex
PULCHERIE,1931,738,579,159,78.45528455284553,21.54471544715448,Unisex
MARY,1931,6861,5830,1031,84.97303600058301,15.026963999416996,Unisex
CAMILLE,1931,287709,207732,79977,72.20212089298562,27.79787910701437,Unisex
TIBURCE,1931,1019,212,807,20.80471050049068,79.19528949950933,Unisex
JEANNY,1931,968,718,250,74.17355371900827,25.82644628099173,Unisex
PEPIN,1931,533,126,407,23.63977485928705,76.36022514071294,Unisex
MESMIN,1931,773,183,590,23.67399741267788,76.32600258732212,Unisex
NONCE,1931,598,172,426,28.762541806020064,71.23745819397993,Unisex
DOMINIQUE,1931,409989,168027,241962,40.98329467375954,59.01670532624046,Unisex
EUSTACHE,1931,1376,277,1099,20.13081395348837,79.86918604651163,Unisex
SAINTE-CROIX,1931,486,103,383,21.193415637860085,78.80658436213992,Unisex
GODFROY,1931,277,69,208,24.90974729241877,75.09025270758123,Unisex
ANTONIE,1931,986,749,237,75.9634888438134,24.036511156186613,Unisex
NICOMEDE,1931,430,193,237,44.88372093023256,55.11627906976744,Unisex
_PRENOMS_RARES,1931,1760252,908578,851674,51.616359475802334,48.38364052419767,Unisex
LIN,1931,701,177,524,25.24964336661912,74.75035663338089,Unisex
MAURILLE,1931,834,214,620,25.65947242206235,74.34052757793765,Unisex
JEANY,1932,4,4,0,100.0,0.0,Female
CHARLISE,1932,3,3,0,100.0,0.0,Female
OLYMPE,1932,6418,6104,314,95.10751012776566,4.892489872234341,Female
VINCENTINE,1932,3,3,0,100.0,0.0,Female
MATHURINE,1932,9,9,0,100.0,0.0,Female
FABIENNE,1932,63,63,0,100.0,0.0,Female
LUCIE,1932,1091,1091,0,100.0,0.0,Female
BAPTISTINE,1932,34,34,0,100.0,0.0,Female
MINA,1932,5,5,0,100.0,0.0,Female
GERTRUDE,1932,90,90,0,100.0,0.0,Female
YOLLANDE,1932,6,6,0,100.0,0.0,Female
NINETTE,1932,5,5,0,100.0,0.0,Female
IMELDA,1932,12,12,0,100.0,0.0,Female
LEONINE,1932,3,3,0,100.0,0.0,Female
ROSINA,1932,11,11,0,100.0,0.0,Female
MYRIAME,1932,13,13,0,100.0,0.0,Female
GRAZIELLA,1932,10,10,0,100.0,0.0,Female
PELAGIA,1932,7,7,0,100.0,0.0,Female
CLAUDETTE,1932,928,928,0,100.0,0.0,Female
NOËLLE,1932,250,250,0,100.0,0.0,Female
ELFRIDE,1932,3,3,0,100.0,0.0,Female
ZAINA,1932,3,3,0,100.0,0.0,Female
PALMIRA,1932,4,4,0,100.0,0.0,Female
GENIA,1932,10,10,0,100.0,0.0,Female
SABINA,1932,18,18,0,100.0,0.0,Female
YANNICK,1932,91754,5225,86529,5.694574623449658,94.30542537655036,Male
VENANT,1932,3,0,3,0.0,100.0,Male
LEOPOLD,1932,103,0,103,0.0,100.0,Male
TIMOTHÉE,1932,3,0,3,0.0,100.0,Male
THERESIEN,1932,6,0,6,0.0,100.0,Male
IRMIN,1932,4,0,4,0.0,100.0,Male
EUCHER,1932,4,0,4,0.0,100.0,Male
BONAVENTURE,1932,4,0,4,0.0,100.0,Male
JOACHIN,1932,7,0,7,0.0,100.0,Male
FRANCIS,1932,1915,0,1915,0.0,100.0,Male
SAUVEUR,1932,53,0,53,0.0,100.0,Male
THÉODORE,1932,3,0,3,0.0,100.0,Male
EVARISTO,1932,3,0,3,0.0,100.0,Male
PIERRINO,1932,3,0,3,0.0,100.0,Male
JACQUY,1932,30,0,30,0.0,100.0,Male
LYONEL,1932,4,0,4,0.0,100.0,Male
ETIENNE,1932,85220,406,84814,0.4764139873269186,99.52358601267308,Male
ROMUALD,1932,11,0,11,0.0,100.0,Male
ELISEE,1932,26,0,26,0.0,100.0,Male
MARCELLO,1932,5,0,5,0.0,100.0,Male
PAMPHILE,1932,3,0,3,0.0,100.0,Male
DANY,1932,3,0,3,0.0,100.0,Male
LOTHAIRE,1932,3,0,3,0.0,100.0,Male
RENAUD,1932,19,0,19,0.0,100.0,Male
AXEL,1932,7,0,7,0.0,100.0,Male
IRENEE,1932,6155,1854,4301,30.121852152721363,69.87814784727864,Unisex
MARY,1932,6861,5830,1031,84.97303600058301,15.026963999416996,Unisex
JANICK,1932,4109,2203,1906,53.61401800924799,46.38598199075201,Unisex
EUSTACHE,1932,1376,277,1099,20.13081395348837,79.86918604651163,Unisex
EUSTASE,1932,347,116,231,33.429394812680115,66.57060518731988,Unisex
ATTALE,1932,80,27,53,33.75,66.25,Unisex
NICOMEDE,1932,430,193,237,44.88372093023256,55.11627906976744,Unisex
GABY,1932,4741,2448,2293,51.63467622864375,48.36532377135626,Unisex
JANY,1932,3897,2256,1641,57.89068514241724,42.10931485758276,Unisex
CAMILLE,1932,287709,207732,79977,72.20212089298562,27.79787910701437,Unisex
FAUSTE,1932,179,86,93,48.04469273743017,51.95530726256983,Unisex
LEONCE,1932,9290,2041,7249,21.96986006458557,78.03013993541443,Unisex
LIE,1932,328,80,248,24.390243902439025,75.60975609756098,Unisex
TIMOLEON,1932,481,101,380,20.997920997921,79.002079002079,Unisex
MARIE-JOSEPH,1932,2275,1830,445,80.43956043956044,19.56043956043956,Unisex
LIN,1932,701,177,524,25.24964336661912,74.75035663338089,Unisex
LEONIDE,1932,1588,1245,343,78.40050377833752,21.599496221662463,Unisex
MAGLOIRE,1932,673,106,567,15.75037147102526,84.24962852897474,Unisex
HYACINTHE,1932,4679,1173,3506,25.069459286172258,74.93054071382774,Unisex
ALIX,1932,37305,28371,8934,76.05146763168477,23.94853236831524,Unisex
HONORAT,1932,652,270,382,41.41104294478527,58.58895705521472,Unisex
SERVAIS,1932,812,150,662,18.47290640394089,81.5270935960591,Unisex
MODERAN,1932,258,58,200,22.48062015503876,77.51937984496125,Unisex
TIBURCE,1932,1019,212,807,20.80471050049068,79.19528949950933,Unisex
SOSTHENE,1932,1059,185,874,17.469310670443818,82.53068932955618,Unisex
CARMEN,1933,444,444,0,100.0,0.0,Female
MONA,1933,4,4,0,100.0,0.0,Female
EDITH,1933,598,598,0,100.0,0.0,Female
ALPHONSINE,1933,118,118,0,100.0,0.0,Female
HERMINE,1933,44,44,0,100.0,0.0,Female
PAULE,1933,784,784,0,100.0,0.0,Female
ÉLIANE,1933,4,4,0,100.0,0.0,Female
TOUSSINE,1933,15,15,0,100.0,0.0,Female
PIA,1933,5,5,0,100.0,0.0,Female
JOSETTE,1933,4316,4316,0,100.0,0.0,Female
CÉCILE,1933,177846,177666,180,99.89878883978274,0.1012111602172666,Female
ALBANIE,1933,9,9,0,100.0,0.0,Female
ERMINIA,1933,4,4,0,100.0,0.0,Female
ERIKA,1933,4,4,0,100.0,0.0,Female
ANNIK,1933,50,50,0,100.0,0.0,Female
ROSE-MARIE,1933,48,48,0,100.0,0.0,Female
MARTIALE,1933,3,3,0,100.0,0.0,Female
LIANE,1933,18,18,0,100.0,0.0,Female
ARMANTINE,1933,4,4,0,100.0,0.0,Female
FULBERTE,1933,6,6,0,100.0,0.0,Female
ALSACE,1933,5,5,0,100.0,0.0,Female
FRANCINE,1933,1227,1227,0,100.0,0.0,Female
FLORIANE,1933,6,6,0,100.0,0.0,Female
ANTONINA,1933,12,12,0,100.0,0.0,Female
CÉCILIA,1933,25,25,0,100.0,0.0,Female
EVARISTE,1933,1780,214,1566,12.022471910112358,87.97752808988764,Male
JEAN-LOUIS,1933,157,0,157,0.0,100.0,Male
JANOT,1933,6,0,6,0.0,100.0,Male
ANTONI,1933,11,0,11,0.0,100.0,Male
JEAN,1933,1913115,548,1912567,0.0286443836361117,99.9713556163639,Male
MARIAN,1933,34,0,34,0.0,100.0,Male
ZIGMUND,1933,4,0,4,0.0,100.0,Male
GEDEON,1933,3,0,3,0.0,100.0,Male
BAPTISTE,1933,86,0,86,0.0,100.0,Male
ISMAEL,1933,12,0,12,0.0,100.0,Male
EDVARD,1933,8,0,8,0.0,100.0,Male
GODEFROY,1933,8,0,8,0.0,100.0,Male
ELMO,1933,3,0,3,0.0,100.0,Male
LIE,1933,8,0,8,0.0,100.0,Male
HILDEBERT,1933,4,0,4,0.0,100.0,Male
SEVERINO,1933,9,0,9,0.0,100.0,Male
CESARE,1933,3,0,3,0.0,100.0,Male
LEONUS,1933,8,0,8,0.0,100.0,Male
VICTOR,1933,796,0,796,0.0,100.0,Male
STÉPHANE,1933,309728,1221,308507,0.3942168612459965,99.605783138754,Male
VALENTINO,1933,4,0,4,0.0,100.0,Male
CLODOMIR,1933,4,0,4,0.0,100.0,Male
SANTIAGO,1933,8,0,8,0.0,100.0,Male
ADOLFO,1933,3,0,3,0.0,100.0,Male
PIERINO,1933,5,0,5,0.0,100.0,Male
NICOMEDE,1933,430,193,237,44.88372093023256,55.11627906976744,Unisex
ERNESTE,1933,189,104,85,55.02645502645503,44.97354497354497,Unisex
EUTROPE,1933,194,70,124,36.08247422680412,63.91752577319587,Unisex
PIE,1933,251,88,163,35.0597609561753,64.9402390438247,Unisex
GEORGE,1933,2417,650,1767,26.89284236657013,73.10715763342988,Unisex
JANY,1933,3897,2256,1641,57.89068514241724,42.10931485758276,Unisex
HYACINTHE,1933,4679,1173,3506,25.069459286172258,74.93054071382774,Unisex
QUIRIN,1933,193,38,155,19.68911917098445,80.31088082901555,Unisex
_PRENOMS_RARES,1933,1760252,908578,851674,51.616359475802334,48.38364052419767,Unisex
LEONCE,1933,9290,2041,7249,21.96986006458557,78.03013993541443,Unisex
MAGLOIRE,1933,673,106,567,15.75037147102526,84.24962852897474,Unisex
AVIT,1933,485,106,379,21.855670103092784,78.14432989690722,Unisex
SOCRATE,1933,378,96,282,25.396825396825395,74.60317460317461,Unisex
EUSEBE,1933,1151,212,939,18.41876629018245,81.58123370981755,Unisex
PERPETUE,1933,201,134,67,66.66666666666666,33.33333333333333,Unisex
EULOGE,1933,621,198,423,31.88405797101449,68.11594202898551,Unisex
JANICK,1933,4109,2203,1906,53.61401800924799,46.38598199075201,Unisex
AUBIERGE,1933,193,125,68,64.76683937823834,35.233160621761655,Unisex
HENRIE,1933,128,96,32,75.0,25.0,Unisex
MEDARD,1933,1076,175,901,16.263940520446095,83.7360594795539,Unisex
MAMERT,1933,224,75,149,33.482142857142854,66.51785714285714,Unisex
SERVAIS,1933,812,150,662,18.47290640394089,81.5270935960591,Unisex
PHILOGONE,1933,396,183,213,46.21212121212121,53.78787878787878,Unisex
NICAISE,1933,1786,1255,531,70.26875699888018,29.73124300111982,Unisex
SABAS,1933,607,220,387,36.24382207578254,63.75617792421746,Unisex
MARIE-MARGUERITE,1934,6,6,0,100.0,0.0,Female
LOUISIANE,1934,10,10,0,100.0,0.0,Female
TOUSSINE,1934,7,7,0,100.0,0.0,Female
MAURICIA,1934,13,13,0,100.0,0.0,Female
HEDWIG,1934,4,4,0,100.0,0.0,Female
HENRYKA,1934,4,4,0,100.0,0.0,Female
CLAIRE,1934,160124,159893,231,99.85573680397692,0.1442631960230821,Female
NOËLLE,1934,278,278,0,100.0,0.0,Female
INÈS,1934,86,86,0,100.0,0.0,Female
ALEXANDRINE,1934,62,62,0,100.0,0.0,Female
NELLIE,1934,11,11,0,100.0,0.0,Female
ZORA,1934,7,7,0,100.0,0.0,Female
GHYSLAINE,1934,11,11,0,100.0,0.0,Female
VALERIA,1934,4,4,0,100.0,0.0,Female
JEANINNE,1934,12,12,0,100.0,0.0,Female
MARINA,1934,38,38,0,100.0,0.0,Female
LEOKADJA,1934,4,4,0,100.0,0.0,Female
JOSETE,1934,6,6,0,100.0,0.0,Female
APOLLONIE,1934,8,8,0,100.0,0.0,Female
CLODINE,1934,4,4,0,100.0,0.0,Female
MARIE-ODILE,1934,11,11,0,100.0,0.0,Female
NUNZIA,1934,4,4,0,100.0,0.0,Female
ADELA,1934,10,10,0,100.0,0.0,Female
ELIDE,1934,3,3,0,100.0,0.0,Female
CÉLINE,1934,209,209,0,100.0,0.0,Female
EWALD,1934,7,0,7,0.0,100.0,Male
ZDZISLAW,1934,10,0,10,0.0,100.0,Male
GRACIEUX,1934,3,0,3,0.0,100.0,Male
GHISLAIN,1934,50,0,50,0.0,100.0,Male
LUCAY,1934,15,0,15,0.0,100.0,Male
EUGENIO,1934,6,0,6,0.0,100.0,Male
MICHAEL,1934,7,0,7,0.0,100.0,Male
IRÉNÉE,1934,3,0,3,0.0,100.0,Male
SANTOS,1934,4,0,4,0.0,100.0,Male
SANTO,1934,8,0,8,0.0,100.0,Male
PETRUS,1934,6,0,6,0.0,100.0,Male
JONAS,1934,7,0,7,0.0,100.0,Male
ZENON,1934,22,0,22,0.0,100.0,Male
JEAN-MARC,1934,17,0,17,0.0,100.0,Male
VALENTIN,1934,62,0,62,0.0,100.0,Male
VICTOR,1934,132737,125,132612,0.094171180605257,99.90582881939474,Male
CARMELO,1934,5,0,5,0.0,100.0,Male
FIORINO,1934,3,0,3,0.0,100.0,Male
GERAUD,1934,14,0,14,0.0,100.0,Male
ALFEO,1934,3,0,3,0.0,100.0,Male
MANOEL,1934,8,0,8,0.0,100.0,Male
JEAN-MAURICE,1934,4,0,4,0.0,100.0,Male
MAXIMIN,1934,48,0,48,0.0,100.0,Male
ANGELY,1934,4,0,4,0.0,100.0,Male
ERNEST,1934,54184,112,54072,0.2067030857817806,99.79329691421822,Male
AGNAN,1934,455,124,331,27.25274725274725,72.74725274725274,Unisex
CARMEL,1934,409,197,212,48.16625916870416,51.83374083129584,Unisex
SAINTE,1934,1055,648,407,61.4218009478673,38.5781990521327,Unisex
MODESTE,1934,1853,656,1197,35.4020507285483,64.59794927145171,Unisex
MARY,1934,6861,5830,1031,84.97303600058301,15.026963999416996,Unisex
CAMILLE,1934,287709,207732,79977,72.20212089298562,27.79787910701437,Unisex
GEORGE,1934,2417,650,1767,26.89284236657013,73.10715763342988,Unisex
EUTROPE,1934,194,70,124,36.08247422680412,63.91752577319587,Unisex
MEDARD,1934,1076,175,901,16.263940520446095,83.7360594795539,Unisex
PEPIN,1934,533,126,407,23.63977485928705,76.36022514071294,Unisex
TIBURCE,1934,1019,212,807,20.80471050049068,79.19528949950933,Unisex
ROSARIO,1934,1546,781,765,50.51746442432082,49.48253557567917,Unisex
SEPTIME,1934,394,119,275,30.20304568527919,69.79695431472082,Unisex
PULCHERIE,1934,738,579,159,78.45528455284553,21.54471544715448,Unisex
EUSTASE,1934,347,116,231,33.429394812680115,66.57060518731988,Unisex
AUBIERGE,1934,193,125,68,64.76683937823834,35.233160621761655,Unisex
NICOMEDE,1934,430,193,237,44.88372093023256,55.11627906976744,Unisex
CRESCENT,1934,447,87,360,19.463087248322147,80.53691275167785,Unisex
JANY,1934,3897,2256,1641,57.89068514241724,42.10931485758276,Unisex
HYACINTHE,1934,4679,1173,3506,25.069459286172258,74.93054071382774,Unisex
EUSTACHE,1934,1376,277,1099,20.13081395348837,79.86918604651163,Unisex
EUSEBE,1934,1151,212,939,18.41876629018245,81.58123370981755,Unisex
CLAUDY,1934,2240,835,1405,37.27678571428572,62.72321428571429,Unisex
IRENEE,1934,6155,1854,4301,30.121852152721363,69.87814784727864,Unisex
PHILOGONE,1934,396,183,213,46.21212121212121,53.78787878787878,Unisex
YVONNETTE,1935,8,8,0,100.0,0.0,Female
MAUDE,1935,12,12,0,100.0,0.0,Female
LUCILLE,1935,4,4,0,100.0,0.0,Female
ANNIC,1935,52,52,0,100.0,0.0,Female
ROSELINE,1935,224,224,0,100.0,0.0,Female
MAURICETTE,1935,1563,1563,0,100.0,0.0,Female
GINA,1935,30,30,0,100.0,0.0,Female
VÉRONIQUE,1935,235902,235723,179,99.92412103331044,0.0758789666895575,Female
CLAUDIE,1935,184,184,0,100.0,0.0,Female
LUDMILA,1935,4,4,0,100.0,0.0,Female
CASIMIRA,1935,13,13,0,100.0,0.0,Female
VENISE,1935,4,4,0,100.0,0.0,Female
NANCY,1935,8,8,0,100.0,0.0,Female
SUZELLE,1935,9,9,0,100.0,0.0,Female
JOSEFA,1935,7,7,0,100.0,0.0,Female
FORTUNEE,1935,16,16,0,100.0,0.0,Female
LINDA,1935,4,4,0,100.0,0.0,Female
HENRIA,1935,7,7,0,100.0,0.0,Female
LOUISIANE,1935,8,8,0,100.0,0.0,Female
ODILIA,1935,3,3,0,100.0,0.0,Female
SYLVIANNE,1935,29,29,0,100.0,0.0,Female
MANUELLA,1935,3,3,0,100.0,0.0,Female
MERCEDES,1935,34,34,0,100.0,0.0,Female
ESTELLA,1935,5,5,0,100.0,0.0,Female
VALERIA,1935,6,6,0,100.0,0.0,Female
RUBENS,1935,3,0,3,0.0,100.0,Male
GUIDO,1935,25,0,25,0.0,100.0,Male
SAVINIEN,1935,3,0,3,0.0,100.0,Male
OLLIVIER,1935,4,0,4,0.0,100.0,Male
SOSTHENES,1935,6,0,6,0.0,100.0,Male
RÉMI,1935,90414,117,90297,0.1294047382042604,99.87059526179574,Male
JUSTE,1935,784,108,676,13.77551020408163,86.22448979591837,Male
ALDE,1935,3,0,3,0.0,100.0,Male
ADAM,1935,18,0,18,0.0,100.0,Male
PATRICE,1935,58,0,58,0.0,100.0,Male
VALMY,1935,3,0,3,0.0,100.0,Male
JOANNES,1935,81,0,81,0.0,100.0,Male
CYRILLE,1935,45,0,45,0.0,100.0,Male
JEAN-PAUL,1935,202,0,202,0.0,100.0,Male
REGIS,1935,301,0,301,0.0,100.0,Male
RINO,1935,22,0,22,0.0,100.0,Male
GATIEN,1935,10,0,10,0.0,100.0,Male
HELIER,1935,9,0,9,0.0,100.0,Male
SEVERIN,1935,23,0,23,0.0,100.0,Male
FRANZ,1935,3,0,3,0.0,100.0,Male
ABRAHAM,1935,8,0,8,0.0,100.0,Male
FULGENT,1935,3,0,3,0.0,100.0,Male
CHARLEY,1935,3,0,3,0.0,100.0,Male
OCULI,1935,11,0,11,0.0,100.0,Male
ALDO,1935,44,0,44,0.0,100.0,Male
EUSEBE,1935,1151,212,939,18.41876629018245,81.58123370981755,Unisex
GEORGE,1935,2417,650,1767,26.89284236657013,73.10715763342988,Unisex
EUSTACHE,1935,1376,277,1099,20.13081395348837,79.86918604651163,Unisex
GABY,1935,4741,2448,2293,51.63467622864375,48.36532377135626,Unisex
HONORAT,1935,652,270,382,41.41104294478527,58.58895705521472,Unisex
NICOMEDE,1935,430,193,237,44.88372093023256,55.11627906976744,Unisex
JANICK,1935,4109,2203,1906,53.61401800924799,46.38598199075201,Unisex
MEDARD,1935,1076,175,901,16.263940520446095,83.7360594795539,Unisex
CAMILLE,1935,287709,207732,79977,72.20212089298562,27.79787910701437,Unisex
ARCADE,1935,883,249,634,28.199320498301244,71.80067950169875,Unisex
SOSTHENE,1935,1059,185,874,17.469310670443818,82.53068932955618,Unisex
EULOGE,1935,621,198,423,31.88405797101449,68.11594202898551,Unisex
PULCHERIE,1935,738,579,159,78.45528455284553,21.54471544715448,Unisex
BONIFACE,1935,1187,217,970,18.28138163437237,81.71861836562763,Unisex
JANNY,1935,1044,617,427,59.099616858237546,40.90038314176245,Unisex
DANNY,1935,3396,610,2786,17.962308598351,82.037691401649,Unisex
JEANNY,1935,968,718,250,74.17355371900827,25.82644628099173,Unisex
HYACINTHE,1935,4679,1173,3506,25.069459286172258,74.93054071382774,Unisex
SERVAIS,1935,812,150,662,18.47290640394089,81.5270935960591,Unisex
TIMOLEON,1935,481,101,380,20.997920997921,79.002079002079,Unisex
CLAUDY,1935,2240,835,1405,37.27678571428572,62.72321428571429,Unisex
PHILOGONE,1935,396,183,213,46.21212121212121,53.78787878787878,Unisex
SAINTE,1935,1055,648,407,61.4218009478673,38.5781990521327,Unisex
LOETARE,1935,208,95,113,45.67307692307692,54.32692307692307,Unisex
EUTROPE,1935,194,70,124,36.08247422680412,63.91752577319587,Unisex
ARMIDA,1936,3,3,0,100.0,0.0,Female
MAXIMILIE,1936,3,3,0,100.0,0.0,Female
SYLVIE,1936,106,106,0,100.0,0.0,Female
RAPHAELLE,1936,17,17,0,100.0,0.0,Female
ZOFIE,1936,3,3,0,100.0,0.0,Female
ROSE,1936,111110,110808,302,99.72819728197284,0.2718027180271802,Female
VIRGINIA,1936,5,5,0,100.0,0.0,Female
MAUR,1936,3,3,0,100.0,0.0,Female
BATHILDE,1936,4,4,0,100.0,0.0,Female
HUBERTE,1936,26,26,0,100.0,0.0,Female
HILDA,1936,11,11,0,100.0,0.0,Female
YAMINA,1936,10,10,0,100.0,0.0,Female
LÉA,1936,199,199,0,100.0,0.0,Female
ELFRIEDE,1936,14,14,0,100.0,0.0,Female
MARIE-LUCE,1936,3,3,0,100.0,0.0,Female
OLIVA,1936,6,6,0,100.0,0.0,Female
JANNICK,1936,11,11,0,100.0,0.0,Female
HERVELINE,1936,12,12,0,100.0,0.0,Female
EVELINA,1936,3,3,0,100.0,0.0,Female
ESPERANCE,1936,10,10,0,100.0,0.0,Female
REINETTE,1936,6,6,0,100.0,0.0,Female
CLAIRE,1936,534,534,0,100.0,0.0,Female
CHARLETTE,1936,60,60,0,100.0,0.0,Female
REJINE,1936,6,6,0,100.0,0.0,Female
BLUETTE,1936,5,5,0,100.0,0.0,Female
GILES,1936,8,0,8,0.0,100.0,Male
GATIEN,1936,3295,40,3255,1.2139605462822458,98.78603945371776,Male
JEAN-MAX,1936,3,0,3,0.0,100.0,Male
ANASTASE,1936,11,0,11,0.0,100.0,Male
HORACE,1936,5,0,5,0.0,100.0,Male
OVIDE,1936,3,0,3,0.0,100.0,Male
ENRIQUE,1936,3,0,3,0.0,100.0,Male
BLAISE,1936,4675,403,4272,8.620320855614972,91.37967914438502,Male
ANGELO,1936,63,0,63,0.0,100.0,Male
LYONEL,1936,8,0,8,0.0,100.0,Male
HENRY,1936,131,0,131,0.0,100.0,Male
CYR,1936,7,0,7,0.0,100.0,Male
VALENTIN,1936,78,0,78,0.0,100.0,Male
BERTHY,1936,3,0,3,0.0,100.0,Male
AUGUSTE,1936,85334,199,85135,0.2332013031148194,99.7667986968852,Male
ROCH,1936,39,0,39,0.0,100.0,Male
DAVID,1936,68,0,68,0.0,100.0,Male
NATAN,1936,3,0,3,0.0,100.0,Male
ANICET,1936,36,0,36,0.0,100.0,Male
BLANCHARD,1936,6,0,6,0.0,100.0,Male
ALIN,1936,15,0,15,0.0,100.0,Male
REGIS,1936,290,0,290,0.0,100.0,Male
STÉPHANE,1936,309728,1221,308507,0.3942168612459965,99.605783138754,Male
THADDEE,1936,5,0,5,0.0,100.0,Male
HUBERT,1936,1151,0,1151,0.0,100.0,Male
SAINTE,1936,1055,648,407,61.4218009478673,38.5781990521327,Unisex
LEONIDE,1936,1588,1245,343,78.40050377833752,21.599496221662463,Unisex
JEANNICK,1936,2091,1305,786,62.4103299856528,37.589670014347206,Unisex
SOSTHENE,1936,1059,185,874,17.469310670443818,82.53068932955618,Unisex
NICAISE,1936,1786,1255,531,70.26875699888018,29.73124300111982,Unisex
SAINTE-CROIX,1936,486,103,383,21.193415637860085,78.80658436213992,Unisex
LIN,1936,701,177,524,25.24964336661912,74.75035663338089,Unisex
JANICK,1936,4109,2203,1906,53.61401800924799,46.38598199075201,Unisex
SCHOLASTIQUE,1936,1080,835,245,77.31481481481481,22.685185185185187,Unisex
FAUSTE,1936,179,86,93,48.04469273743017,51.95530726256983,Unisex
MAURILLE,1936,834,214,620,25.65947242206235,74.34052757793765,Unisex
LEONCE,1936,9290,2041,7249,21.96986006458557,78.03013993541443,Unisex
JANNY,1936,1044,617,427,59.099616858237546,40.90038314176245,Unisex
EUSEBE,1936,1151,212,939,18.41876629018245,81.58123370981755,Unisex
DANNY,1936,3396,610,2786,17.962308598351,82.037691401649,Unisex
MARY,1936,6861,5830,1031,84.97303600058301,15.026963999416996,Unisex
CRESCENT,1936,447,87,360,19.463087248322147,80.53691275167785,Unisex
HONORAT,1936,652,270,382,41.41104294478527,58.58895705521472,Unisex
GABY,1936,4741,2448,2293,51.63467622864375,48.36532377135626,Unisex
PRIVAT,1936,514,87,427,16.926070038910506,83.0739299610895,Unisex
GEORGE,1936,2417,650,1767,26.89284236657013,73.10715763342988,Unisex
OCULI,1936,447,105,342,23.48993288590604,76.51006711409396,Unisex
SEPTIME,1936,394,119,275,30.20304568527919,69.79695431472082,Unisex
JEANNY,1936,968,718,250,74.17355371900827,25.82644628099173,Unisex
HYACINTHE,1936,4679,1173,3506,25.069459286172258,74.93054071382774,Unisex
BRUNE,1937,4,4,0,100.0,0.0,Female
OLYMPE,1937,6418,6104,314,95.10751012776566,4.892489872234341,Female
DÉSIRÉE,1937,3,3,0,100.0,0.0,Female
REINE,1937,489,489,0,100.0,0.0,Female
REYMONDE,1937,7,7,0,100.0,0.0,Female
LAURETTE,1937,80,80,0,100.0,0.0,Female
SYLVAINE,1937,38,38,0,100.0,0.0,Female
LEONNE,1937,23,23,0,100.0,0.0,Female
ANIC,1937,4,4,0,100.0,0.0,Female
SHIRLEY,1937,5,5,0,100.0,0.0,Female
ALBERTINE,1937,200,200,0,100.0,0.0,Female
CHRYSTIANE,1937,6,6,0,100.0,0.0,Female
JINETTE,1937,3,3,0,100.0,0.0,Female
SERGINE,1937,19,19,0,100.0,0.0,Female
JOSELYNE,1937,30,30,0,100.0,0.0,Female
YOLENE,1937,4,4,0,100.0,0.0,Female
MARIE-DENISE,1937,3,3,0,100.0,0.0,Female
DORA,1937,13,13,0,100.0,0.0,Female
ARIANE,1937,25,25,0,100.0,0.0,Female
MURIELLE,1937,4,4,0,100.0,0.0,Female
LYSE,1937,7,7,0,100.0,0.0,Female
HELYETT,1937,5,5,0,100.0,0.0,Female
JOANNA,1937,5,5,0,100.0,0.0,Female
CATERINA,1937,4,4,0,100.0,0.0,Female
ODILLE,1937,47,47,0,100.0,0.0,Female
ARNOLD,1937,13,0,13,0.0,100.0,Male
MEDERIC,1937,10,0,10,0.0,100.0,Male
ROGER,1937,423803,202,423601,0.0476636550472743,99.95233634495273,Male
GONZAGUE,1937,9,0,9,0.0,100.0,Male
SAUL,1937,3,0,3,0.0,100.0,Male
AMAR,1937,6,0,6,0.0,100.0,Male
DONATIEN,1937,26,0,26,0.0,100.0,Male
LUIGI,1937,12,0,12,0.0,100.0,Male
XAVIER,1937,216,0,216,0.0,100.0,Male
BAPTISTE,1937,41,0,41,0.0,100.0,Male
AVIT,1937,6,0,6,0.0,100.0,Male
SÉBASTIEN,1937,304173,122,304051,0.0401087538999187,99.95989124610009,Male
CLOVIS,1937,61,0,61,0.0,100.0,Male
FLEURY,1937,23,0,23,0.0,100.0,Male
CRISTIAN,1937,8,0,8,0.0,100.0,Male
CASIMIR,1937,84,0,84,0.0,100.0,Male
RENAULT,1937,3,0,3,0.0,100.0,Male
IBRAHIM,1937,3,0,3,0.0,100.0,Male
CARLO,1937,14,0,14,0.0,100.0,Male
ODE,1937,3,0,3,0.0,100.0,Male
ALEXIN,1937,4,0,4,0.0,100.0,Male
JOSUE,1937,3,0,3,0.0,100.0,Male
JÉRÔME,1937,3,0,3,0.0,100.0,Male
FABIEN,1937,20,0,20,0.0,100.0,Male
RICHARD,1937,84161,182,83979,0.2162521833153123,99.78374781668468,Male
SAINTE-CROIX,1937,486,103,383,21.193415637860085,78.80658436213992,Unisex
ANNONCIAT,1937,89,67,22,75.28089887640449,24.719101123595504,Unisex
CLAUDY,1937,2240,835,1405,37.27678571428572,62.72321428571429,Unisex
CANDIDE,1937,1019,686,333,67.32090284592738,32.67909715407262,Unisex
GEORGE,1937,2417,650,1767,26.89284236657013,73.10715763342988,Unisex
DANNY,1937,3396,610,2786,17.962308598351,82.037691401649,Unisex
_PRENOMS_RARES,1937,1760252,908578,851674,51.616359475802334,48.38364052419767,Unisex
JANNICK,1937,2792,1545,1247,55.336676217765046,44.66332378223496,Unisex
GUALBERT,1937,497,85,412,17.102615694164992,82.897384305835,Unisex
PHILOGONE,1937,396,183,213,46.21212121212121,53.78787878787878,Unisex
MEDARD,1937,1076,175,901,16.263940520446095,83.7360594795539,Unisex
SABAS,1937,607,220,387,36.24382207578254,63.75617792421746,Unisex
DANY,1937,26027,7836,18191,30.10719637299728,69.89280362700273,Unisex
DOMINIQUE,1937,409989,168027,241962,40.98329467375954,59.01670532624046,Unisex
JOSY,1937,1021,840,181,82.27228207639568,17.72771792360431,Unisex
MARY,1937,6861,5830,1031,84.97303600058301,15.026963999416996,Unisex
TIBURCE,1937,1019,212,807,20.80471050049068,79.19528949950933,Unisex
GABY,1937,4741,2448,2293,51.63467622864375,48.36532377135626,Unisex
YANICK,1937,3028,482,2546,15.918097754293262,84.08190224570674,Unisex
ALIX,1937,37305,28371,8934,76.05146763168477,23.94853236831524,Unisex
ATTALE,1937,80,27,53,33.75,66.25,Unisex
CAMILLE,1937,287709,207732,79977,72.20212089298562,27.79787910701437,Unisex
NICAISE,1937,1786,1255,531,70.26875699888018,29.73124300111982,Unisex
HONORAT,1937,652,270,382,41.41104294478527,58.58895705521472,Unisex
SAINTE,1937,1055,648,407,61.4218009478673,38.5781990521327,Unisex
VINCENTE,1938,14,14,0,100.0,0.0,Female
GHYSLAINE,1938,14,14,0,100.0,0.0,Female
HERMINIE,1938,6,6,0,100.0,0.0,Female
ROLANDE,1938,824,824,0,100.0,0.0,Female
THOMASSINE,1938,10,10,0,100.0,0.0,Female
ALMA,1938,6,6,0,100.0,0.0,Female
DANIELLE,1938,2735,2735,0,100.0,0.0,Female
MARIE-GENEVIÈVE,1938,4,4,0,100.0,0.0,Female
BENITA,1938,3,3,0,100.0,0.0,Female
FLEURETTE,1938,7,7,0,100.0,0.0,Female
BRIGITTE,1938,202746,202582,164,99.91911061130676,0.0808893886932417,Female
LUCIE,1938,617,617,0,100.0,0.0,Female
VIRGINIE,1938,52,52,0,100.0,0.0,Female
BALBINA,1938,3,3,0,100.0,0.0,Female
STANISE,1938,4,4,0,100.0,0.0,Female
TATIANA,1938,6,6,0,100.0,0.0,Female
YOLANDE,1938,1043,1043,0,100.0,0.0,Female
RAYMONDE,1938,2455,2455,0,100.0,0.0,Female
JANNIE,1938,9,9,0,100.0,0.0,Female
ANNY,1938,235,235,0,100.0,0.0,Female
ETIENNISE,1938,4,4,0,100.0,0.0,Female
ENGRACE,1938,3,3,0,100.0,0.0,Female
ALEXANDRA,1938,12,12,0,100.0,0.0,Female
GHISLENE,1938,4,4,0,100.0,0.0,Female
CLODETTE,1938,6,6,0,100.0,0.0,Female
GERMAIN,1938,350,0,350,0.0,100.0,Male
RÉMY,1938,506,0,506,0.0,100.0,Male
PARFAIT,1938,3,0,3,0.0,100.0,Male
LEGER,1938,3,0,3,0.0,100.0,Male
DIMITRI,1938,12,0,12,0.0,100.0,Male
RUFIN,1938,12,0,12,0.0,100.0,Male
FAUST,1938,4,0,4,0.0,100.0,Male
FRANZ,1938,6,0,6,0.0,100.0,Male
BERARD,1938,3,0,3,0.0,100.0,Male
RINO,1938,12,0,12,0.0,100.0,Male
YANN,1938,12,0,12,0.0,100.0,Male
CELESTIN,1938,60,0,60,0.0,100.0,Male
ERICH,1938,5,0,5,0.0,100.0,Male
VIVIEN,1938,7,0,7,0.0,100.0,Male
JOAQUIM,1938,3,0,3,0.0,100.0,Male
JEANOT,1938,5,0,5,0.0,100.0,Male
ARNAULD,1938,3,0,3,0.0,100.0,Male
LIONEL,1938,285,0,285,0.0,100.0,Male
ALPHONSE,1938,43587,109,43478,0.2500745635166448,99.74992543648337,Male
QUIRIN,1938,5,0,5,0.0,100.0,Male
DANTE,1938,10,0,10,0.0,100.0,Male
VICTORIN,1938,8,0,8,0.0,100.0,Male
HANS,1938,3,0,3,0.0,100.0,Male
CLAUDIUS,1938,56,0,56,0.0,100.0,Male
SILVIO,1938,12,0,12,0.0,100.0,Male
PRIVAT,1938,514,87,427,16.926070038910506,83.0739299610895,Unisex
EUSEBE,1938,1151,212,939,18.41876629018245,81.58123370981755,Unisex
IRENEE,1938,6155,1854,4301,30.121852152721363,69.87814784727864,Unisex
SOCRATE,1938,378,96,282,25.396825396825395,74.60317460317461,Unisex
TIMOLEON,1938,481,101,380,20.997920997921,79.002079002079,Unisex
LEONCE,1938,9290,2041,7249,21.96986006458557,78.03013993541443,Unisex
JANNY,1938,1044,617,427,59.099616858237546,40.90038314176245,Unisex
JANICK,1938,4109,2203,1906,53.61401800924799,46.38598199075201,Unisex
MARY,1938,6861,5830,1031,84.97303600058301,15.026963999416996,Unisex
FIDELE,1938,793,162,631,20.42875157629256,79.57124842370744,Unisex
CAMILLE,1938,287709,207732,79977,72.20212089298562,27.79787910701437,Unisex
MARIE-JOSEPH,1938,2275,1830,445,80.43956043956044,19.56043956043956,Unisex
TIBURCE,1938,1019,212,807,20.80471050049068,79.19528949950933,Unisex
HONORAT,1938,652,270,382,41.41104294478527,58.58895705521472,Unisex
DANNY,1938,3396,610,2786,17.962308598351,82.037691401649,Unisex
CLAUDY,1938,2240,835,1405,37.27678571428572,62.72321428571429,Unisex
YANNIC,1938,671,104,567,15.499254843517138,84.50074515648286,Unisex
LOETARE,1938,208,95,113,45.67307692307692,54.32692307692307,Unisex
EUSTACHE,1938,1376,277,1099,20.13081395348837,79.86918604651163,Unisex
CREPIN,1938,606,136,470,22.44224422442244,77.55775577557755,Unisex
GABY,1938,4741,2448,2293,51.63467622864375,48.36532377135626,Unisex
AGNAN,1938,455,124,331,27.25274725274725,72.74725274725274,Unisex
SOSTHENE,1938,1059,185,874,17.469310670443818,82.53068932955618,Unisex
PULCHERIE,1938,738,579,159,78.45528455284553,21.54471544715448,Unisex
MAURILLE,1938,834,214,620,25.65947242206235,74.34052757793765,Unisex
PAZ,1939,3,3,0,100.0,0.0,Female
CLAUDINE,1939,2614,2614,0,100.0,0.0,Female
IRÈNE,1939,83934,82102,1832,97.81733266614243,2.182667333857555,Female
ELINE,1939,6,6,0,100.0,0.0,Female
EDWIGE,1939,21241,20689,552,97.40125229508968,2.598747704910315,Female
MARIE-COLETTE,1939,3,3,0,100.0,0.0,Female
ANNE,1939,364561,364227,334,99.9083829592304,0.0916170407695831,Female
AIDA,1939,4,4,0,100.0,0.0,Female
IVETTE,1939,8,8,0,100.0,0.0,Female
ADOLPHINE,1939,20,20,0,100.0,0.0,Female
BLEUETTE,1939,11,11,0,100.0,0.0,Female
MARIE-MADELEINE,1939,167,167,0,100.0,0.0,Female
STEPHANIA,1939,7,7,0,100.0,0.0,Female
VANDA,1939,7,7,0,100.0,0.0,Female
FLORIDA,1939,4,4,0,100.0,0.0,Female
BERTHINA,1939,3,3,0,100.0,0.0,Female
VIRGINA,1939,4,4,0,100.0,0.0,Female
SATURNINE,1939,3,3,0,100.0,0.0,Female
MARIVONNE,1939,12,12,0,100.0,0.0,Female
JEROMINE,1939,12,12,0,100.0,0.0,Female
MARCELLE,1939,2510,2510,0,100.0,0.0,Female
LAURENCE,1939,124,124,0,100.0,0.0,Female
ZOUBEDA,1939,5,5,0,100.0,0.0,Female
BERNARDETTE,1939,7,7,0,100.0,0.0,Female
SIDONIE,1939,19,19,0,100.0,0.0,Female
ALIN,1939,20,0,20,0.0,100.0,Male
STANISLAW,1939,16,0,16,0.0,100.0,Male
ERNESTO,1939,3,0,3,0.0,100.0,Male
HILARION,1939,820,111,709,13.53658536585366,86.46341463414635,Male
ATHANASE,1939,1559,230,1329,14.753046824887749,85.24695317511225,Male
SIMON,1939,241,0,241,0.0,100.0,Male
REMOND,1939,3,0,3,0.0,100.0,Male
LADISLAS,1939,6,0,6,0.0,100.0,Male
GILBERT,1939,3677,0,3677,0.0,100.0,Male
JEAN-HENRI,1939,3,0,3,0.0,100.0,Male
GATIEN,1939,8,0,8,0.0,100.0,Male
YVAN,1939,211,0,211,0.0,100.0,Male
PEDRO,1939,19,0,19,0.0,100.0,Male
MOÏSE,1939,3,0,3,0.0,100.0,Male
BABYLAS,1939,5,0,5,0.0,100.0,Male
INNOCENT,1939,11,0,11,0.0,100.0,Male
ILDEBERT,1939,10,0,10,0.0,100.0,Male
MEDERIC,1939,11,0,11,0.0,100.0,Male
YVES-MARIE,1939,3,0,3,0.0,100.0,Male
OCTAVE,1939,37,0,37,0.0,100.0,Male
JACQUELIN,1939,4,0,4,0.0,100.0,Male
HENRYK,1939,13,0,13,0.0,100.0,Male
ALPHONSE,1939,315,0,315,0.0,100.0,Male
LUDWIK,1939,3,0,3,0.0,100.0,Male
JEANOT,1939,4,0,4,0.0,100.0,Male
JOSY,1939,1021,840,181,82.27228207639568,17.72771792360431,Unisex
DANY,1939,26027,7836,18191,30.10719637299728,69.89280362700273,Unisex
APPOLINAIRE,1939,632,126,506,19.93670886075949,80.0632911392405,Unisex
TIBURCE,1939,1019,212,807,20.80471050049068,79.19528949950933,Unisex
NICAISE,1939,1786,1255,531,70.26875699888018,29.73124300111982,Unisex
JANY,1939,3897,2256,1641,57.89068514241724,42.10931485758276,Unisex
EUSEBE,1939,1151,212,939,18.41876629018245,81.58123370981755,Unisex
YANICK,1939,3028,482,2546,15.918097754293262,84.08190224570674,Unisex
EUSTACHE,1939,1376,277,1099,20.13081395348837,79.86918604651163,Unisex
MARY,1939,6861,5830,1031,84.97303600058301,15.026963999416996,Unisex
DANNY,1939,3396,610,2786,17.962308598351,82.037691401649,Unisex
SCHOLASTIQUE,1939,1080,835,245,77.31481481481481,22.685185185185187,Unisex
MESMIN,1939,773,183,590,23.67399741267788,76.32600258732212,Unisex
AMOUR,1939,782,287,495,36.70076726342711,63.29923273657288,Unisex
JEANNY,1939,968,718,250,74.17355371900827,25.82644628099173,Unisex
LEONCE,1939,9290,2041,7249,21.96986006458557,78.03013993541443,Unisex
CLAUDY,1939,2240,835,1405,37.27678571428572,62.72321428571429,Unisex
TIMOLEON,1939,481,101,380,20.997920997921,79.002079002079,Unisex
SOCRATE,1939,378,96,282,25.396825396825395,74.60317460317461,Unisex
GABY,1939,4741,2448,2293,51.63467622864375,48.36532377135626,Unisex
ARCADE,1939,883,249,634,28.199320498301244,71.80067950169875,Unisex
JANICK,1939,4109,2203,1906,53.61401800924799,46.38598199075201,Unisex
SOSTHENE,1939,1059,185,874,17.469310670443818,82.53068932955618,Unisex
GODFROY,1939,277,69,208,24.90974729241877,75.09025270758123,Unisex
LEONIDE,1939,1588,1245,343,78.40050377833752,21.599496221662463,Unisex
ANASTASIE,1940,26,26,0,100.0,0.0,Female
MARIE-BERNADETTE,1940,16,16,0,100.0,0.0,Female
LINDA,1940,3,3,0,100.0,0.0,Female
LILIANA,1940,3,3,0,100.0,0.0,Female
MARYLISE,1940,8,8,0,100.0,0.0,Female
ANIC,1940,16,16,0,100.0,0.0,Female
RAOULE,1940,3,3,0,100.0,0.0,Female
ADOLPHINE,1940,6,6,0,100.0,0.0,Female
RENETTE,1940,6,6,0,100.0,0.0,Female
ELIANE,1940,2292,2292,0,100.0,0.0,Female
MARIE-ODILE,1940,33,33,0,100.0,0.0,Female
FRANCINETTE,1940,4,4,0,100.0,0.0,Female
MICHELLE,1940,3336,3336,0,100.0,0.0,Female
CAMILLA,1940,5,5,0,100.0,0.0,Female
JOSEPHINE,1940,385,385,0,100.0,0.0,Female
YOLAINE,1940,15,15,0,100.0,0.0,Female
ADELINE,1940,43,43,0,100.0,0.0,Female
GISHLAINE,1940,13,13,0,100.0,0.0,Female
DANNIE,1940,5,5,0,100.0,0.0,Female
LEOPOLDINE,1940,3,3,0,100.0,0.0,Female
MARCELLINE,1940,69,69,0,100.0,0.0,Female
ISABEL,1940,5,5,0,100.0,0.0,Female
ROSE,1940,753,753,0,100.0,0.0,Female
ANGÈLE,1940,71790,71550,240,99.66569160050146,0.3343083994985374,Female
CASIMIRA,1940,13,13,0,100.0,0.0,Female
HUGUES,1940,25826,189,25637,0.7318206458607605,99.26817935413924,Male
SAINT,1940,17,0,17,0.0,100.0,Male
VICENTE,1940,4,0,4,0.0,100.0,Male
CARLOS,1940,15,0,15,0.0,100.0,Male
JEAN-PAUL,1940,445,0,445,0.0,100.0,Male
APPOLINAIRE,1940,4,0,4,0.0,100.0,Male
JEAN-BAPTISTE,1940,115,0,115,0.0,100.0,Male
JAME,1940,3,0,3,0.0,100.0,Male
MATHURIN,1940,19,0,19,0.0,100.0,Male
LIONEL,1940,238,0,238,0.0,100.0,Male
ALBERIC,1940,6,0,6,0.0,100.0,Male
ABRAHAM,1940,3,0,3,0.0,100.0,Male
CORENTIN,1940,28,0,28,0.0,100.0,Male
ENIO,1940,3,0,3,0.0,100.0,Male
SERVAIS,1940,3,0,3,0.0,100.0,Male
WALTER,1940,35,0,35,0.0,100.0,Male
SALOMON,1940,4,0,4,0.0,100.0,Male
EXPEDIE,1940,9,0,9,0.0,100.0,Male
JOSEPH,1940,378694,477,378217,0.1259592177325228,99.87404078226749,Male
CELESTIN,1940,65,0,65,0.0,100.0,Male
ROSARIO,1940,3,0,3,0.0,100.0,Male
CHARLY,1940,10,0,10,0.0,100.0,Male
IVE,1940,3,0,3,0.0,100.0,Male
YVAN,1940,196,0,196,0.0,100.0,Male
ANTONIO,1940,46,0,46,0.0,100.0,Male
DOMINIQUE,1940,409989,168027,241962,40.98329467375954,59.01670532624046,Unisex
JANY,1940,3897,2256,1641,57.89068514241724,42.10931485758276,Unisex
GABY,1940,4741,2448,2293,51.63467622864375,48.36532377135626,Unisex
YANNIC,1940,671,104,567,15.499254843517138,84.50074515648286,Unisex
ANDOCHE,1940,390,140,250,35.8974358974359,64.1025641025641,Unisex
JANICK,1940,4109,2203,1906,53.61401800924799,46.38598199075201,Unisex
WENCESLAS,1940,877,175,702,19.95438996579248,80.04561003420753,Unisex
CLOUD,1940,101,34,67,33.663366336633665,66.33663366336634,Unisex
FIACRE,1940,253,59,194,23.3201581027668,76.6798418972332,Unisex
HONORAT,1940,652,270,382,41.41104294478527,58.58895705521472,Unisex
DANY,1940,26027,7836,18191,30.10719637299728,69.89280362700273,Unisex
ARCADE,1940,883,249,634,28.199320498301244,71.80067950169875,Unisex
BABYLAS,1940,330,98,232,29.6969696969697,70.3030303030303,Unisex
NICOMEDE,1940,430,193,237,44.88372093023256,55.11627906976744,Unisex
EUSTACHE,1940,1376,277,1099,20.13081395348837,79.86918604651163,Unisex
ALIX,1940,37305,28371,8934,76.05146763168477,23.94853236831524,Unisex
MESMIN,1940,773,183,590,23.67399741267788,76.32600258732212,Unisex
TIMOLEON,1940,481,101,380,20.997920997921,79.002079002079,Unisex
LIN,1940,701,177,524,25.24964336661912,74.75035663338089,Unisex
TIBURCE,1940,1019,212,807,20.80471050049068,79.19528949950933,Unisex
_PRENOMS_RARES,1940,1760252,908578,851674,51.616359475802334,48.38364052419767,Unisex
NICAISE,1940,1786,1255,531,70.26875699888018,29.73124300111982,Unisex
LEONCE,1940,9290,2041,7249,21.96986006458557,78.03013993541443,Unisex
LEONIDE,1940,1588,1245,343,78.40050377833752,21.599496221662463,Unisex
HYACINTHE,1940,4679,1173,3506,25.069459286172258,74.93054071382774,Unisex
CÉCILE,1941,177846,177666,180,99.89878883978274,0.1012111602172666,Female
PRISCA,1941,3,3,0,100.0,0.0,Female
JUANITA,1941,6,6,0,100.0,0.0,Female
ROSANE,1941,3,3,0,100.0,0.0,Female
CLOTILDE,1941,27434,27324,110,99.5990376904571,0.4009623095429029,Female
CASIMIRA,1941,14,14,0,100.0,0.0,Female
ILDA,1941,6,6,0,100.0,0.0,Female
JEANNE,1941,3105,3105,0,100.0,0.0,Female
FERDINANDE,1941,9,9,0,100.0,0.0,Female
URSULA,1941,6,6,0,100.0,0.0,Female
AIDA,1941,4,4,0,100.0,0.0,Female
RUFINE,1941,14,14,0,100.0,0.0,Female
GRACIANNE,1941,5,5,0,100.0,0.0,Female
FLORE,1941,12234,12171,63,99.48504168710151,0.5149583128984796,Female
JEANETTE,1941,5,5,0,100.0,0.0,Female
GERTRUDE,1941,123,123,0,100.0,0.0,Female
LILIA,1941,6,6,0,100.0,0.0,Female
DANIELLE,1941,4368,4368,0,100.0,0.0,Female
ALINE,1941,495,495,0,100.0,0.0,Female
EDDA,1941,14,14,0,100.0,0.0,Female
EMILIENNE,1941,272,272,0,100.0,0.0,Female
VERA,1941,13,13,0,100.0,0.0,Female
STELLA,1941,17,17,0,100.0,0.0,Female
MICHELINE,1941,2035,2035,0,100.0,0.0,Female
ELIA,1941,5,5,0,100.0,0.0,Female
ANTONIN,1941,53,0,53,0.0,100.0,Male
ARSENE,1941,15051,1013,14038,6.730449803999735,93.26955019600028,Male
JAKIE,1941,8,0,8,0.0,100.0,Male
BIENVENU,1941,3,0,3,0.0,100.0,Male
THOMAS,1941,281159,347,280812,0.1234177102635875,99.87658228973642,Male
FRANZ,1941,10,0,10,0.0,100.0,Male
VICTOR,1941,380,0,380,0.0,100.0,Male
PETER,1941,6,0,6,0.0,100.0,Male
LAMBERT,1941,11,0,11,0.0,100.0,Male
ANTON,1941,3,0,3,0.0,100.0,Male
THÉO,1941,16,0,16,0.0,100.0,Male
ANGE,1941,21831,2649,19182,12.134121203792771,87.86587879620723,Male
ROLLAND,1941,116,0,116,0.0,100.0,Male
FLORIS,1941,5,0,5,0.0,100.0,Male
AMAURY,1941,5,0,5,0.0,100.0,Male
HECTOR,1941,23,0,23,0.0,100.0,Male
MEDERIC,1941,10,0,10,0.0,100.0,Male
GIOVANNI,1941,5,0,5,0.0,100.0,Male
ERIK,1941,4,0,4,0.0,100.0,Male
LIONNEL,1941,12,0,12,0.0,100.0,Male
ARCHANGE,1941,4,0,4,0.0,100.0,Male
MARIN,1941,29,0,29,0.0,100.0,Male
SERVAIS,1941,7,0,7,0.0,100.0,Male
REYNALD,1941,3,0,3,0.0,100.0,Male
ODILON,1941,3,0,3,0.0,100.0,Male
MARIE-JOSEPH,1941,2275,1830,445,80.43956043956044,19.56043956043956,Unisex
TIBURCE,1941,1019,212,807,20.80471050049068,79.19528949950933,Unisex
YANNIC,1941,671,104,567,15.499254843517138,84.50074515648286,Unisex
SAINTE,1941,1055,648,407,61.4218009478673,38.5781990521327,Unisex
GUALBERT,1941,497,85,412,17.102615694164992,82.897384305835,Unisex
CALIXTE,1941,3347,540,2807,16.13385121003884,83.86614878996116,Unisex
PULCHERIE,1941,738,579,159,78.45528455284553,21.54471544715448,Unisex
HYACINTHE,1941,4679,1173,3506,25.069459286172258,74.93054071382774,Unisex
OCULI,1941,447,105,342,23.48993288590604,76.51006711409396,Unisex
DANY,1941,26027,7836,18191,30.10719637299728,69.89280362700273,Unisex
FIACRE,1941,253,59,194,23.3201581027668,76.6798418972332,Unisex
CLAUDY,1941,2240,835,1405,37.27678571428572,62.72321428571429,Unisex
JANY,1941,3897,2256,1641,57.89068514241724,42.10931485758276,Unisex
GEORGE,1941,2417,650,1767,26.89284236657013,73.10715763342988,Unisex
JEANNY,1941,968,718,250,74.17355371900827,25.82644628099173,Unisex
ANDOCHE,1941,390,140,250,35.8974358974359,64.1025641025641,Unisex
MERY,1941,515,409,106,79.41747572815534,20.58252427184466,Unisex
HONORAT,1941,652,270,382,41.41104294478527,58.58895705521472,Unisex
MAURILLE,1941,834,214,620,25.65947242206235,74.34052757793765,Unisex
IRENEE,1941,6155,1854,4301,30.121852152721363,69.87814784727864,Unisex
ALIX,1941,37305,28371,8934,76.05146763168477,23.94853236831524,Unisex
AGNAN,1941,455,124,331,27.25274725274725,72.74725274725274,Unisex
JANICK,1941,4109,2203,1906,53.61401800924799,46.38598199075201,Unisex
LEONCE,1941,9290,2041,7249,21.96986006458557,78.03013993541443,Unisex
SCHOLASTIQUE,1941,1080,835,245,77.31481481481481,22.685185185185187,Unisex
SATURNINE,1942,3,3,0,100.0,0.0,Female
MARIVONNE,1942,10,10,0,100.0,0.0,Female
ANITA,1942,222,222,0,100.0,0.0,Female
ISABELLE,1942,224,224,0,100.0,0.0,Female
EDWIGE,1942,21241,20689,552,97.40125229508968,2.598747704910315,Female
RENELISE,1942,9,9,0,100.0,0.0,Female
CESARINE,1942,10,10,0,100.0,0.0,Female
CLAUDIE,1942,24804,24545,259,98.95581357845508,1.044186421544912,Female
STELLA,1942,8,8,0,100.0,0.0,Female
AURORE,1942,17,17,0,100.0,0.0,Female
PULCHERIE,1942,6,6,0,100.0,0.0,Female
MARGUERITTE,1942,9,9,0,100.0,0.0,Female
FLORENTINE,1942,9,9,0,100.0,0.0,Female
NELLIE,1942,6,6,0,100.0,0.0,Female
LUCINE,1942,4,4,0,100.0,0.0,Female
MADELEINE,1942,2591,2591,0,100.0,0.0,Female
EPIPHANIE,1942,4,4,0,100.0,0.0,Female
ROSEMARY,1942,3,3,0,100.0,0.0,Female
LORETTE,1942,14,14,0,100.0,0.0,Female
AMÉLIE,1942,58,58,0,100.0,0.0,Female
ANGÉLIQUE,1942,3,3,0,100.0,0.0,Female
ELODIE,1942,4,4,0,100.0,0.0,Female
NOELLA,1942,67,67,0,100.0,0.0,Female
ROSARIO,1942,6,6,0,100.0,0.0,Female
OCULIE,1942,3,3,0,100.0,0.0,Female
LOICK,1942,3,0,3,0.0,100.0,Male
JEAN-GEORGES,1942,7,0,7,0.0,100.0,Male
CLOVIS,1942,36,0,36,0.0,100.0,Male
GERAUD,1942,7,0,7,0.0,100.0,Male
JUSTIN,1942,62,0,62,0.0,100.0,Male
JEAN-PHILIPPE,1942,57,0,57,0.0,100.0,Male
JEAN-GABRIEL,1942,4,0,4,0.0,100.0,Male
RENÉ,1942,516630,397,516233,0.0768441631341579,99.92315583686585,Male
ABRAHAM,1942,4,0,4,0.0,100.0,Male
JASMIN,1942,3,0,3,0.0,100.0,Male
ANNET,1942,3,0,3,0.0,100.0,Male
AMED,1942,3,0,3,0.0,100.0,Male
CHARLEY,1942,5,0,5,0.0,100.0,Male
ALBAN,1942,35,0,35,0.0,100.0,Male
CHARLY,1942,18,0,18,0.0,100.0,Male
ARISTIDE,1942,28,0,28,0.0,100.0,Male
MARIO,1942,69,0,69,0.0,100.0,Male
DIETER,1942,37,0,37,0.0,100.0,Male
EXPEDIT,1942,14,0,14,0.0,100.0,Male
RÉGIS,1942,11,0,11,0.0,100.0,Male
WERNER,1942,56,0,56,0.0,100.0,Male
DARIO,1942,3,0,3,0.0,100.0,Male
WILLIAMS,1942,10,0,10,0.0,100.0,Male
THEOBALD,1942,6,0,6,0.0,100.0,Male
JEAN-PAUL,1942,835,0,835,0.0,100.0,Male
DANY,1942,26027,7836,18191,30.10719637299728,69.89280362700273,Unisex
JANICK,1942,4109,2203,1906,53.61401800924799,46.38598199075201,Unisex
ALIX,1942,37305,28371,8934,76.05146763168477,23.94853236831524,Unisex
ANGE-MARIE,1942,650,290,360,44.61538461538462,55.38461538461539,Unisex
MARIE-JOSEPH,1942,2275,1830,445,80.43956043956044,19.56043956043956,Unisex
MACAIRE,1942,240,57,183,23.75,76.25,Unisex
HYACINTHE,1942,4679,1173,3506,25.069459286172258,74.93054071382774,Unisex
ARCADE,1942,883,249,634,28.199320498301244,71.80067950169875,Unisex
EULOGE,1942,621,198,423,31.88405797101449,68.11594202898551,Unisex
EUSEBE,1942,1151,212,939,18.41876629018245,81.58123370981755,Unisex
YANICK,1942,3028,482,2546,15.918097754293262,84.08190224570674,Unisex
SCHOLASTIQUE,1942,1080,835,245,77.31481481481481,22.685185185185187,Unisex
SABAS,1942,607,220,387,36.24382207578254,63.75617792421746,Unisex
IRENEE,1942,6155,1854,4301,30.121852152721363,69.87814784727864,Unisex
CAMILLE,1942,287709,207732,79977,72.20212089298562,27.79787910701437,Unisex
DOMINIQUE,1942,409989,168027,241962,40.98329467375954,59.01670532624046,Unisex
NICAISE,1942,1786,1255,531,70.26875699888018,29.73124300111982,Unisex
_PRENOMS_RARES,1942,1760252,908578,851674,51.616359475802334,48.38364052419767,Unisex
AGNAN,1942,455,124,331,27.25274725274725,72.74725274725274,Unisex
MAURILLE,1942,834,214,620,25.65947242206235,74.34052757793765,Unisex
CREPIN,1942,606,136,470,22.44224422442244,77.55775577557755,Unisex
SERVAIS,1942,812,150,662,18.47290640394089,81.5270935960591,Unisex
MODESTE,1942,1853,656,1197,35.4020507285483,64.59794927145171,Unisex
JANY,1942,3897,2256,1641,57.89068514241724,42.10931485758276,Unisex
GABY,1942,4741,2448,2293,51.63467622864375,48.36532377135626,Unisex
MAGDA,1943,3,3,0,100.0,0.0,Female
LOUISIANE,1943,6,6,0,100.0,0.0,Female
RAYMONDE,1943,1746,1746,0,100.0,0.0,Female
JOSSELINE,1943,147,147,0,100.0,0.0,Female
MARION,1943,8,8,0,100.0,0.0,Female
NICOLLE,1943,451,451,0,100.0,0.0,Female
BERTHE,1943,213,213,0,100.0,0.0,Female
CYRILLIA,1943,6,6,0,100.0,0.0,Female
IRENA,1943,7,7,0,100.0,0.0,Female
EDITHE,1943,21,21,0,100.0,0.0,Female
AMÉLIE,1943,52,52,0,100.0,0.0,Female
HANNA,1943,7,7,0,100.0,0.0,Female
MARIANNA,1943,5,5,0,100.0,0.0,Female
SYMPHORIENNE,1943,4,4,0,100.0,0.0,Female
MARTHE,1943,582,582,0,100.0,0.0,Female
JOSETTE,1943,4933,4933,0,100.0,0.0,Female
HENRIANE,1943,3,3,0,100.0,0.0,Female
TRINITE,1943,4,4,0,100.0,0.0,Female
MARIE-COLETTE,1943,3,3,0,100.0,0.0,Female
JUDITH,1943,11,11,0,100.0,0.0,Female
INGEBORG,1943,21,21,0,100.0,0.0,Female
DORIA,1943,3,3,0,100.0,0.0,Female
DANIELLE,1943,7653,7653,0,100.0,0.0,Female
ROSIANE,1943,4,4,0,100.0,0.0,Female
SIMONE,1943,3083,3083,0,100.0,0.0,Female
GONZAGUE,1943,6,0,6,0.0,100.0,Male
CHARLES,1943,243348,231,243117,0.0949257852951328,99.90507421470488,Male
ALBERTO,1943,6,0,6,0.0,100.0,Male
WILLIAMS,1943,12,0,12,0.0,100.0,Male
VIRGILE,1943,7,0,7,0.0,100.0,Male
JULO,1943,4,0,4,0.0,100.0,Male
ANTONI,1943,4,0,4,0.0,100.0,Male
CHARLIE,1943,13,0,13,0.0,100.0,Male
OCULI,1943,3,0,3,0.0,100.0,Male
JOSEPH,1943,3333,0,3333,0.0,100.0,Male
TANGUY,1943,7,0,7,0.0,100.0,Male
WOLFGANG,1943,36,0,36,0.0,100.0,Male
RICO,1943,4,0,4,0.0,100.0,Male
ELOI,1943,32,0,32,0.0,100.0,Male
MIGUEL,1943,14,0,14,0.0,100.0,Male
GERMINAL,1943,11,0,11,0.0,100.0,Male
ROBERT,1943,6447,0,6447,0.0,100.0,Male
HERBERT,1943,62,0,62,0.0,100.0,Male
JEAN-LUC,1943,153,0,153,0.0,100.0,Male
PEDRO,1943,10,0,10,0.0,100.0,Male
SYLVESTRE,1943,4075,197,3878,4.834355828220859,95.16564417177914,Male
MORAND,1943,5,0,5,0.0,100.0,Male
JEAN-LUCIEN,1943,4,0,4,0.0,100.0,Male
AURELE,1943,3,0,3,0.0,100.0,Male
AUREL,1943,3,0,3,0.0,100.0,Male
DOMINIQUE,1943,409989,168027,241962,40.98329467375954,59.01670532624046,Unisex
MESMIN,1943,773,183,590,23.67399741267788,76.32600258732212,Unisex
JEANNICK,1943,2091,1305,786,62.4103299856528,37.589670014347206,Unisex
IRENEE,1943,6155,1854,4301,30.121852152721363,69.87814784727864,Unisex
ARCADE,1943,883,249,634,28.199320498301244,71.80067950169875,Unisex
GEORGE,1943,2417,650,1767,26.89284236657013,73.10715763342988,Unisex
LEONCE,1943,9290,2041,7249,21.96986006458557,78.03013993541443,Unisex
NICAISE,1943,1786,1255,531,70.26875699888018,29.73124300111982,Unisex
GODFROY,1943,277,69,208,24.90974729241877,75.09025270758123,Unisex
SCHOLASTIQUE,1943,1080,835,245,77.31481481481481,22.685185185185187,Unisex
DANY,1943,26027,7836,18191,30.10719637299728,69.89280362700273,Unisex
SAINTE-CROIX,1943,486,103,383,21.193415637860085,78.80658436213992,Unisex
TIBURCE,1943,1019,212,807,20.80471050049068,79.19528949950933,Unisex
JANIK,1943,500,287,213,57.4,42.6,Unisex
DAMASE,1943,195,32,163,16.41025641025641,83.58974358974359,Unisex
YANICK,1943,3028,482,2546,15.918097754293262,84.08190224570674,Unisex
CLAUDY,1943,2240,835,1405,37.27678571428572,62.72321428571429,Unisex
JANY,1943,3897,2256,1641,57.89068514241724,42.10931485758276,Unisex
_PRENOMS_RARES,1943,1760252,908578,851674,51.616359475802334,48.38364052419767,Unisex
MODESTE,1943,1853,656,1197,35.4020507285483,64.59794927145171,Unisex
HYACINTHE,1943,4679,1173,3506,25.069459286172258,74.93054071382774,Unisex
CAMILLE,1943,287709,207732,79977,72.20212089298562,27.79787910701437,Unisex
JANNY,1943,1044,617,427,59.099616858237546,40.90038314176245,Unisex
ALIX,1943,37305,28371,8934,76.05146763168477,23.94853236831524,Unisex
JANNICK,1943,2792,1545,1247,55.336676217765046,44.66332378223496,Unisex
BRUNE,1944,4,4,0,100.0,0.0,Female
MATHURINE,1944,9,9,0,100.0,0.0,Female
THEREZE,1944,5,5,0,100.0,0.0,Female
MARIEL,1944,4,4,0,100.0,0.0,Female
YVONNA,1944,4,4,0,100.0,0.0,Female
JULIE,1944,70,70,0,100.0,0.0,Female
NOELE,1944,53,53,0,100.0,0.0,Female
AURELIA,1944,5,5,0,100.0,0.0,Female
MARGARITA,1944,5,5,0,100.0,0.0,Female
FLORIANNE,1944,4,4,0,100.0,0.0,Female
ELIANNE,1944,31,31,0,100.0,0.0,Female
ODETTE,1944,1479,1479,0,100.0,0.0,Female
AMY,1944,4,4,0,100.0,0.0,Female
NOELLA,1944,69,69,0,100.0,0.0,Female
MARIE-NICOLE,1944,3,3,0,100.0,0.0,Female
ETIENNISE,1944,6,6,0,100.0,0.0,Female
IMELDA,1944,5,5,0,100.0,0.0,Female
AGATHE,1944,26,26,0,100.0,0.0,Female
ALETH,1944,11,11,0,100.0,0.0,Female
CHRISTINE,1944,689,689,0,100.0,0.0,Female
MARIELLE,1944,32,32,0,100.0,0.0,Female
ELIZABETH,1944,9,9,0,100.0,0.0,Female
CARINE,1944,13,13,0,100.0,0.0,Female
GERLINDE,1944,13,13,0,100.0,0.0,Female
HILDEGARD,1944,7,7,0,100.0,0.0,Female
VIRGILE,1944,10,0,10,0.0,100.0,Male
IVAN,1944,37,0,37,0.0,100.0,Male
WILFRIED,1944,10,0,10,0.0,100.0,Male
WILLY,1944,101,0,101,0.0,100.0,Male
EPHREM,1944,3,0,3,0.0,100.0,Male
CORENTIN,1944,10,0,10,0.0,100.0,Male
ANGE,1944,21831,2649,19182,12.134121203792771,87.86587879620723,Male
WLADYSLAW,1944,14,0,14,0.0,100.0,Male
MAX,1944,600,0,600,0.0,100.0,Male
TRISTAN,1944,5,0,5,0.0,100.0,Male
JÉRÔME,1944,6,0,6,0.0,100.0,Male
MARCIEN,1944,4,0,4,0.0,100.0,Male
PATRIK,1944,8,0,8,0.0,100.0,Male
SERAPHIN,1944,7,0,7,0.0,100.0,Male
LOTHAR,1944,8,0,8,0.0,100.0,Male
THERESIEN,1944,3,0,3,0.0,100.0,Male
BOLESLAW,1944,8,0,8,0.0,100.0,Male
BAPTISTE,1944,26,0,26,0.0,100.0,Male
WALTER,1944,49,0,49,0.0,100.0,Male
LÉON,1944,128662,142,128520,0.1103666972377236,99.88963330276228,Male
FRITZ,1944,3,0,3,0.0,100.0,Male
RENAUD,1944,54,0,54,0.0,100.0,Male
PIERROT,1944,20,0,20,0.0,100.0,Male
MARYAN,1944,6,0,6,0.0,100.0,Male
ELIAN,1944,10,0,10,0.0,100.0,Male
DANY,1944,26027,7836,18191,30.10719637299728,69.89280362700273,Unisex
_PRENOMS_RARES,1944,1760252,908578,851674,51.616359475802334,48.38364052419767,Unisex
CLAUDY,1944,2240,835,1405,37.27678571428572,62.72321428571429,Unisex
JEANNICK,1944,2091,1305,786,62.4103299856528,37.589670014347206,Unisex
TIMOLEON,1944,481,101,380,20.997920997921,79.002079002079,Unisex
JEANNY,1944,968,718,250,74.17355371900827,25.82644628099173,Unisex
ALIX,1944,37305,28371,8934,76.05146763168477,23.94853236831524,Unisex
MAURILLE,1944,834,214,620,25.65947242206235,74.34052757793765,Unisex
MARIE-JOSEPH,1944,2275,1830,445,80.43956043956044,19.56043956043956,Unisex
GEORGE,1944,2417,650,1767,26.89284236657013,73.10715763342988,Unisex
SCHOLASTIQUE,1944,1080,835,245,77.31481481481481,22.685185185185187,Unisex
GABY,1944,4741,2448,2293,51.63467622864375,48.36532377135626,Unisex
SAINTE,1944,1055,648,407,61.4218009478673,38.5781990521327,Unisex
ARCADE,1944,883,249,634,28.199320498301244,71.80067950169875,Unisex
NAZAIRE,1944,628,97,531,15.445859872611464,84.55414012738854,Unisex
IRENEE,1944,6155,1854,4301,30.121852152721363,69.87814784727864,Unisex
JANICK,1944,4109,2203,1906,53.61401800924799,46.38598199075201,Unisex
LIN,1944,701,177,524,25.24964336661912,74.75035663338089,Unisex
DANNY,1944,3396,610,2786,17.962308598351,82.037691401649,Unisex
CALIXTE,1944,3347,540,2807,16.13385121003884,83.86614878996116,Unisex
DOMINIQUE,1944,409989,168027,241962,40.98329467375954,59.01670532624046,Unisex
PRIVAT,1944,514,87,427,16.926070038910506,83.0739299610895,Unisex
EUSEBE,1944,1151,212,939,18.41876629018245,81.58123370981755,Unisex
WENCESLAS,1944,877,175,702,19.95438996579248,80.04561003420753,Unisex
NICAISE,1944,1786,1255,531,70.26875699888018,29.73124300111982,Unisex
ANNE-FRANÇOISE,1945,6,6,0,100.0,0.0,Female
ANNIE,1945,6892,6892,0,100.0,0.0,Female
JOSIANE,1945,3589,3589,0,100.0,0.0,Female
BLONDINE,1945,6,6,0,100.0,0.0,Female
CARMEN,1945,301,301,0,100.0,0.0,Female
MARIE-THEREZE,1945,7,7,0,100.0,0.0,Female
MARIE-HÉLÈNE,1945,208,208,0,100.0,0.0,Female
ARIELLE,1945,11,11,0,100.0,0.0,Female
ARMELE,1945,8,8,0,100.0,0.0,Female
BATHILDE,1945,5,5,0,100.0,0.0,Female
ROSE-MARIE,1945,133,133,0,100.0,0.0,Female
REINE-MARIE,1945,11,11,0,100.0,0.0,Female
REJEANE,1945,6,6,0,100.0,0.0,Female
VIOLETTE,1945,212,212,0,100.0,0.0,Female
DALIA,1945,3,3,0,100.0,0.0,Female
DORIS,1945,38,38,0,100.0,0.0,Female
ELYANE,1945,49,49,0,100.0,0.0,Female
LORETTA,1945,3,3,0,100.0,0.0,Female
JANINE,1945,1753,1753,0,100.0,0.0,Female
ZINA,1945,6,6,0,100.0,0.0,Female
BRUNA,1945,8,8,0,100.0,0.0,Female
FLEURETTE,1945,4,4,0,100.0,0.0,Female
KRYSTYNA,1945,6,6,0,100.0,0.0,Female
ARLETTE,1945,2153,2153,0,100.0,0.0,Female
GISLHAINE,1945,22,22,0,100.0,0.0,Female
MERIADEC,1945,3,0,3,0.0,100.0,Male
JEAN-MARC,1945,258,0,258,0.0,100.0,Male
SAINT-OMER,1945,3,0,3,0.0,100.0,Male
MYRTIL,1945,4,0,4,0.0,100.0,Male
GUISLAIN,1945,10,0,10,0.0,100.0,Male
LUCAY,1945,9,0,9,0.0,100.0,Male
GABIN,1945,7,0,7,0.0,100.0,Male
MERRY,1945,4,0,4,0.0,100.0,Male
JUDES,1945,8,0,8,0.0,100.0,Male
ANASTASE,1945,3,0,3,0.0,100.0,Male
MARCELIN,1945,16,0,16,0.0,100.0,Male
FULBERT,1945,11,0,11,0.0,100.0,Male
YVAN,1945,272,0,272,0.0,100.0,Male
PIERRE-HENRI,1945,3,0,3,0.0,100.0,Male
LÉOPOLD,1945,3,0,3,0.0,100.0,Male
HANS,1945,11,0,11,0.0,100.0,Male
ROSAIRE,1945,29,0,29,0.0,100.0,Male
HILARION,1945,13,0,13,0.0,100.0,Male
EDOUARD,1945,79050,207,78843,0.2618595825426945,99.73814041745732,Male
ZEPHIRIN,1945,5,0,5,0.0,100.0,Male
VALERE,1945,3267,196,3071,5.9993878175696365,94.00061218243036,Male
STÉPHANE,1945,309728,1221,308507,0.3942168612459965,99.605783138754,Male
HERVÉ,1945,653,0,653,0.0,100.0,Male
HAROLD,1945,8,0,8,0.0,100.0,Male
FÉLIX,1945,50743,323,50420,0.6365410007291645,99.36345899927085,Male
CALIXTE,1945,3347,540,2807,16.13385121003884,83.86614878996116,Unisex
WENCESLAS,1945,877,175,702,19.95438996579248,80.04561003420753,Unisex
IRENEE,1945,6155,1854,4301,30.121852152721363,69.87814784727864,Unisex
DANNY,1945,3396,610,2786,17.962308598351,82.037691401649,Unisex
AVIT,1945,485,106,379,21.855670103092784,78.14432989690722,Unisex
MARY,1945,6861,5830,1031,84.97303600058301,15.026963999416996,Unisex
BABYLAS,1945,330,98,232,29.6969696969697,70.3030303030303,Unisex
MAURILLE,1945,834,214,620,25.65947242206235,74.34052757793765,Unisex
NAZAIRE,1945,628,97,531,15.445859872611464,84.55414012738854,Unisex
APPOLINAIRE,1945,632,126,506,19.93670886075949,80.0632911392405,Unisex
JEANNY,1945,968,718,250,74.17355371900827,25.82644628099173,Unisex
JEANNICK,1945,2091,1305,786,62.4103299856528,37.589670014347206,Unisex
EUSTACHE,1945,1376,277,1099,20.13081395348837,79.86918604651163,Unisex
HYACINTHE,1945,4679,1173,3506,25.069459286172258,74.93054071382774,Unisex
JANNY,1945,1044,617,427,59.099616858237546,40.90038314176245,Unisex
NICOMEDE,1945,430,193,237,44.88372093023256,55.11627906976744,Unisex
JANIK,1945,500,287,213,57.4,42.6,Unisex
SOSTHENE,1945,1059,185,874,17.469310670443818,82.53068932955618,Unisex
MODESTE,1945,1853,656,1197,35.4020507285483,64.59794927145171,Unisex
SCHOLASTIQUE,1945,1080,835,245,77.31481481481481,22.685185185185187,Unisex
MEDARD,1945,1076,175,901,16.263940520446095,83.7360594795539,Unisex
PEPIN,1945,533,126,407,23.63977485928705,76.36022514071294,Unisex
MARIE-JOSEPH,1945,2275,1830,445,80.43956043956044,19.56043956043956,Unisex
CLAUDY,1945,2240,835,1405,37.27678571428572,62.72321428571429,Unisex
SABAS,1945,607,220,387,36.24382207578254,63.75617792421746,Unisex
ROGERE,1946,4,4,0,100.0,0.0,Female
GISMONDE,1946,12,12,0,100.0,0.0,Female
GIOVANNA,1946,7,7,0,100.0,0.0,Female
LEONA,1946,5,5,0,100.0,0.0,Female
SOIZIC,1946,6,6,0,100.0,0.0,Female
CHANTAL,1946,232523,232189,334,99.85635829573847,0.1436417042615139,Female
DENYSE,1946,30,30,0,100.0,0.0,Female
MARIE-FRANÇOISE,1946,1007,1007,0,100.0,0.0,Female
MARIE-ANNICK,1946,184,184,0,100.0,0.0,Female
JEANNE-MARIE,1946,66,66,0,100.0,0.0,Female
ELIETTE,1946,202,202,0,100.0,0.0,Female
MAGDALENA,1946,3,3,0,100.0,0.0,Female
ROSEMARIE,1946,4,4,0,100.0,0.0,Female
GERALDE,1946,4,4,0,100.0,0.0,Female
VINCENTE,1946,13,13,0,100.0,0.0,Female
MARIVONNE,1946,11,11,0,100.0,0.0,Female
MAY,1946,6,6,0,100.0,0.0,Female
MARIE-NOELE,1946,22,22,0,100.0,0.0,Female
HORTENSE,1946,14197,14105,92,99.35197576952878,0.6480242304712263,Female
ANNECY,1946,3,3,0,100.0,0.0,Female
MARYVONNE,1946,2042,2042,0,100.0,0.0,Female
YVONNE,1946,1630,1630,0,100.0,0.0,Female
ELVIRE,1946,34,34,0,100.0,0.0,Female
GISELENE,1946,5,5,0,100.0,0.0,Female
ZENA,1946,4,4,0,100.0,0.0,Female
JEAN-POL,1946,41,0,41,0.0,100.0,Male
ANTOINE,1946,282413,349,282064,0.1235778806216427,99.87642211937836,Male
ALLAN,1946,3,0,3,0.0,100.0,Male
PIERRE-FRANÇOIS,1946,3,0,3,0.0,100.0,Male
GEOFFROY,1946,14,0,14,0.0,100.0,Male
AISSA,1946,3170,393,2777,12.397476340694007,87.602523659306,Male
SAMY,1946,3,0,3,0.0,100.0,Male
CASIMIR,1946,7241,279,6962,3.853058969755559,96.14694103024443,Male
MADANI,1946,5,0,5,0.0,100.0,Male
JEAN-VICTOR,1946,6,0,6,0.0,100.0,Male
GIMMY,1946,4,0,4,0.0,100.0,Male
HUGO,1946,4,0,4,0.0,100.0,Male
MARIN,1946,15,0,15,0.0,100.0,Male
HENRI-CLAUDE,1946,4,0,4,0.0,100.0,Male
HENRIO,1946,3,0,3,0.0,100.0,Male
YANNIK,1946,688,101,587,14.680232558139537,85.31976744186046,Male
ANGELY,1946,3,0,3,0.0,100.0,Male
FLOREAL,1946,33,0,33,0.0,100.0,Male
RENÉ-CLAUDE,1946,4,0,4,0.0,100.0,Male
FERNAND,1946,1064,0,1064,0.0,100.0,Male
JEAN-PIERRE,1946,9273,0,9273,0.0,100.0,Male
ADAM,1946,11,0,11,0.0,100.0,Male
BRONISLAW,1946,11,0,11,0.0,100.0,Male
RODRIGUE,1946,3,0,3,0.0,100.0,Male
ANDRÉ,1946,712785,625,712160,0.0876842245557917,99.9123157754442,Male
DANNY,1946,3396,610,2786,17.962308598351,82.037691401649,Unisex
GEORGE,1946,2417,650,1767,26.89284236657013,73.10715763342988,Unisex
JANY,1946,3897,2256,1641,57.89068514241724,42.10931485758276,Unisex
ALIX,1946,37305,28371,8934,76.05146763168477,23.94853236831524,Unisex
CALIXTE,1946,3347,540,2807,16.13385121003884,83.86614878996116,Unisex
YANICK,1946,3028,482,2546,15.918097754293262,84.08190224570674,Unisex
JEANNY,1946,968,718,250,74.17355371900827,25.82644628099173,Unisex
CAMILLE,1946,287709,207732,79977,72.20212089298562,27.79787910701437,Unisex
CLAUDY,1946,2240,835,1405,37.27678571428572,62.72321428571429,Unisex
JANICK,1946,4109,2203,1906,53.61401800924799,46.38598199075201,Unisex
BONIFACE,1946,1187,217,970,18.28138163437237,81.71861836562763,Unisex
JANNY,1946,1044,617,427,59.099616858237546,40.90038314176245,Unisex
TIMOLEON,1946,481,101,380,20.997920997921,79.002079002079,Unisex
IRENEE,1946,6155,1854,4301,30.121852152721363,69.87814784727864,Unisex
ARCADE,1946,883,249,634,28.199320498301244,71.80067950169875,Unisex
MARIEL,1946,321,226,95,70.40498442367601,29.595015576323984,Unisex
GABY,1946,4741,2448,2293,51.63467622864375,48.36532377135626,Unisex
DOMINIQUE,1946,409989,168027,241962,40.98329467375954,59.01670532624046,Unisex
HYACINTHE,1946,4679,1173,3506,25.069459286172258,74.93054071382774,Unisex
EUSTACHE,1946,1376,277,1099,20.13081395348837,79.86918604651163,Unisex
WENCESLAS,1946,877,175,702,19.95438996579248,80.04561003420753,Unisex
EULOGE,1946,621,198,423,31.88405797101449,68.11594202898551,Unisex
SERVAIS,1946,812,150,662,18.47290640394089,81.5270935960591,Unisex
SCHOLASTIQUE,1946,1080,835,245,77.31481481481481,22.685185185185187,Unisex
EUSEBE,1946,1151,212,939,18.41876629018245,81.58123370981755,Unisex
MARIELE,1947,6,6,0,100.0,0.0,Female
VENANCE,1947,3,3,0,100.0,0.0,Female
ADA,1947,3,3,0,100.0,0.0,Female
MATHEA,1947,3,3,0,100.0,0.0,Female
MARIE-MARGUERITE,1947,6,6,0,100.0,0.0,Female
SIMONE,1947,2970,2970,0,100.0,0.0,Female
ANITE,1947,4,4,0,100.0,0.0,Female
SAIDA,1947,3,3,0,100.0,0.0,Female
LYSIANNE,1947,12,12,0,100.0,0.0,Female
MARIE-CLAUDINE,1947,13,13,0,100.0,0.0,Female
ODILIA,1947,3,3,0,100.0,0.0,Female
GUYLAINE,1947,31,31,0,100.0,0.0,Female
MARIE-PAULETTE,1947,5,5,0,100.0,0.0,Female
MARIE-DOMINIQUE,1947,79,79,0,100.0,0.0,Female
MARIE-HÉLÈNE,1947,637,637,0,100.0,0.0,Female
YAMINA,1947,71,71,0,100.0,0.0,Female
GEORGINA,1947,15,15,0,100.0,0.0,Female
ARMIDE,1947,4,4,0,100.0,0.0,Female
PASCALINE,1947,36,36,0,100.0,0.0,Female
MANOLITA,1947,8,8,0,100.0,0.0,Female
CHARLISE,1947,4,4,0,100.0,0.0,Female
MARIE-ROSE,1947,338,338,0,100.0,0.0,Female
MARIE-JACQUELINE,1947,10,10,0,100.0,0.0,Female
MARYLIS,1947,4,4,0,100.0,0.0,Female
ANTOINISE,1947,5,5,0,100.0,0.0,Female
THEOPHILE,1947,44,0,44,0.0,100.0,Male
ROBY,1947,4,0,4,0.0,100.0,Male
RÉMY,1947,74262,110,74152,0.1481242088820662,99.85187579111792,Male
JEAN-CHRISTIAN,1947,30,0,30,0.0,100.0,Male
TRISTAN,1947,11,0,11,0.0,100.0,Male
PIERRE-GILLES,1947,4,0,4,0.0,100.0,Male
ROLAND,1947,3726,0,3726,0.0,100.0,Male
EMERY,1947,3,0,3,0.0,100.0,Male
JEAN-PASCAL,1947,12,0,12,0.0,100.0,Male
ELOI,1947,44,0,44,0.0,100.0,Male
AMAND,1947,38,0,38,0.0,100.0,Male
JEAN-FRANCIS,1947,15,0,15,0.0,100.0,Male
DOCTROVE,1947,5,0,5,0.0,100.0,Male
LARBI,1947,4,0,4,0.0,100.0,Male
WILLIAM,1947,480,0,480,0.0,100.0,Male
AMEDEE,1947,20,0,20,0.0,100.0,Male
ANGELO,1947,26,0,26,0.0,100.0,Male
JEAN-PIERRE,1947,10539,0,10539,0.0,100.0,Male
JEHAN,1947,10,0,10,0.0,100.0,Male
CHARLOT,1947,5,0,5,0.0,100.0,Male
ABDOUL,1947,3,0,3,0.0,100.0,Male
MERRY,1947,3,0,3,0.0,100.0,Male
AMED,1947,7,0,7,0.0,100.0,Male
YOLAND,1947,15,0,15,0.0,100.0,Male
ROGATIEN,1947,3,0,3,0.0,100.0,Male
PULCHERIE,1947,738,579,159,78.45528455284553,21.54471544715448,Unisex
DOMINIQUE,1947,409989,168027,241962,40.98329467375954,59.01670532624046,Unisex
CAMILLE,1947,287709,207732,79977,72.20212089298562,27.79787910701437,Unisex
PLACIDE,1947,1098,214,884,19.489981785063755,80.51001821493625,Unisex
DANY,1947,26027,7836,18191,30.10719637299728,69.89280362700273,Unisex
MARIE-JOSEPH,1947,2275,1830,445,80.43956043956044,19.56043956043956,Unisex
NICAISE,1947,1786,1255,531,70.26875699888018,29.73124300111982,Unisex
ANONYME,1947,513,197,316,38.40155945419103,61.59844054580896,Unisex
JANY,1947,3897,2256,1641,57.89068514241724,42.10931485758276,Unisex
GABY,1947,4741,2448,2293,51.63467622864375,48.36532377135626,Unisex
TIBURCE,1947,1019,212,807,20.80471050049068,79.19528949950933,Unisex
NAZAIRE,1947,628,97,531,15.445859872611464,84.55414012738854,Unisex
SAINTE,1947,1055,648,407,61.4218009478673,38.5781990521327,Unisex
JEANNICK,1947,2091,1305,786,62.4103299856528,37.589670014347206,Unisex
MODESTE,1947,1853,656,1197,35.4020507285483,64.59794927145171,Unisex
LEONCE,1947,9290,2041,7249,21.96986006458557,78.03013993541443,Unisex
ARIEL,1947,2401,428,1973,17.8259058725531,82.17409412744689,Unisex
TIMOLEON,1947,481,101,380,20.997920997921,79.002079002079,Unisex
MAGLOIRE,1947,673,106,567,15.75037147102526,84.24962852897474,Unisex
LIN,1947,701,177,524,25.24964336661912,74.75035663338089,Unisex
SERVAIS,1947,812,150,662,18.47290640394089,81.5270935960591,Unisex
CLAUDY,1947,2240,835,1405,37.27678571428572,62.72321428571429,Unisex
SABAS,1947,607,220,387,36.24382207578254,63.75617792421746,Unisex
ANGE-MARIE,1947,650,290,360,44.61538461538462,55.38461538461539,Unisex
JEANICK,1947,322,126,196,39.130434782608695,60.86956521739131,Unisex
CHRISTA,1948,7,7,0,100.0,0.0,Female
MARIE-CÉLINE,1948,18,18,0,100.0,0.0,Female
MARIE-YOLANDE,1948,3,3,0,100.0,0.0,Female
SERVANE,1948,6,6,0,100.0,0.0,Female
ROLLANDE,1948,26,26,0,100.0,0.0,Female
MOISETTE,1948,25,25,0,100.0,0.0,Female
MARIE-GISÈLE,1948,4,4,0,100.0,0.0,Female
GHISLENE,1948,7,7,0,100.0,0.0,Female
ESTER,1948,4,4,0,100.0,0.0,Female
RIGOBERTE,1948,5,5,0,100.0,0.0,Female
MYRTILLE,1948,16,16,0,100.0,0.0,Female
FRANCIA,1948,12,12,0,100.0,0.0,Female
GISLAINE,1948,185,185,0,100.0,0.0,Female
ROXANE,1948,9,9,0,100.0,0.0,Female
DJAMILA,1948,5,5,0,100.0,0.0,Female
FLORIANE,1948,10,10,0,100.0,0.0,Female
MAGDALENA,1948,3,3,0,100.0,0.0,Female
MARIE-CHANTAL,1948,102,102,0,100.0,0.0,Female
FLAVIE,1948,7,7,0,100.0,0.0,Female
MARIE-REINE,1948,92,92,0,100.0,0.0,Female
ARIANE,1948,74,74,0,100.0,0.0,Female
BERNADINE,1948,14,14,0,100.0,0.0,Female
HEDWIGE,1948,18,18,0,100.0,0.0,Female
CELINA,1948,7,7,0,100.0,0.0,Female
ROMAINE,1948,22,22,0,100.0,0.0,Female
BRAHIM,1948,11,0,11,0.0,100.0,Male
ANASTASE,1948,7,0,7,0.0,100.0,Male
AMOR,1948,3,0,3,0.0,100.0,Male
IGNACE,1948,30,0,30,0.0,100.0,Male
SABIN,1948,3,0,3,0.0,100.0,Male
JOCELIN,1948,4,0,4,0.0,100.0,Male
GERHARD,1948,3,0,3,0.0,100.0,Male
MAXIME,1948,224277,1364,222913,0.6081764960294636,99.39182350397051,Male
HELMUT,1948,4,0,4,0.0,100.0,Male
ARISTE,1948,6,0,6,0.0,100.0,Male
JOAQUIN,1948,8,0,8,0.0,100.0,Male
JÉRÔME,1948,10,0,10,0.0,100.0,Male
PAOLO,1948,3,0,3,0.0,100.0,Male
PEPITO,1948,3,0,3,0.0,100.0,Male
ALAIN,1948,506999,34,506965,0.0067061276254982,99.9932938723745,Male
VALERE,1948,29,0,29,0.0,100.0,Male
JEAN-BERTRAND,1948,3,0,3,0.0,100.0,Male
JEAN-CHARLES,1948,180,0,180,0.0,100.0,Male
ALBERIC,1948,3,0,3,0.0,100.0,Male
JULIAN,1948,3,0,3,0.0,100.0,Male
ANTONIN,1948,48,0,48,0.0,100.0,Male
EDGARD,1948,64,0,64,0.0,100.0,Male
EMILIO,1948,5,0,5,0.0,100.0,Male
EXPEDIT,1948,17,0,17,0.0,100.0,Male
ELISEE,1948,3,0,3,0.0,100.0,Male
DANY,1948,26027,7836,18191,30.10719637299728,69.89280362700273,Unisex
AGNAN,1948,455,124,331,27.25274725274725,72.74725274725274,Unisex
MARIE-BERNARD,1948,410,337,73,82.1951219512195,17.804878048780488,Unisex
BENEDICT,1948,373,64,309,17.158176943699733,82.84182305630027,Unisex
ANGE-MARIE,1948,650,290,360,44.61538461538462,55.38461538461539,Unisex
JEANNICK,1948,2091,1305,786,62.4103299856528,37.589670014347206,Unisex
JEANICK,1948,322,126,196,39.130434782608695,60.86956521739131,Unisex
ARIEL,1948,2401,428,1973,17.8259058725531,82.17409412744689,Unisex
GERALDE,1948,212,151,61,71.22641509433963,28.77358490566038,Unisex
OCULI,1948,447,105,342,23.48993288590604,76.51006711409396,Unisex
ROSARIO,1948,1546,781,765,50.51746442432082,49.48253557567917,Unisex
IRENEE,1948,6155,1854,4301,30.121852152721363,69.87814784727864,Unisex
SAINTE,1948,1055,648,407,61.4218009478673,38.5781990521327,Unisex
ANONYME,1948,513,197,316,38.40155945419103,61.59844054580896,Unisex
JANIK,1948,500,287,213,57.4,42.6,Unisex
JANNICK,1948,2792,1545,1247,55.336676217765046,44.66332378223496,Unisex
MESMIN,1948,773,183,590,23.67399741267788,76.32600258732212,Unisex
CREPIN,1948,606,136,470,22.44224422442244,77.55775577557755,Unisex
EUSEBE,1948,1151,212,939,18.41876629018245,81.58123370981755,Unisex
PRIVAT,1948,514,87,427,16.926070038910506,83.0739299610895,Unisex
SIMPLICE,1948,329,106,223,32.21884498480243,67.78115501519757,Unisex
MERY,1948,515,409,106,79.41747572815534,20.58252427184466,Unisex
MAURILLE,1948,834,214,620,25.65947242206235,74.34052757793765,Unisex
JOSY,1948,1021,840,181,82.27228207639568,17.72771792360431,Unisex
PERPETUE,1948,201,134,67,66.66666666666666,33.33333333333333,Unisex
LISELOTTE,1949,5,5,0,100.0,0.0,Female
MARCIENNE,1949,9,9,0,100.0,0.0,Female
MIRYAM,1949,3,3,0,100.0,0.0,Female
OLYMPE,1949,6418,6104,314,95.10751012776566,4.892489872234341,Female
NOËLLA,1949,3,3,0,100.0,0.0,Female
NOELISE,1949,5,5,0,100.0,0.0,Female
JOSEE,1949,96,96,0,100.0,0.0,Female
NADYA,1949,5,5,0,100.0,0.0,Female
CLELIE,1949,3,3,0,100.0,0.0,Female
JOSIANE,1949,6567,6567,0,100.0,0.0,Female
VALENTINE,1949,42,42,0,100.0,0.0,Female
ANNA,1949,230,230,0,100.0,0.0,Female
MARIE-MARCELLE,1949,4,4,0,100.0,0.0,Female
MARIE-GERMAINE,1949,6,6,0,100.0,0.0,Female
JULIE,1949,54,54,0,100.0,0.0,Female
DELPHINE,1949,27,27,0,100.0,0.0,Female
SONYA,1949,5,5,0,100.0,0.0,Female
IRÈNE,1949,83934,82102,1832,97.81733266614243,2.182667333857555,Female
FELICIENNE,1949,20,20,0,100.0,0.0,Female
ROSALIA,1949,3,3,0,100.0,0.0,Female
BRUNE,1949,5,5,0,100.0,0.0,Female
JUANITA,1949,21,21,0,100.0,0.0,Female
AMÉLIE,1949,98201,98078,123,99.8747466930072,0.1252533069928005,Female
DELLY,1949,4,4,0,100.0,0.0,Female
MARIE-ELISABETH,1949,99,99,0,100.0,0.0,Female
ABDELKADER,1949,9,0,9,0.0,100.0,Male
ALI,1949,105,0,105,0.0,100.0,Male
JOHN,1949,35,0,35,0.0,100.0,Male
ULYSSE,1949,16,0,16,0.0,100.0,Male
ELIAS,1949,3,0,3,0.0,100.0,Male
JEAN-ROLAND,1949,5,0,5,0.0,100.0,Male
RAMON,1949,30,0,30,0.0,100.0,Male
MACAIRE,1949,3,0,3,0.0,100.0,Male
JACK,1949,425,0,425,0.0,100.0,Male
CLARENCE,1949,3,0,3,0.0,100.0,Male
JURGEN,1949,5,0,5,0.0,100.0,Male
LYSIAN,1949,3,0,3,0.0,100.0,Male
EVENOR,1949,5,0,5,0.0,100.0,Male
JEAN-FRÉDÉRIC,1949,3,0,3,0.0,100.0,Male
GUALBERT,1949,8,0,8,0.0,100.0,Male
ALFREDO,1949,8,0,8,0.0,100.0,Male
MATHURIN,1949,23,0,23,0.0,100.0,Male
FRANC,1949,15,0,15,0.0,100.0,Male
JEAN-YVES,1949,1113,0,1113,0.0,100.0,Male
HORST,1949,17,0,17,0.0,100.0,Male
ANTONY,1949,16,0,16,0.0,100.0,Male
PASQUIN,1949,3,0,3,0.0,100.0,Male
ARNAULT,1949,6,0,6,0.0,100.0,Male
JEAN-VICTOR,1949,6,0,6,0.0,100.0,Male
WOLFGANG,1949,25,0,25,0.0,100.0,Male
DANNY,1949,3396,610,2786,17.962308598351,82.037691401649,Unisex
IRENEE,1949,6155,1854,4301,30.121852152721363,69.87814784727864,Unisex
JEANNY,1949,968,718,250,74.17355371900827,25.82644628099173,Unisex
MAGLOIRE,1949,673,106,567,15.75037147102526,84.24962852897474,Unisex
JEANICK,1949,322,126,196,39.130434782608695,60.86956521739131,Unisex
CAMILLE,1949,287709,207732,79977,72.20212089298562,27.79787910701437,Unisex
JEANNICK,1949,2091,1305,786,62.4103299856528,37.589670014347206,Unisex
EUSTACHE,1949,1376,277,1099,20.13081395348837,79.86918604651163,Unisex
JANNY,1949,1044,617,427,59.099616858237546,40.90038314176245,Unisex
NAZAIRE,1949,628,97,531,15.445859872611464,84.55414012738854,Unisex
JANNICK,1949,2792,1545,1247,55.336676217765046,44.66332378223496,Unisex
CAROL,1949,3507,2953,554,84.20302252637582,15.79697747362418,Unisex
PLACIDE,1949,1098,214,884,19.489981785063755,80.51001821493625,Unisex
MARY,1949,6861,5830,1031,84.97303600058301,15.026963999416996,Unisex
ROSARIO,1949,1546,781,765,50.51746442432082,49.48253557567917,Unisex
MARIE-BERNARD,1949,410,337,73,82.1951219512195,17.804878048780488,Unisex
DANY,1949,26027,7836,18191,30.10719637299728,69.89280362700273,Unisex
YANNIC,1949,671,104,567,15.499254843517138,84.50074515648286,Unisex
JEANY,1949,175,128,47,73.14285714285714,26.857142857142858,Unisex
ANGE-MARIE,1949,650,290,360,44.61538461538462,55.38461538461539,Unisex
GEORGE,1949,2417,650,1767,26.89284236657013,73.10715763342988,Unisex
CALIXTE,1949,3347,540,2807,16.13385121003884,83.86614878996116,Unisex
MARIE-JOSEPH,1949,2275,1830,445,80.43956043956044,19.56043956043956,Unisex
JANICK,1949,4109,2203,1906,53.61401800924799,46.38598199075201,Unisex
NICAISE,1949,1786,1255,531,70.26875699888018,29.73124300111982,Unisex
ANIK,1950,14,14,0,100.0,0.0,Female
GILLIANE,1950,8,8,0,100.0,0.0,Female
MARIE-LOUISE,1950,603,603,0,100.0,0.0,Female
ARISTA,1950,4,4,0,100.0,0.0,Female
YASMINA,1950,29,29,0,100.0,0.0,Female
LAURIANNE,1950,5,5,0,100.0,0.0,Female
GRACIANE,1950,3,3,0,100.0,0.0,Female
CLARISSE,1950,51,51,0,100.0,0.0,Female
MARIETTA,1950,10,10,0,100.0,0.0,Female
BERTINE,1950,5,5,0,100.0,0.0,Female
HELEN,1950,3,3,0,100.0,0.0,Female
YVANE,1950,10,10,0,100.0,0.0,Female
VIVIANE,1950,2173,2173,0,100.0,0.0,Female
FRANCESCA,1950,10,10,0,100.0,0.0,Female
GINA,1950,26,26,0,100.0,0.0,Female
ODILE,1950,93538,93149,389,99.584126237465,0.4158737625350125,Female
ROSANNA,1950,5,5,0,100.0,0.0,Female
EMILIA,1950,23,23,0,100.0,0.0,Female
MARIE-JOSIANE,1950,13,13,0,100.0,0.0,Female
MARTHA,1950,12,12,0,100.0,0.0,Female
ANNY-CLAUDE,1950,6,6,0,100.0,0.0,Female
JULIANE,1950,20,20,0,100.0,0.0,Female
KATHERINE,1950,55,55,0,100.0,0.0,Female
CLAUDIE,1950,24804,24545,259,98.95581357845508,1.044186421544912,Female
GABRIELLE,1950,510,510,0,100.0,0.0,Female
JOHNNY,1950,30,0,30,0.0,100.0,Male
INNOCENT,1950,12,0,12,0.0,100.0,Male
ABDOUL,1950,5,0,5,0.0,100.0,Male
YVONNIC,1950,3,0,3,0.0,100.0,Male
FERIE,1950,4,0,4,0.0,100.0,Male
ELIAS,1950,3,0,3,0.0,100.0,Male
SYLVIO,1950,11,0,11,0.0,100.0,Male
RODOLPHE,1950,59,0,59,0.0,100.0,Male
ATTILA,1950,3,0,3,0.0,100.0,Male
GHYSLAIN,1950,6,0,6,0.0,100.0,Male
JEAN-LÉON,1950,7,0,7,0.0,100.0,Male
JULOT,1950,6,0,6,0.0,100.0,Male
VALENTIN,1950,56,0,56,0.0,100.0,Male
GYSLAIN,1950,4,0,4,0.0,100.0,Male
RENÉ-FRANÇOIS,1950,3,0,3,0.0,100.0,Male
LAMBERT,1950,2218,156,2062,7.033363390441839,92.96663660955817,Male
BONAVENTURE,1950,4,0,4,0.0,100.0,Male
BERND,1950,5,0,5,0.0,100.0,Male
EDY,1950,5,0,5,0.0,100.0,Male
OVIDE,1950,3,0,3,0.0,100.0,Male
GUSTAVE,1950,37156,171,36985,0.4602217676822047,99.5397782323178,Male
JEAN-ANTOINE,1950,10,0,10,0.0,100.0,Male
FARIDE,1950,3,0,3,0.0,100.0,Male
GONZAGUE,1950,10,0,10,0.0,100.0,Male
CLAUDE,1950,468398,56643,411755,12.09292097745934,87.90707902254066,Male
PRIVAT,1950,514,87,427,16.926070038910506,83.0739299610895,Unisex
CALIXTE,1950,3347,540,2807,16.13385121003884,83.86614878996116,Unisex
JEANNICK,1950,2091,1305,786,62.4103299856528,37.589670014347206,Unisex
JANNICK,1950,2792,1545,1247,55.336676217765046,44.66332378223496,Unisex
GERALDE,1950,212,151,61,71.22641509433963,28.77358490566038,Unisex
SCHOLASTIQUE,1950,1080,835,245,77.31481481481481,22.685185185185187,Unisex
YANIK,1950,330,50,280,15.151515151515152,84.84848484848484,Unisex
IRENEE,1950,6155,1854,4301,30.121852152721363,69.87814784727864,Unisex
ANONYME,1950,513,197,316,38.40155945419103,61.59844054580896,Unisex
DOMINIQUE,1950,409989,168027,241962,40.98329467375954,59.01670532624046,Unisex
EUSTACHE,1950,1376,277,1099,20.13081395348837,79.86918604651163,Unisex
JOSY,1950,1021,840,181,82.27228207639568,17.72771792360431,Unisex
JANICK,1950,4109,2203,1906,53.61401800924799,46.38598199075201,Unisex
LEONCE,1950,9290,2041,7249,21.96986006458557,78.03013993541443,Unisex
ALIX,1950,37305,28371,8934,76.05146763168477,23.94853236831524,Unisex
DANNY,1950,3396,610,2786,17.962308598351,82.037691401649,Unisex
ARIEL,1950,2401,428,1973,17.8259058725531,82.17409412744689,Unisex
JEANNY,1950,968,718,250,74.17355371900827,25.82644628099173,Unisex
GABY,1950,4741,2448,2293,51.63467622864375,48.36532377135626,Unisex
CAROL,1950,3507,2953,554,84.20302252637582,15.79697747362418,Unisex
JANNIK,1950,131,85,46,64.8854961832061,35.11450381679389,Unisex
CAMILLE,1950,287709,207732,79977,72.20212089298562,27.79787910701437,Unisex
HYACINTHE,1950,4679,1173,3506,25.069459286172258,74.93054071382774,Unisex
DANY,1950,26027,7836,18191,30.10719637299728,69.89280362700273,Unisex
WENCESLAS,1950,877,175,702,19.95438996579248,80.04561003420753,Unisex
MARTINE,1951,320273,320188,85,99.97346014181652,0.0265398581834872,Female
MARGARITA,1951,6,6,0,100.0,0.0,Female
CLARISSE,1951,60,60,0,100.0,0.0,Female
DARIA,1951,4,4,0,100.0,0.0,Female
YVANE,1951,10,10,0,100.0,0.0,Female
MARIE-MICHÈLE,1951,20,20,0,100.0,0.0,Female
SYLVA,1951,3,3,0,100.0,0.0,Female
ANNECY,1951,3,3,0,100.0,0.0,Female
JOSEPHINE,1951,199,199,0,100.0,0.0,Female
DENISE,1951,2742,2742,0,100.0,0.0,Female
GISELAINE,1951,12,12,0,100.0,0.0,Female
ANGELINE,1951,46,46,0,100.0,0.0,Female
MARYLÈNE,1951,32,32,0,100.0,0.0,Female
ELFRIEDE,1951,14,14,0,100.0,0.0,Female
EDDA,1951,4,4,0,100.0,0.0,Female
MARIE-CLAIRE,1951,1398,1398,0,100.0,0.0,Female
MARIE-LISE,1951,107,107,0,100.0,0.0,Female
MERYEM,1951,6,6,0,100.0,0.0,Female
RAPHAELA,1951,8,8,0,100.0,0.0,Female
GISMONDE,1951,8,8,0,100.0,0.0,Female
ALPHONSINE,1951,21,21,0,100.0,0.0,Female
MONIQUE,1951,400171,399730,441,99.88979711173474,0.1102028882652665,Female
ZAINA,1951,4,4,0,100.0,0.0,Female
PULCHERIE,1951,4,4,0,100.0,0.0,Female
MARIE-JOSÉ,1951,1690,1690,0,100.0,0.0,Female
JOACHIM,1951,14719,183,14536,1.2432909844418778,98.75670901555812,Male
CATALDO,1951,10,0,10,0.0,100.0,Male
ORY,1951,3,0,3,0.0,100.0,Male
THIERY,1951,18,0,18,0.0,100.0,Male
AMED,1951,5,0,5,0.0,100.0,Male
ALOYSE,1951,14,0,14,0.0,100.0,Male
EMILIEN,1951,51,0,51,0.0,100.0,Male
YANN,1951,117,0,117,0.0,100.0,Male
JOSELIN,1951,3,0,3,0.0,100.0,Male
WITOLD,1951,3,0,3,0.0,100.0,Male
ANDRÉ-PIERRE,1951,8,0,8,0.0,100.0,Male
BLAISE,1951,4675,403,4272,8.620320855614972,91.37967914438502,Male
MARIN,1951,19,0,19,0.0,100.0,Male
JEAN-FERNAND,1951,4,0,4,0.0,100.0,Male
BERTRAND,1951,712,0,712,0.0,100.0,Male
SAINT-ANGE,1951,8,0,8,0.0,100.0,Male
GAETANO,1951,9,0,9,0.0,100.0,Male
SÉBASTIEN,1951,304173,122,304051,0.0401087538999187,99.95989124610009,Male
CHRETIEN,1951,6,0,6,0.0,100.0,Male
LAHLOU,1951,3,0,3,0.0,100.0,Male
ARNAULT,1951,10,0,10,0.0,100.0,Male
ABD-EL,1951,12,0,12,0.0,100.0,Male
YVONNIC,1951,5,0,5,0.0,100.0,Male
PATRIK,1951,17,0,17,0.0,100.0,Male
GIREL,1951,3,0,3,0.0,100.0,Male
ROSARIO,1951,1546,781,765,50.51746442432082,49.48253557567917,Unisex
MODESTE,1951,1853,656,1197,35.4020507285483,64.59794927145171,Unisex
JANNY,1951,1044,617,427,59.099616858237546,40.90038314176245,Unisex
NAZAIRE,1951,628,97,531,15.445859872611464,84.55414012738854,Unisex
MARIE-JOSEPH,1951,2275,1830,445,80.43956043956044,19.56043956043956,Unisex
EUSTACHE,1951,1376,277,1099,20.13081395348837,79.86918604651163,Unisex
CLAUDY,1951,2240,835,1405,37.27678571428572,62.72321428571429,Unisex
ARIEL,1951,2401,428,1973,17.8259058725531,82.17409412744689,Unisex
ALIX,1951,37305,28371,8934,76.05146763168477,23.94853236831524,Unisex
_PRENOMS_RARES,1951,1760252,908578,851674,51.616359475802334,48.38364052419767,Unisex
JANIK,1951,500,287,213,57.4,42.6,Unisex
JANNICK,1951,2792,1545,1247,55.336676217765046,44.66332378223496,Unisex
OCULI,1951,447,105,342,23.48993288590604,76.51006711409396,Unisex
ANGE-MARIE,1951,650,290,360,44.61538461538462,55.38461538461539,Unisex
SULPICE,1951,508,182,326,35.826771653543304,64.1732283464567,Unisex
JEANICK,1951,322,126,196,39.130434782608695,60.86956521739131,Unisex
DANNY,1951,3396,610,2786,17.962308598351,82.037691401649,Unisex
JEANNY,1951,968,718,250,74.17355371900827,25.82644628099173,Unisex
WENCESLAS,1951,877,175,702,19.95438996579248,80.04561003420753,Unisex
PLACIDE,1951,1098,214,884,19.489981785063755,80.51001821493625,Unisex
JANICK,1951,4109,2203,1906,53.61401800924799,46.38598199075201,Unisex
JEANNICK,1951,2091,1305,786,62.4103299856528,37.589670014347206,Unisex
DANY,1951,26027,7836,18191,30.10719637299728,69.89280362700273,Unisex
MESMIN,1951,773,183,590,23.67399741267788,76.32600258732212,Unisex
YANICK,1951,3028,482,2546,15.918097754293262,84.08190224570674,Unisex
MARILY,1952,3,3,0,100.0,0.0,Female
FADELA,1952,4,4,0,100.0,0.0,Female
ANNA-MARIE,1952,7,7,0,100.0,0.0,Female
LUCIE,1952,257,257,0,100.0,0.0,Female
LEOCADIE,1952,2516,2346,170,93.24324324324324,6.756756756756757,Female
HILDA,1952,8,8,0,100.0,0.0,Female
JESSIE,1952,3,3,0,100.0,0.0,Female
GINETTE,1952,1692,1692,0,100.0,0.0,Female
XAVIERE,1952,6,6,0,100.0,0.0,Female
ELINA,1952,6,6,0,100.0,0.0,Female
KATIA,1952,73,73,0,100.0,0.0,Female
MARIE-PAULE,1952,691,691,0,100.0,0.0,Female
ASTRIDE,1952,95,95,0,100.0,0.0,Female
ANNE-THÉRÈSE,1952,4,4,0,100.0,0.0,Female
BENOITE,1952,12,12,0,100.0,0.0,Female
MAYA,1952,4,4,0,100.0,0.0,Female
KATERINE,1952,3,3,0,100.0,0.0,Female
MARIE-EDITH,1952,36,36,0,100.0,0.0,Female
MARIE-LAURE,1952,270,270,0,100.0,0.0,Female
ANNIE-FRANÇOISE,1952,4,4,0,100.0,0.0,Female
GISELLE,1952,47,47,0,100.0,0.0,Female
LINETTE,1952,18,18,0,100.0,0.0,Female
ANICETTE,1952,19,19,0,100.0,0.0,Female
JOSSELYNE,1952,117,117,0,100.0,0.0,Female
DAUPHINE,1952,3,3,0,100.0,0.0,Female
ABDELKADER,1952,14,0,14,0.0,100.0,Male
ANICET,1952,2447,192,2255,7.8463424601552925,92.15365753984472,Male
DAMIAN,1952,3,0,3,0.0,100.0,Male
GUILLAUME,1952,222938,145,222793,0.0650405045348931,99.93495949546512,Male
JORDI,1952,4,0,4,0.0,100.0,Male
IDRIS,1952,5,0,5,0.0,100.0,Male
MOURAD,1952,6,0,6,0.0,100.0,Male
YOUCEF,1952,5,0,5,0.0,100.0,Male
AMAURY,1952,5,0,5,0.0,100.0,Male
BRUNOT,1952,8,0,8,0.0,100.0,Male
TADEUSZ,1952,4,0,4,0.0,100.0,Male
ROBERT,1952,4974,0,4974,0.0,100.0,Male
VITO,1952,6,0,6,0.0,100.0,Male
JEAN-PASCAL,1952,42,0,42,0.0,100.0,Male
ABRAHAM,1952,7,0,7,0.0,100.0,Male
ISIDORE,1952,6462,161,6301,2.491488703187868,97.50851129681212,Male
BRAHIM,1952,22,0,22,0.0,100.0,Male
CLAUDI,1952,3,0,3,0.0,100.0,Male
JEAN-HERVÉ,1952,5,0,5,0.0,100.0,Male
SAINTE,1952,5,0,5,0.0,100.0,Male
MARINO,1952,9,0,9,0.0,100.0,Male
ROMAIN,1952,87,0,87,0.0,100.0,Male
JOANES,1952,4,0,4,0.0,100.0,Male
NICODEME,1952,3,0,3,0.0,100.0,Male
PROSPER,1952,24,0,24,0.0,100.0,Male
DANY,1952,26027,7836,18191,30.10719637299728,69.89280362700273,Unisex
ARIEL,1952,2401,428,1973,17.8259058725531,82.17409412744689,Unisex
YANIK,1952,330,50,280,15.151515151515152,84.84848484848484,Unisex
ANGE-MARIE,1952,650,290,360,44.61538461538462,55.38461538461539,Unisex
CLAUDY,1952,2240,835,1405,37.27678571428572,62.72321428571429,Unisex
BONIFACE,1952,1187,217,970,18.28138163437237,81.71861836562763,Unisex
JOSY,1952,1021,840,181,82.27228207639568,17.72771792360431,Unisex
PASQUALE,1952,585,144,441,24.615384615384617,75.38461538461539,Unisex
HYACINTHE,1952,4679,1173,3506,25.069459286172258,74.93054071382774,Unisex
JEANICK,1952,322,126,196,39.130434782608695,60.86956521739131,Unisex
JANIK,1952,500,287,213,57.4,42.6,Unisex
YANICK,1952,3028,482,2546,15.918097754293262,84.08190224570674,Unisex
PEPIN,1952,533,126,407,23.63977485928705,76.36022514071294,Unisex
MODESTE,1952,1853,656,1197,35.4020507285483,64.59794927145171,Unisex
ANONYME,1952,513,197,316,38.40155945419103,61.59844054580896,Unisex
JANY,1952,3897,2256,1641,57.89068514241724,42.10931485758276,Unisex
DANNY,1952,3396,610,2786,17.962308598351,82.037691401649,Unisex
JEANNICK,1952,2091,1305,786,62.4103299856528,37.589670014347206,Unisex
NICAISE,1952,1786,1255,531,70.26875699888018,29.73124300111982,Unisex
GABY,1952,4741,2448,2293,51.63467622864375,48.36532377135626,Unisex
DOMINIQUE,1952,409989,168027,241962,40.98329467375954,59.01670532624046,Unisex
IRENEE,1952,6155,1854,4301,30.121852152721363,69.87814784727864,Unisex
MARIE-JOSEPH,1952,2275,1830,445,80.43956043956044,19.56043956043956,Unisex
WENCESLAS,1952,877,175,702,19.95438996579248,80.04561003420753,Unisex
JANICK,1952,4109,2203,1906,53.61401800924799,46.38598199075201,Unisex
MARIE-PAULE,1953,822,822,0,100.0,0.0,Female
FLORIMONDE,1953,3,3,0,100.0,0.0,Female
LAURIANE,1953,14,14,0,100.0,0.0,Female
MARIE-ARMELLE,1953,7,7,0,100.0,0.0,Female
MARYLENE,1953,596,596,0,100.0,0.0,Female
MARYLISE,1953,103,103,0,100.0,0.0,Female
FATIRA,1953,3,3,0,100.0,0.0,Female
MARIE-BENEDICTE,1953,12,12,0,100.0,0.0,Female
MARIE-VÉRONIQUE,1953,16,16,0,100.0,0.0,Female
BERTRANDE,1953,4,4,0,100.0,0.0,Female
MARIA-CHRISTINA,1953,6,6,0,100.0,0.0,Female
ELIZABETH,1953,88,88,0,100.0,0.0,Female
ANNE-DOMINIQUE,1953,3,3,0,100.0,0.0,Female
MARIE-CLAIRE,1953,1384,1384,0,100.0,0.0,Female
PALMYRE,1953,7,7,0,100.0,0.0,Female
ANDRÉA,1953,52847,46098,6749,87.22917100308437,12.770828996915624,Female
CAROLLE,1953,11,11,0,100.0,0.0,Female
ANNE-YVONNE,1953,7,7,0,100.0,0.0,Female
MARIE-SYLVIE,1953,21,21,0,100.0,0.0,Female
MARIE-JOSEE,1953,326,326,0,100.0,0.0,Female
ZOÉ,1953,65289,64921,368,99.4363522185973,0.5636477814026865,Female
GYSLAINE,1953,23,23,0,100.0,0.0,Female
YAMENA,1953,3,3,0,100.0,0.0,Female
MAUDE,1953,5,5,0,100.0,0.0,Female
HALIMA,1953,14,14,0,100.0,0.0,Female
REMO,1953,4,0,4,0.0,100.0,Male
ALFRED,1953,267,0,267,0.0,100.0,Male
JOSUE,1953,3,0,3,0.0,100.0,Male
TURENNE,1953,3,0,3,0.0,100.0,Male
AIME,1953,198,0,198,0.0,100.0,Male
JEAN-DOMINIQUE,1953,38,0,38,0.0,100.0,Male
JEAN-ANTOINE,1953,9,0,9,0.0,100.0,Male
STANIS,1953,4,0,4,0.0,100.0,Male
SVEN,1953,4,0,4,0.0,100.0,Male
JEAN-ERIC,1953,15,0,15,0.0,100.0,Male
BERTHO,1953,3,0,3,0.0,100.0,Male
HUGUES,1953,411,0,411,0.0,100.0,Male
MEZIANE,1953,15,0,15,0.0,100.0,Male
FARID,1953,55,0,55,0.0,100.0,Male
MATERNE,1953,7,0,7,0.0,100.0,Male
TADEUSZ,1953,4,0,4,0.0,100.0,Male
JOSSELIN,1953,5,0,5,0.0,100.0,Male
ROLF,1953,6,0,6,0.0,100.0,Male
FERNAND,1953,509,0,509,0.0,100.0,Male
JANNIK,1953,4,0,4,0.0,100.0,Male
PIERRE-FRANÇOIS,1953,10,0,10,0.0,100.0,Male
GAVINO,1953,3,0,3,0.0,100.0,Male
JEAN-ROGER,1953,12,0,12,0.0,100.0,Male
FRITZ,1953,7,0,7,0.0,100.0,Male
GWENOLE,1953,3,0,3,0.0,100.0,Male
PLACIDE,1953,1098,214,884,19.489981785063755,80.51001821493625,Unisex
_PRENOMS_RARES,1953,1760252,908578,851674,51.616359475802334,48.38364052419767,Unisex
MODESTE,1953,1853,656,1197,35.4020507285483,64.59794927145171,Unisex
JANIK,1953,500,287,213,57.4,42.6,Unisex
SULPICE,1953,508,182,326,35.826771653543304,64.1732283464567,Unisex
SIMPLICE,1953,329,106,223,32.21884498480243,67.78115501519757,Unisex
YANIK,1953,330,50,280,15.151515151515152,84.84848484848484,Unisex
SERVAIS,1953,812,150,662,18.47290640394089,81.5270935960591,Unisex
PATERNE,1953,180,33,147,18.33333333333333,81.66666666666667,Unisex
AGNAN,1953,455,124,331,27.25274725274725,72.74725274725274,Unisex
SCHOLASTIQUE,1953,1080,835,245,77.31481481481481,22.685185185185187,Unisex
GABY,1953,4741,2448,2293,51.63467622864375,48.36532377135626,Unisex
CLAUDY,1953,2240,835,1405,37.27678571428572,62.72321428571429,Unisex
CAROL,1953,3507,2953,554,84.20302252637582,15.79697747362418,Unisex
WENCESLAS,1953,877,175,702,19.95438996579248,80.04561003420753,Unisex
JANNICK,1953,2792,1545,1247,55.336676217765046,44.66332378223496,Unisex
CAMILLE,1953,287709,207732,79977,72.20212089298562,27.79787910701437,Unisex
JANICK,1953,4109,2203,1906,53.61401800924799,46.38598199075201,Unisex
HYACINTHE,1953,4679,1173,3506,25.069459286172258,74.93054071382774,Unisex
DANNY,1953,3396,610,2786,17.962308598351,82.037691401649,Unisex
HONORAT,1953,652,270,382,41.41104294478527,58.58895705521472,Unisex
MARIE-JOSEPH,1953,2275,1830,445,80.43956043956044,19.56043956043956,Unisex
JEANNICK,1953,2091,1305,786,62.4103299856528,37.589670014347206,Unisex
MAGLOIRE,1953,673,106,567,15.75037147102526,84.24962852897474,Unisex
ARIEL,1953,2401,428,1973,17.8259058725531,82.17409412744689,Unisex
HOURIA,1954,13,13,0,100.0,0.0,Female
LIDIA,1954,12,12,0,100.0,0.0,Female
BETTIE,1954,4,4,0,100.0,0.0,Female
HÉLÈNE-MARIE,1954,4,4,0,100.0,0.0,Female
LOUISIANE,1954,11,11,0,100.0,0.0,Female
ELFRIEDE,1954,6,6,0,100.0,0.0,Female
FRANZETTE,1954,3,3,0,100.0,0.0,Female
CORRINE,1954,19,19,0,100.0,0.0,Female
LAURETTA,1954,3,3,0,100.0,0.0,Female
JO,1954,4,4,0,100.0,0.0,Female
MARIE-CARMEN,1954,7,7,0,100.0,0.0,Female
ZAHIA,1954,7,7,0,100.0,0.0,Female
AUDREY,1954,4,4,0,100.0,0.0,Female
ROBERTA,1954,6,6,0,100.0,0.0,Female
NORIA,1954,5,5,0,100.0,0.0,Female
CÉCILE,1954,177846,177666,180,99.89878883978274,0.1012111602172666,Female
CRISTINE,1954,5,5,0,100.0,0.0,Female
GERALDE,1954,5,5,0,100.0,0.0,Female
MARIE-YVONNE,1954,63,63,0,100.0,0.0,Female
BERENGERE,1954,19,19,0,100.0,0.0,Female
PALOMA,1954,7,7,0,100.0,0.0,Female
DAPHNÉ,1954,3,3,0,100.0,0.0,Female
CHRISLAINE,1954,5,5,0,100.0,0.0,Female
ARLETTE,1954,1489,1489,0,100.0,0.0,Female
MANOLA,1954,9,9,0,100.0,0.0,Female
MAGLOIRE,1954,4,0,4,0.0,100.0,Male
ZEPHIRIN,1954,5,0,5,0.0,100.0,Male
JEHAN,1954,10,0,10,0.0,100.0,Male
LAKHDAR,1954,5,0,5,0.0,100.0,Male
MARC-ANTOINE,1954,7,0,7,0.0,100.0,Male
HEROLD,1954,4,0,4,0.0,100.0,Male
FRANÇOIS-LOUIS,1954,3,0,3,0.0,100.0,Male
JOHNNIE,1954,4,0,4,0.0,100.0,Male
JOCELYN,1954,184,0,184,0.0,100.0,Male
SAM,1954,4,0,4,0.0,100.0,Male
JOACHIN,1954,3,0,3,0.0,100.0,Male
HARY,1954,4,0,4,0.0,100.0,Male
AMINE,1954,5,0,5,0.0,100.0,Male
FRANC,1954,10,0,10,0.0,100.0,Male
GARRY,1954,3,0,3,0.0,100.0,Male
GENE,1954,3,0,3,0.0,100.0,Male
AMBROISE,1954,8259,209,8050,2.530572708560358,97.46942729143964,Male
JEAN-PIERRE,1954,8289,0,8289,0.0,100.0,Male
FRANCESCO,1954,19,0,19,0.0,100.0,Male
CARMINE,1954,4,0,4,0.0,100.0,Male
IVANO,1954,5,0,5,0.0,100.0,Male
JOSÉ,1954,58950,1605,57345,2.72264631043257,97.27735368956742,Male
LEONUS,1954,6,0,6,0.0,100.0,Male
DANIEL,1954,12917,0,12917,0.0,100.0,Male
RENAUD,1954,99,0,99,0.0,100.0,Male
JANICK,1954,4109,2203,1906,53.61401800924799,46.38598199075201,Unisex
CREPIN,1954,606,136,470,22.44224422442244,77.55775577557755,Unisex
NAZAIRE,1954,628,97,531,15.445859872611464,84.55414012738854,Unisex
ROSARIO,1954,1546,781,765,50.51746442432082,49.48253557567917,Unisex
_PRENOMS_RARES,1954,1760252,908578,851674,51.616359475802334,48.38364052419767,Unisex
JEANICK,1954,322,126,196,39.130434782608695,60.86956521739131,Unisex
CHARLIE,1954,30211,15480,14731,51.23961470987389,48.76038529012611,Unisex
JANY,1954,3897,2256,1641,57.89068514241724,42.10931485758276,Unisex
JOSY,1954,1021,840,181,82.27228207639568,17.72771792360431,Unisex
ANONYME,1954,513,197,316,38.40155945419103,61.59844054580896,Unisex
YANICK,1954,3028,482,2546,15.918097754293262,84.08190224570674,Unisex
DANY,1954,26027,7836,18191,30.10719637299728,69.89280362700273,Unisex
GEORGE,1954,2417,650,1767,26.89284236657013,73.10715763342988,Unisex
JANIC,1954,115,56,59,48.69565217391305,51.30434782608696,Unisex
JEANNY,1954,968,718,250,74.17355371900827,25.82644628099173,Unisex
IRENEE,1954,6155,1854,4301,30.121852152721363,69.87814784727864,Unisex
CLAUDY,1954,2240,835,1405,37.27678571428572,62.72321428571429,Unisex
DOMINIQUE-MARIE,1954,67,46,21,68.65671641791045,31.343283582089555,Unisex
CALIXTE,1954,3347,540,2807,16.13385121003884,83.86614878996116,Unisex
ALIX,1954,37305,28371,8934,76.05146763168477,23.94853236831524,Unisex
SAINTE,1954,1055,648,407,61.4218009478673,38.5781990521327,Unisex
PATERNE,1954,180,33,147,18.33333333333333,81.66666666666667,Unisex
HYACINTHE,1954,4679,1173,3506,25.069459286172258,74.93054071382774,Unisex
JANNICK,1954,2792,1545,1247,55.336676217765046,44.66332378223496,Unisex
CAROL,1954,3507,2953,554,84.20302252637582,15.79697747362418,Unisex
MARIE-GEORGE,1955,5,5,0,100.0,0.0,Female
MIRTHA,1955,4,4,0,100.0,0.0,Female
SHANNON,1955,3,3,0,100.0,0.0,Female
LISA,1955,16,16,0,100.0,0.0,Female
VICTORIA,1955,33,33,0,100.0,0.0,Female
GASTONIA,1955,4,4,0,100.0,0.0,Female
HERVELINE,1955,5,5,0,100.0,0.0,Female
JOSÉPHINE,1955,6,6,0,100.0,0.0,Female
AÏCHA,1955,10,10,0,100.0,0.0,Female
ANITA,1955,800,800,0,100.0,0.0,Female
XAVIERE,1955,3,3,0,100.0,0.0,Female
COLETTE,1955,2630,2630,0,100.0,0.0,Female
ALEXANDRINE,1955,31,31,0,100.0,0.0,Female
THERESA,1955,19,19,0,100.0,0.0,Female
AIDA,1955,5,5,0,100.0,0.0,Female
MONISE,1955,3,3,0,100.0,0.0,Female
LAMBERTE,1955,3,3,0,100.0,0.0,Female
EDITHE,1955,6,6,0,100.0,0.0,Female
ERICA,1955,6,6,0,100.0,0.0,Female
NOËLLA,1955,9,9,0,100.0,0.0,Female
SOLANGE,1955,91031,90901,130,99.8571915061902,0.142808493809801,Female
MIRYAM,1955,9,9,0,100.0,0.0,Female
ALBERTE,1955,67,67,0,100.0,0.0,Female
MARLINE,1955,3,3,0,100.0,0.0,Female
MICHELINE,1955,1110,1110,0,100.0,0.0,Female
CLAUDIUS,1955,7,0,7,0.0,100.0,Male
YACOUB,1955,7,0,7,0.0,100.0,Male
GUILLAUME,1955,86,0,86,0.0,100.0,Male
EMILE,1955,360,0,360,0.0,100.0,Male
STEFANO,1955,6,0,6,0.0,100.0,Male
XAVIER,1955,869,0,869,0.0,100.0,Male
NACER,1955,7,0,7,0.0,100.0,Male
NOËL,1955,929,0,929,0.0,100.0,Male
AHMED,1955,102,0,102,0.0,100.0,Male
MAURO,1955,4,0,4,0.0,100.0,Male
JEAN-ALAIN,1955,17,0,17,0.0,100.0,Male
PIERRE-ANDRÉ,1955,11,0,11,0.0,100.0,Male
HASSEN,1955,9,0,9,0.0,100.0,Male
WOLFGANG,1955,6,0,6,0.0,100.0,Male
RENATO,1955,9,0,9,0.0,100.0,Male
DIMITRI,1955,6,0,6,0.0,100.0,Male
AYMERIC,1955,8,0,8,0.0,100.0,Male
BENOÎT,1955,125788,171,125617,0.1359430152319776,99.86405698476804,Male
FLORENT,1955,69781,29,69752,0.0415585904472564,99.95844140955276,Male
JOCELIN,1955,8,0,8,0.0,100.0,Male
EVENOR,1955,6,0,6,0.0,100.0,Male
KADOUR,1955,5,0,5,0.0,100.0,Male
HABIB,1955,8,0,8,0.0,100.0,Male
RENÉ,1955,3544,0,3544,0.0,100.0,Male
SALOMON,1955,4,0,4,0.0,100.0,Male
MEDARD,1955,1076,175,901,16.263940520446095,83.7360594795539,Unisex
JANIK,1955,500,287,213,57.4,42.6,Unisex
NICAISE,1955,1786,1255,531,70.26875699888018,29.73124300111982,Unisex
CAROL,1955,3507,2953,554,84.20302252637582,15.79697747362418,Unisex
HONORAT,1955,652,270,382,41.41104294478527,58.58895705521472,Unisex
MESMIN,1955,773,183,590,23.67399741267788,76.32600258732212,Unisex
JEANICK,1955,322,126,196,39.130434782608695,60.86956521739131,Unisex
CALIXTE,1955,3347,540,2807,16.13385121003884,83.86614878996116,Unisex
ARIEL,1955,2401,428,1973,17.8259058725531,82.17409412744689,Unisex
PRIVAT,1955,514,87,427,16.926070038910506,83.0739299610895,Unisex
GEORGE,1955,2417,650,1767,26.89284236657013,73.10715763342988,Unisex
PATERNE,1955,180,33,147,18.33333333333333,81.66666666666667,Unisex
DANNY,1955,3396,610,2786,17.962308598351,82.037691401649,Unisex
KIM,1955,6518,5270,1248,80.85302239950906,19.146977600490946,Unisex
SULPICE,1955,508,182,326,35.826771653543304,64.1732283464567,Unisex
JANNICK,1955,2792,1545,1247,55.336676217765046,44.66332378223496,Unisex
JEANNY,1955,968,718,250,74.17355371900827,25.82644628099173,Unisex
IRENEE,1955,6155,1854,4301,30.121852152721363,69.87814784727864,Unisex
HYACINTHE,1955,4679,1173,3506,25.069459286172258,74.93054071382774,Unisex
PERPETUE,1955,201,134,67,66.66666666666666,33.33333333333333,Unisex
JANNY,1955,1044,617,427,59.099616858237546,40.90038314176245,Unisex
ANGE-MARIE,1955,650,290,360,44.61538461538462,55.38461538461539,Unisex
SIMPLICE,1955,329,106,223,32.21884498480243,67.78115501519757,Unisex
YANICK,1955,3028,482,2546,15.918097754293262,84.08190224570674,Unisex
BONIFACE,1955,1187,217,970,18.28138163437237,81.71861836562763,Unisex
SOLANGE,1956,848,848,0,100.0,0.0,Female
JOËLLE,1956,4331,4331,0,100.0,0.0,Female
VENUS,1956,3,3,0,100.0,0.0,Female
LUCIENNE,1956,461,461,0,100.0,0.0,Female
FATMA,1956,58,58,0,100.0,0.0,Female
SUZEL,1956,17,17,0,100.0,0.0,Female
MARIE-JOSEPHE,1956,292,292,0,100.0,0.0,Female
THEODORA,1956,6,6,0,100.0,0.0,Female
MARYANICK,1956,3,3,0,100.0,0.0,Female
BÉATRICE,1956,4114,4114,0,100.0,0.0,Female
MARIE-PIERRETTE,1956,6,6,0,100.0,0.0,Female
SAADIA,1956,16,16,0,100.0,0.0,Female
SOAZIG,1956,5,5,0,100.0,0.0,Female
IVELYNE,1956,3,3,0,100.0,0.0,Female
MARIE-GENEVIÈVE,1956,39,39,0,100.0,0.0,Female
NOELLA,1956,86,86,0,100.0,0.0,Female
NACIRA,1956,4,4,0,100.0,0.0,Female
JOSSELYNE,1956,90,90,0,100.0,0.0,Female
LISBETH,1956,14,14,0,100.0,0.0,Female
GLENDA,1956,3,3,0,100.0,0.0,Female
EVELYSE,1956,13,13,0,100.0,0.0,Female
ANNIK,1956,47,47,0,100.0,0.0,Female
JOANNE,1956,13,13,0,100.0,0.0,Female
MARGARET,1956,132,132,0,100.0,0.0,Female
LUCRECE,1956,8,8,0,100.0,0.0,Female
HELIER,1956,5,0,5,0.0,100.0,Male
THÉODORE,1956,3,0,3,0.0,100.0,Male
FREDERICO,1956,3,0,3,0.0,100.0,Male
EMMANUEL,1956,136541,142,136399,0.1039980665148197,99.89600193348518,Male
GEORGY,1956,6,0,6,0.0,100.0,Male
CARLO,1956,26,0,26,0.0,100.0,Male
MAURIZIO,1956,3,0,3,0.0,100.0,Male
GRÉGOIRE,1956,26979,577,26402,2.1387004707364987,97.8612995292635,Male
BENAMAR,1956,6,0,6,0.0,100.0,Male
KAROL,1956,4,0,4,0.0,100.0,Male
NASSERDINE,1956,3,0,3,0.0,100.0,Male
ABDOUL,1956,3,0,3,0.0,100.0,Male
HASSANE,1956,3,0,3,0.0,100.0,Male
JEAN-ROLAND,1956,7,0,7,0.0,100.0,Male
PIERRE-MICHEL,1956,12,0,12,0.0,100.0,Male
VITTORIO,1956,5,0,5,0.0,100.0,Male
AUGUSTIN,1956,45224,80,45144,0.1768972227136034,99.8231027772864,Male
JEAN-JOSÉ,1956,6,0,6,0.0,100.0,Male
JASMIN,1956,3,0,3,0.0,100.0,Male
FLORIS,1956,4,0,4,0.0,100.0,Male
LARBI,1956,25,0,25,0.0,100.0,Male
GUIBERT,1956,3,0,3,0.0,100.0,Male
OLLIVIER,1956,16,0,16,0.0,100.0,Male
DOMINGO,1956,5,0,5,0.0,100.0,Male
ALEX,1956,318,0,318,0.0,100.0,Male
YANIK,1956,330,50,280,15.151515151515152,84.84848484848484,Unisex
ROSARIO,1956,1546,781,765,50.51746442432082,49.48253557567917,Unisex
MINH,1956,738,185,553,25.067750677506773,74.93224932249322,Unisex
PASQUALE,1956,585,144,441,24.615384615384617,75.38461538461539,Unisex
SAINTE-CROIX,1956,486,103,383,21.193415637860085,78.80658436213992,Unisex
MARIE-JOSEPH,1956,2275,1830,445,80.43956043956044,19.56043956043956,Unisex
GEORGE,1956,2417,650,1767,26.89284236657013,73.10715763342988,Unisex
JEANNY,1956,968,718,250,74.17355371900827,25.82644628099173,Unisex
SULPICE,1956,508,182,326,35.826771653543304,64.1732283464567,Unisex
ARIEL,1956,2401,428,1973,17.8259058725531,82.17409412744689,Unisex
CAROL,1956,3507,2953,554,84.20302252637582,15.79697747362418,Unisex
SABAS,1956,607,220,387,36.24382207578254,63.75617792421746,Unisex
MAGLOIRE,1956,673,106,567,15.75037147102526,84.24962852897474,Unisex
CALIXTE,1956,3347,540,2807,16.13385121003884,83.86614878996116,Unisex
NICAISE,1956,1786,1255,531,70.26875699888018,29.73124300111982,Unisex
CREPIN,1956,606,136,470,22.44224422442244,77.55775577557755,Unisex
PLACIDE,1956,1098,214,884,19.489981785063755,80.51001821493625,Unisex
JOSY,1956,1021,840,181,82.27228207639568,17.72771792360431,Unisex
JEANICK,1956,322,126,196,39.130434782608695,60.86956521739131,Unisex
YANICK,1956,3028,482,2546,15.918097754293262,84.08190224570674,Unisex
TIBURCE,1956,1019,212,807,20.80471050049068,79.19528949950933,Unisex
SCHOLASTIQUE,1956,1080,835,245,77.31481481481481,22.685185185185187,Unisex
LEONCE,1956,9290,2041,7249,21.96986006458557,78.03013993541443,Unisex
YANNIC,1956,671,104,567,15.499254843517138,84.50074515648286,Unisex
JANICK,1956,4109,2203,1906,53.61401800924799,46.38598199075201,Unisex
LORETTE,1957,31,31,0,100.0,0.0,Female
TASSADITE,1957,7,7,0,100.0,0.0,Female
BARBERINE,1957,4,4,0,100.0,0.0,Female
JAMELA,1957,3,3,0,100.0,0.0,Female
MARY-LINE,1957,16,16,0,100.0,0.0,Female
RUFINE,1957,11,11,0,100.0,0.0,Female
ALINA,1957,3,3,0,100.0,0.0,Female
ADA,1957,7,7,0,100.0,0.0,Female
ANNYCK,1957,6,6,0,100.0,0.0,Female
KATTY,1957,17,17,0,100.0,0.0,Female
MARJOLAINE,1957,8,8,0,100.0,0.0,Female
MAGGUY,1957,8,8,0,100.0,0.0,Female
PEPITA,1957,9,9,0,100.0,0.0,Female
MAGUI,1957,3,3,0,100.0,0.0,Female
LOUISETTE,1957,234,234,0,100.0,0.0,Female
SHARON,1957,27,27,0,100.0,0.0,Female
GILBERTE,1957,302,302,0,100.0,0.0,Female
AIMÉE,1957,71,71,0,100.0,0.0,Female
HUBERTE,1957,14,14,0,100.0,0.0,Female
CLAUDIA,1957,58,58,0,100.0,0.0,Female
SYLVAINE,1957,317,317,0,100.0,0.0,Female
SORYA,1957,3,3,0,100.0,0.0,Female
MARIE-FRANÇOISE,1957,1190,1190,0,100.0,0.0,Female
MARIE-JANE,1957,4,4,0,100.0,0.0,Female
MARIE-BÉNÉDICTE,1957,3,3,0,100.0,0.0,Female
DELPHIN,1957,3,0,3,0.0,100.0,Male
RENÉ-PIERRE,1957,5,0,5,0.0,100.0,Male
YAZID,1957,8,0,8,0.0,100.0,Male
LIVIO,1957,3,0,3,0.0,100.0,Male
JEAN-FRED,1957,6,0,6,0.0,100.0,Male
RUDDY,1957,15,0,15,0.0,100.0,Male
ABDELHAMID,1957,7,0,7,0.0,100.0,Male
GÉRALD,1957,431,0,431,0.0,100.0,Male
MOZART,1957,3,0,3,0.0,100.0,Male
ANTHONY,1957,21,0,21,0.0,100.0,Male
DONALD,1957,33,0,33,0.0,100.0,Male
FARIDE,1957,14,0,14,0.0,100.0,Male
FRANÇOIS-MARIE,1957,12,0,12,0.0,100.0,Male
GASPARD,1957,8,0,8,0.0,100.0,Male
GUY-MICHEL,1957,5,0,5,0.0,100.0,Male
AMIDE,1957,3,0,3,0.0,100.0,Male
JAIME,1957,7,0,7,0.0,100.0,Male
NICOLAS,1957,406002,279,405723,0.0687188733060428,99.93128112669396,Male
IVO,1957,3,0,3,0.0,100.0,Male
YACINE,1957,4,0,4,0.0,100.0,Male
ALBERTO,1957,14,0,14,0.0,100.0,Male
JEAN-NICOLAS,1957,7,0,7,0.0,100.0,Male
STEVE,1957,17,0,17,0.0,100.0,Male
CARMELO,1957,25,0,25,0.0,100.0,Male
MARTIN,1957,163,0,163,0.0,100.0,Male
CAMILLE,1957,287709,207732,79977,72.20212089298562,27.79787910701437,Unisex
JEANNICK,1957,2091,1305,786,62.4103299856528,37.589670014347206,Unisex
MARY,1957,6861,5830,1031,84.97303600058301,15.026963999416996,Unisex
DOMINIQUE,1957,409989,168027,241962,40.98329467375954,59.01670532624046,Unisex
MODESTE,1957,1853,656,1197,35.4020507285483,64.59794927145171,Unisex
ARIEL,1957,2401,428,1973,17.8259058725531,82.17409412744689,Unisex
LEE,1957,538,203,335,37.732342007434944,62.26765799256505,Unisex
ALIX,1957,37305,28371,8934,76.05146763168477,23.94853236831524,Unisex
GEORGIE,1957,255,164,91,64.31372549019608,35.68627450980392,Unisex
MARIE-JOSEPH,1957,2275,1830,445,80.43956043956044,19.56043956043956,Unisex
DANY,1957,26027,7836,18191,30.10719637299728,69.89280362700273,Unisex
IRENEE,1957,6155,1854,4301,30.121852152721363,69.87814784727864,Unisex
YANICK,1957,3028,482,2546,15.918097754293262,84.08190224570674,Unisex
LORI,1957,430,327,103,76.04651162790698,23.953488372093023,Unisex
GABY,1957,4741,2448,2293,51.63467622864375,48.36532377135626,Unisex
JANIK,1957,500,287,213,57.4,42.6,Unisex
PLACIDE,1957,1098,214,884,19.489981785063755,80.51001821493625,Unisex
CALIXTE,1957,3347,540,2807,16.13385121003884,83.86614878996116,Unisex
NICAISE,1957,1786,1255,531,70.26875699888018,29.73124300111982,Unisex
NAZAIRE,1957,628,97,531,15.445859872611464,84.55414012738854,Unisex
YANNIC,1957,671,104,567,15.499254843517138,84.50074515648286,Unisex
KIM,1957,6518,5270,1248,80.85302239950906,19.146977600490946,Unisex
JANICK,1957,4109,2203,1906,53.61401800924799,46.38598199075201,Unisex
ANONYME,1957,513,197,316,38.40155945419103,61.59844054580896,Unisex
JEANNY,1957,968,718,250,74.17355371900827,25.82644628099173,Unisex
MARIA-ISABEL,1958,3,3,0,100.0,0.0,Female
DIANNE,1958,6,6,0,100.0,0.0,Female
GLORIA,1958,30,30,0,100.0,0.0,Female
FATNA,1958,10,10,0,100.0,0.0,Female
AURELIA,1958,11,11,0,100.0,0.0,Female
ELINE,1958,4,4,0,100.0,0.0,Female
ODILE-MARIE,1958,3,3,0,100.0,0.0,Female
MARJOLAINE,1958,43,43,0,100.0,0.0,Female
GISELLA,1958,3,3,0,100.0,0.0,Female
NADETTE,1958,7,7,0,100.0,0.0,Female
LEONNE,1958,3,3,0,100.0,0.0,Female
PIERINA,1958,3,3,0,100.0,0.0,Female
PAOLA,1958,19,19,0,100.0,0.0,Female
GISMONDE,1958,3,3,0,100.0,0.0,Female
RÉGINE,1958,2361,2361,0,100.0,0.0,Female
MARISA,1958,27,27,0,100.0,0.0,Female
MIGUELLE,1958,6,6,0,100.0,0.0,Female
MARY-ANGE,1958,3,3,0,100.0,0.0,Female
BELINDA,1958,12,12,0,100.0,0.0,Female
NOELLA,1958,68,68,0,100.0,0.0,Female
LOUISIANE,1958,15,15,0,100.0,0.0,Female
SOLEDAD,1958,5,5,0,100.0,0.0,Female
SALEHA,1958,13,13,0,100.0,0.0,Female
HÉLOÏSE,1958,5,5,0,100.0,0.0,Female
MARLETTE,1958,3,3,0,100.0,0.0,Female
NICOLA,1958,9,0,9,0.0,100.0,Male
AREZKI,1958,6,0,6,0.0,100.0,Male
RAYNAL,1958,7,0,7,0.0,100.0,Male
HOCINE,1958,58,0,58,0.0,100.0,Male
ABDELHAMID,1958,5,0,5,0.0,100.0,Male
AISSA,1958,30,0,30,0.0,100.0,Male
JULIUS,1958,3,0,3,0.0,100.0,Male
PIERO,1958,6,0,6,0.0,100.0,Male
JOSÉ,1958,58950,1605,57345,2.72264631043257,97.27735368956742,Male
VALERY,1958,5530,696,4834,12.585895117540687,87.41410488245931,Male
MARINO,1958,16,0,16,0.0,100.0,Male
SERAPHIN,1958,8,0,8,0.0,100.0,Male
KLEBERT,1958,6,0,6,0.0,100.0,Male
SYLVIAN,1958,14,0,14,0.0,100.0,Male
ELVIO,1958,3,0,3,0.0,100.0,Male
OMER,1958,33,0,33,0.0,100.0,Male
GONZAGUE,1958,14,0,14,0.0,100.0,Male
GUNTER,1958,4,0,4,0.0,100.0,Male
RÉMY,1958,1003,0,1003,0.0,100.0,Male
AZEDINE,1958,6,0,6,0.0,100.0,Male
ODET,1958,3,0,3,0.0,100.0,Male
NORDINE,1958,97,0,97,0.0,100.0,Male
MADJIDE,1958,3,0,3,0.0,100.0,Male
WILFRID,1958,52,0,52,0.0,100.0,Male
ANDRÉ,1958,712785,625,712160,0.0876842245557917,99.9123157754442,Male
HYACINTHE,1958,4679,1173,3506,25.069459286172258,74.93054071382774,Unisex
ALIX,1958,37305,28371,8934,76.05146763168477,23.94853236831524,Unisex
ANONYME,1958,513,197,316,38.40155945419103,61.59844054580896,Unisex
SCHOLASTIQUE,1958,1080,835,245,77.31481481481481,22.685185185185187,Unisex
ANGE-MARIE,1958,650,290,360,44.61538461538462,55.38461538461539,Unisex
DANICK,1958,205,69,136,33.65853658536586,66.34146341463415,Unisex
SERVAIS,1958,812,150,662,18.47290640394089,81.5270935960591,Unisex
MODESTE,1958,1853,656,1197,35.4020507285483,64.59794927145171,Unisex
YANICK,1958,3028,482,2546,15.918097754293262,84.08190224570674,Unisex
MARIE-BERNARD,1958,410,337,73,82.1951219512195,17.804878048780488,Unisex
DANNY,1958,3396,610,2786,17.962308598351,82.037691401649,Unisex
_PRENOMS_RARES,1958,1760252,908578,851674,51.616359475802334,48.38364052419767,Unisex
JANNY,1958,1044,617,427,59.099616858237546,40.90038314176245,Unisex
GABY,1958,4741,2448,2293,51.63467622864375,48.36532377135626,Unisex
JO,1958,341,118,223,34.60410557184751,65.39589442815249,Unisex
JOSY,1958,1021,840,181,82.27228207639568,17.72771792360431,Unisex
GEORGE,1958,2417,650,1767,26.89284236657013,73.10715763342988,Unisex
JANIK,1958,500,287,213,57.4,42.6,Unisex
MARIE-JOSEPH,1958,2275,1830,445,80.43956043956044,19.56043956043956,Unisex
KIM,1958,6518,5270,1248,80.85302239950906,19.146977600490946,Unisex
ARIEL,1958,2401,428,1973,17.8259058725531,82.17409412744689,Unisex
CAROL,1958,3507,2953,554,84.20302252637582,15.79697747362418,Unisex
NICAISE,1958,1786,1255,531,70.26875699888018,29.73124300111982,Unisex
DOMINIQUE,1958,409989,168027,241962,40.98329467375954,59.01670532624046,Unisex
CAMILLE,1958,287709,207732,79977,72.20212089298562,27.79787910701437,Unisex
MAUDE,1959,12,12,0,100.0,0.0,Female
MARTINE,1959,15193,15193,0,100.0,0.0,Female
LEILLA,1959,3,3,0,100.0,0.0,Female
MURYEL,1959,4,4,0,100.0,0.0,Female
FRANCISCA,1959,27,27,0,100.0,0.0,Female
DELPHINE,1959,48,48,0,100.0,0.0,Female
RANIA,1959,9,9,0,100.0,0.0,Female
SELIMA,1959,4,4,0,100.0,0.0,Female
KATIA,1959,143,143,0,100.0,0.0,Female
ORANE,1959,5,5,0,100.0,0.0,Female
REINETTE,1959,11,11,0,100.0,0.0,Female
GHYSLAINE,1959,120,120,0,100.0,0.0,Female
JULIETTA,1959,3,3,0,100.0,0.0,Female
MARIE-JOSEPHE,1959,254,254,0,100.0,0.0,Female
GEORGINA,1959,19,19,0,100.0,0.0,Female
BRUNELLA,1959,6,6,0,100.0,0.0,Female
LISE-BERTHE,1959,3,3,0,100.0,0.0,Female
GATIENNE,1959,5,5,0,100.0,0.0,Female
NINON,1959,4,4,0,100.0,0.0,Female
ANNEMARIE,1959,3,3,0,100.0,0.0,Female
MARIELLE,1959,131,131,0,100.0,0.0,Female
GAETANNE,1959,5,5,0,100.0,0.0,Female
ROSE-MARY,1959,3,3,0,100.0,0.0,Female
ENA,1959,3,3,0,100.0,0.0,Female
JAMILA,1959,60,60,0,100.0,0.0,Female
MUSTAPHA,1959,98,0,98,0.0,100.0,Male
OSWALDO,1959,5,0,5,0.0,100.0,Male
ANNUNZIATO,1959,4,0,4,0.0,100.0,Male
FADEL,1959,3,0,3,0.0,100.0,Male
DALE,1959,5,0,5,0.0,100.0,Male
PIERRE-BERNARD,1959,3,0,3,0.0,100.0,Male
GAËTAN,1959,148,0,148,0.0,100.0,Male
FELICE,1959,5,0,5,0.0,100.0,Male
EDGARD,1959,44,0,44,0.0,100.0,Male
SIMEON,1959,11,0,11,0.0,100.0,Male
LAHOUCINE,1959,3,0,3,0.0,100.0,Male
JOSÉ-MARIA,1959,6,0,6,0.0,100.0,Male
JEAN-LUC,1959,6130,0,6130,0.0,100.0,Male
FORTUNE,1959,11,0,11,0.0,100.0,Male
SANTIAGO,1959,10,0,10,0.0,100.0,Male
ANTONINO,1959,29,0,29,0.0,100.0,Male
EDOUARDO,1959,3,0,3,0.0,100.0,Male
ABDEL-KADER,1959,9,0,9,0.0,100.0,Male
CELESTE,1959,4,0,4,0.0,100.0,Male
JEAN-EMMANUEL,1959,8,0,8,0.0,100.0,Male
JIMMY,1959,41,0,41,0.0,100.0,Male
ABDELHAFID,1959,10,0,10,0.0,100.0,Male
GAETANO,1959,28,0,28,0.0,100.0,Male
HERIC,1959,5,0,5,0.0,100.0,Male
RÉMI,1959,845,0,845,0.0,100.0,Male
JEANNICK,1959,2091,1305,786,62.4103299856528,37.589670014347206,Unisex
NICAISE,1959,1786,1255,531,70.26875699888018,29.73124300111982,Unisex
GEORGE,1959,2417,650,1767,26.89284236657013,73.10715763342988,Unisex
JANICK,1959,4109,2203,1906,53.61401800924799,46.38598199075201,Unisex
CLARENCE,1959,2943,924,2019,31.39653414882773,68.60346585117227,Unisex
HAMIDA,1959,759,628,131,82.74044795783925,17.25955204216074,Unisex
CAROL,1959,3507,2953,554,84.20302252637582,15.79697747362418,Unisex
AMARA,1959,1568,601,967,38.329081632653065,61.670918367346935,Unisex
ARIEL,1959,2401,428,1973,17.8259058725531,82.17409412744689,Unisex
JANNICK,1959,2792,1545,1247,55.336676217765046,44.66332378223496,Unisex
MARIE-BERNARD,1959,410,337,73,82.1951219512195,17.804878048780488,Unisex
ROSARIO,1959,1546,781,765,50.51746442432082,49.48253557567917,Unisex
GABY,1959,4741,2448,2293,51.63467622864375,48.36532377135626,Unisex
ADDA,1959,397,209,188,52.64483627204031,47.3551637279597,Unisex
MODESTE,1959,1853,656,1197,35.4020507285483,64.59794927145171,Unisex
ANGE-MARIE,1959,650,290,360,44.61538461538462,55.38461538461539,Unisex
DANICK,1959,205,69,136,33.65853658536586,66.34146341463415,Unisex
CALIXTE,1959,3347,540,2807,16.13385121003884,83.86614878996116,Unisex
JOSY,1959,1021,840,181,82.27228207639568,17.72771792360431,Unisex
JANIK,1959,500,287,213,57.4,42.6,Unisex
DANNY,1959,3396,610,2786,17.962308598351,82.037691401649,Unisex
PASQUALE,1959,585,144,441,24.615384615384617,75.38461538461539,Unisex
CLAUDY,1959,2240,835,1405,37.27678571428572,62.72321428571429,Unisex
TIBURCE,1959,1019,212,807,20.80471050049068,79.19528949950933,Unisex
YANICK,1959,3028,482,2546,15.918097754293262,84.08190224570674,Unisex
ANNY-CLAUDE,1960,4,4,0,100.0,0.0,Female
DAHBIA,1960,8,8,0,100.0,0.0,Female
GUYLAINE,1960,350,350,0,100.0,0.0,Female
FREDERICA,1960,6,6,0,100.0,0.0,Female
CLAUDINE,1960,4195,4195,0,100.0,0.0,Female
LIANE,1960,3,3,0,100.0,0.0,Female
MARIE-DAISY,1960,5,5,0,100.0,0.0,Female
FATIA,1960,15,15,0,100.0,0.0,Female
CONSTANCE,1960,44,44,0,100.0,0.0,Female
LEÏLA,1960,6,6,0,100.0,0.0,Female
FRANCELYNE,1960,3,3,0,100.0,0.0,Female
ANDRÉA,1960,52847,46098,6749,87.22917100308437,12.770828996915624,Female
ISABELLA,1960,14,14,0,100.0,0.0,Female
FRANCISCA,1960,38,38,0,100.0,0.0,Female
NELLIE,1960,5,5,0,100.0,0.0,Female
ROZEN,1960,6,6,0,100.0,0.0,Female
MELINDA,1960,3,3,0,100.0,0.0,Female
SOLINE,1960,9,9,0,100.0,0.0,Female
DJIDA,1960,3,3,0,100.0,0.0,Female
MARIANNE,1960,767,767,0,100.0,0.0,Female
LELIA,1960,5,5,0,100.0,0.0,Female
DENYSE,1960,4,4,0,100.0,0.0,Female
GUENAELE,1960,3,3,0,100.0,0.0,Female
LORRAINE,1960,28,28,0,100.0,0.0,Female
VINCENZA,1960,21,21,0,100.0,0.0,Female
NESTOR,1960,2489,159,2330,6.388107673764563,93.61189232623543,Male
STANLEY,1960,9,0,9,0.0,100.0,Male
CASIMO,1960,4,0,4,0.0,100.0,Male
GEORGES-MARIE,1960,16,0,16,0.0,100.0,Male
GABIN,1960,13,0,13,0.0,100.0,Male
EVARISTE,1960,4,0,4,0.0,100.0,Male
EDDI,1960,5,0,5,0.0,100.0,Male
GEORGES-HENRI,1960,3,0,3,0.0,100.0,Male
FARRID,1960,3,0,3,0.0,100.0,Male
TONI,1960,17,0,17,0.0,100.0,Male
JOANNES,1960,6,0,6,0.0,100.0,Male
GEROME,1960,9,0,9,0.0,100.0,Male
RAPHAËL,1960,290,0,290,0.0,100.0,Male
RAMUNTCHO,1960,7,0,7,0.0,100.0,Male
SALVATORE,1960,173,0,173,0.0,100.0,Male
JOCELIN,1960,6,0,6,0.0,100.0,Male
ABDELA,1960,3,0,3,0.0,100.0,Male
ANATOLE,1960,16,0,16,0.0,100.0,Male
FRANCO,1960,112,0,112,0.0,100.0,Male
REDA,1960,3,0,3,0.0,100.0,Male
CORRADO,1960,4,0,4,0.0,100.0,Male
DOUGLAS,1960,21,0,21,0.0,100.0,Male
RANDAL,1960,3,0,3,0.0,100.0,Male
EMERIC,1960,7,0,7,0.0,100.0,Male
CALOGERO,1960,61,0,61,0.0,100.0,Male
CARMINE,1960,372,76,296,20.43010752688172,79.56989247311827,Unisex
FELICE,1960,396,204,192,51.51515151515152,48.48484848484848,Unisex
PASQUALE,1960,585,144,441,24.615384615384617,75.38461538461539,Unisex
JANY,1960,3897,2256,1641,57.89068514241724,42.10931485758276,Unisex
JEANNICK,1960,2091,1305,786,62.4103299856528,37.589670014347206,Unisex
JANIK,1960,500,287,213,57.4,42.6,Unisex
NICAISE,1960,1786,1255,531,70.26875699888018,29.73124300111982,Unisex
DANICK,1960,205,69,136,33.65853658536586,66.34146341463415,Unisex
HYACINTHE,1960,4679,1173,3506,25.069459286172258,74.93054071382774,Unisex
JANICK,1960,4109,2203,1906,53.61401800924799,46.38598199075201,Unisex
CAMILLE,1960,287709,207732,79977,72.20212089298562,27.79787910701437,Unisex
ARIEL,1960,2401,428,1973,17.8259058725531,82.17409412744689,Unisex
GEORGE,1960,2417,650,1767,26.89284236657013,73.10715763342988,Unisex
SCHOLASTIQUE,1960,1080,835,245,77.31481481481481,22.685185185185187,Unisex
CAROL,1960,3507,2953,554,84.20302252637582,15.79697747362418,Unisex
CALIXTE,1960,3347,540,2807,16.13385121003884,83.86614878996116,Unisex
BENEDICT,1960,373,64,309,17.158176943699733,82.84182305630027,Unisex
JANNICK,1960,2792,1545,1247,55.336676217765046,44.66332378223496,Unisex
_PRENOMS_RARES,1960,1760252,908578,851674,51.616359475802334,48.38364052419767,Unisex
JEANICK,1960,322,126,196,39.130434782608695,60.86956521739131,Unisex
GABY,1960,4741,2448,2293,51.63467622864375,48.36532377135626,Unisex
JANNY,1960,1044,617,427,59.099616858237546,40.90038314176245,Unisex
CLARENCE,1960,2943,924,2019,31.39653414882773,68.60346585117227,Unisex
ANGE-MARIE,1960,650,290,360,44.61538461538462,55.38461538461539,Unisex
ALIX,1960,37305,28371,8934,76.05146763168477,23.94853236831524,Unisex
ANGELITA,1961,4,4,0,100.0,0.0,Female
ADELA,1961,3,3,0,100.0,0.0,Female
MARIE-MARGUERITE,1961,6,6,0,100.0,0.0,Female
CHRISTINE-MARIE,1961,7,7,0,100.0,0.0,Female
MALIKA,1961,569,569,0,100.0,0.0,Female
LOUISIANE,1961,20,20,0,100.0,0.0,Female
TANIA,1961,77,77,0,100.0,0.0,Female
MARIANE,1961,42,42,0,100.0,0.0,Female
JAMILLA,1961,12,12,0,100.0,0.0,Female
JUDITH,1961,70,70,0,100.0,0.0,Female
MONTSERRAT,1961,19,19,0,100.0,0.0,Female
ELODIE,1961,8,8,0,100.0,0.0,Female
MARIE-VÉRONIQUE,1961,45,45,0,100.0,0.0,Female
MARIETTA,1961,25,25,0,100.0,0.0,Female
MUGUETTE,1961,46,46,0,100.0,0.0,Female
OIRDA,1961,4,4,0,100.0,0.0,Female
ZORAH,1961,12,12,0,100.0,0.0,Female
MYRIAMA,1961,3,3,0,100.0,0.0,Female
SOFIA,1961,12,12,0,100.0,0.0,Female
CRISTINA,1961,11,11,0,100.0,0.0,Female
SOPHIE,1961,246667,246532,135,99.94527034422929,0.0547296557707354,Female
CRYSTAL,1961,4,4,0,100.0,0.0,Female
ANNE-MARIA,1961,3,3,0,100.0,0.0,Female
DANIA,1961,5,5,0,100.0,0.0,Female
OMBLINE,1961,4,4,0,100.0,0.0,Female
CHOUKRI,1961,3,0,3,0.0,100.0,Male
ENRICO,1961,17,0,17,0.0,100.0,Male
SALVADOR,1961,31,0,31,0.0,100.0,Male
HAIM,1961,4,0,4,0.0,100.0,Male
FULBERT,1961,11,0,11,0.0,100.0,Male
JEAN-MARIUS,1961,3,0,3,0.0,100.0,Male
RAIMONDO,1961,3,0,3,0.0,100.0,Male
THÉO,1961,15,0,15,0.0,100.0,Male
ANTAR,1961,3,0,3,0.0,100.0,Male
RENATO,1961,25,0,25,0.0,100.0,Male
BERTRAND,1961,1687,0,1687,0.0,100.0,Male
JACQUY,1961,25,0,25,0.0,100.0,Male
GUÉNAËL,1961,4,0,4,0.0,100.0,Male
VICENTE,1961,36,0,36,0.0,100.0,Male
JORIS,1961,8,0,8,0.0,100.0,Male
CLAIR,1961,6,0,6,0.0,100.0,Male
FABIO,1961,21,0,21,0.0,100.0,Male
BEN,1961,17,0,17,0.0,100.0,Male
VANNI,1961,5,0,5,0.0,100.0,Male
THIÉRY,1961,4,0,4,0.0,100.0,Male
JORGE,1961,8,0,8,0.0,100.0,Male
LEZIN,1961,3,0,3,0.0,100.0,Male
LUCA,1961,3,0,3,0.0,100.0,Male
RIAD,1961,6,0,6,0.0,100.0,Male
EFISIO,1961,3,0,3,0.0,100.0,Male
CAROL,1961,3507,2953,554,84.20302252637582,15.79697747362418,Unisex
SABAS,1961,607,220,387,36.24382207578254,63.75617792421746,Unisex
_PRENOMS_RARES,1961,1760252,908578,851674,51.616359475802334,48.38364052419767,Unisex
DOMINIQUE,1961,409989,168027,241962,40.98329467375954,59.01670532624046,Unisex
CAMILLE,1961,287709,207732,79977,72.20212089298562,27.79787910701437,Unisex
PLACIDE,1961,1098,214,884,19.489981785063755,80.51001821493625,Unisex
MARIE-JOSEPH,1961,2275,1830,445,80.43956043956044,19.56043956043956,Unisex
DANNY,1961,3396,610,2786,17.962308598351,82.037691401649,Unisex
MAGLOIRE,1961,673,106,567,15.75037147102526,84.24962852897474,Unisex
HONORAT,1961,652,270,382,41.41104294478527,58.58895705521472,Unisex
CLAUDY,1961,2240,835,1405,37.27678571428572,62.72321428571429,Unisex
AMARA,1961,1568,601,967,38.329081632653065,61.670918367346935,Unisex
ALIX,1961,37305,28371,8934,76.05146763168477,23.94853236831524,Unisex
ROSARIO,1961,1546,781,765,50.51746442432082,49.48253557567917,Unisex
HYACINTHE,1961,4679,1173,3506,25.069459286172258,74.93054071382774,Unisex
JANY,1961,3897,2256,1641,57.89068514241724,42.10931485758276,Unisex
NICAISE,1961,1786,1255,531,70.26875699888018,29.73124300111982,Unisex
GABY,1961,4741,2448,2293,51.63467622864375,48.36532377135626,Unisex
HAMIDA,1961,759,628,131,82.74044795783925,17.25955204216074,Unisex
DANICK,1961,205,69,136,33.65853658536586,66.34146341463415,Unisex
MARY,1961,6861,5830,1031,84.97303600058301,15.026963999416996,Unisex
JEANNICK,1961,2091,1305,786,62.4103299856528,37.589670014347206,Unisex
GEORGE,1961,2417,650,1767,26.89284236657013,73.10715763342988,Unisex
JANICK,1961,4109,2203,1906,53.61401800924799,46.38598199075201,Unisex
YANICK,1961,3028,482,2546,15.918097754293262,84.08190224570674,Unisex
EVELISE,1962,4,4,0,100.0,0.0,Female
HELIETTE,1962,5,5,0,100.0,0.0,Female
ANTONIA,1962,92,92,0,100.0,0.0,Female
FATHIA,1962,8,8,0,100.0,0.0,Female
LAURIANE,1962,10,10,0,100.0,0.0,Female
BLANCHE,1962,38,38,0,100.0,0.0,Female
IRMA,1962,29,29,0,100.0,0.0,Female
ROSE-ANNE,1962,9,9,0,100.0,0.0,Female
MARYLENE,1962,549,549,0,100.0,0.0,Female
ARMIDE,1962,3,3,0,100.0,0.0,Female
SOLINE,1962,14,14,0,100.0,0.0,Female
JANINE,1962,199,199,0,100.0,0.0,Female
SAIDA,1962,26,26,0,100.0,0.0,Female
TRINIDAD,1962,10,10,0,100.0,0.0,Female
LOUISIANE,1962,25,25,0,100.0,0.0,Female
SIBYLLE,1962,11,11,0,100.0,0.0,Female
MARIE-EVE,1962,22,22,0,100.0,0.0,Female
RAPHAELLE,1962,41,41,0,100.0,0.0,Female
ARMELE,1962,4,4,0,100.0,0.0,Female
MARIE-DANIELE,1962,10,10,0,100.0,0.0,Female
SÉGOLÈNE,1962,11,11,0,100.0,0.0,Female
LIDIA,1962,32,32,0,100.0,0.0,Female
ESTRELLA,1962,5,5,0,100.0,0.0,Female
GEORGIA,1962,12,12,0,100.0,0.0,Female
SYLVANIE,1962,4,4,0,100.0,0.0,Female
GWENAËL,1962,3,0,3,0.0,100.0,Male
SEVERIN,1962,5,0,5,0.0,100.0,Male
JEAN-GÉRALD,1962,3,0,3,0.0,100.0,Male
JEAN-XAVIER,1962,3,0,3,0.0,100.0,Male
JEAN-JACQUES,1962,1697,0,1697,0.0,100.0,Male
JEAN-CARLO,1962,4,0,4,0.0,100.0,Male
ROY,1962,9,0,9,0.0,100.0,Male
YOUSEF,1962,3,0,3,0.0,100.0,Male
ISTVAN,1962,3,0,3,0.0,100.0,Male
ALBERTO,1962,40,0,40,0.0,100.0,Male
GUIDO,1962,9,0,9,0.0,100.0,Male
HERMANN,1962,8,0,8,0.0,100.0,Male
JOHANN,1962,23,0,23,0.0,100.0,Male
WILSON,1962,5,0,5,0.0,100.0,Male
SALVATORE,1962,197,0,197,0.0,100.0,Male
LOTFI,1962,3,0,3,0.0,100.0,Male
THONY,1962,3,0,3,0.0,100.0,Male
DJELLOUL,1962,6,0,6,0.0,100.0,Male
BOUZID,1962,8,0,8,0.0,100.0,Male
ABDEL-NASSER,1962,4,0,4,0.0,100.0,Male
ADEL,1962,4,0,4,0.0,100.0,Male
HASSEN,1962,31,0,31,0.0,100.0,Male
BRYAN,1962,5,0,5,0.0,100.0,Male
SERGES,1962,8,0,8,0.0,100.0,Male
MYRTHO,1962,3,0,3,0.0,100.0,Male
CAMILLE,1962,287709,207732,79977,72.20212089298562,27.79787910701437,Unisex
ARIEL,1962,2401,428,1973,17.8259058725531,82.17409412744689,Unisex
JOSY,1962,1021,840,181,82.27228207639568,17.72771792360431,Unisex
JEANNY,1962,968,718,250,74.17355371900827,25.82644628099173,Unisex
ROSARIO,1962,1546,781,765,50.51746442432082,49.48253557567917,Unisex
PASQUALE,1962,585,144,441,24.615384615384617,75.38461538461539,Unisex
AMARA,1962,1568,601,967,38.329081632653065,61.670918367346935,Unisex
ALIX,1962,37305,28371,8934,76.05146763168477,23.94853236831524,Unisex
HAMIDA,1962,759,628,131,82.74044795783925,17.25955204216074,Unisex
JANY,1962,3897,2256,1641,57.89068514241724,42.10931485758276,Unisex
DANNY,1962,3396,610,2786,17.962308598351,82.037691401649,Unisex
PRIVAT,1962,514,87,427,16.926070038910506,83.0739299610895,Unisex
CALIXTE,1962,3347,540,2807,16.13385121003884,83.86614878996116,Unisex
BENEDICT,1962,373,64,309,17.158176943699733,82.84182305630027,Unisex
MARIE-JOSEPH,1962,2275,1830,445,80.43956043956044,19.56043956043956,Unisex
JANNY,1962,1044,617,427,59.099616858237546,40.90038314176245,Unisex
NICAISE,1962,1786,1255,531,70.26875699888018,29.73124300111982,Unisex
HYACINTHE,1962,4679,1173,3506,25.069459286172258,74.93054071382774,Unisex
FELICE,1962,396,204,192,51.51515151515152,48.48484848484848,Unisex
_PRENOMS_RARES,1962,1760252,908578,851674,51.616359475802334,48.38364052419767,Unisex
JEANNICK,1962,2091,1305,786,62.4103299856528,37.589670014347206,Unisex
GABY,1962,4741,2448,2293,51.63467622864375,48.36532377135626,Unisex
DOMINIQUE,1962,409989,168027,241962,40.98329467375954,59.01670532624046,Unisex
CAROL,1962,3507,2953,554,84.20302252637582,15.79697747362418,Unisex
IRENEE,1962,6155,1854,4301,30.121852152721363,69.87814784727864,Unisex
SOURIA,1963,3,3,0,100.0,0.0,Female
CHANTALE,1963,76,76,0,100.0,0.0,Female
CHRISTIANE,1963,2041,2041,0,100.0,0.0,Female
FRANCIANNE,1963,5,5,0,100.0,0.0,Female
REINE,1963,111,111,0,100.0,0.0,Female
AGATHE,1963,57,57,0,100.0,0.0,Female
MAITE,1963,45,45,0,100.0,0.0,Female
LAURINDA,1963,4,4,0,100.0,0.0,Female
CALOGERA,1963,23,23,0,100.0,0.0,Female
GATIENNE,1963,5,5,0,100.0,0.0,Female
CATHARINA,1963,3,3,0,100.0,0.0,Female
VESNA,1963,3,3,0,100.0,0.0,Female
NOUARA,1963,16,16,0,100.0,0.0,Female
FRANCESCA,1963,54,54,0,100.0,0.0,Female
SILVA,1963,3,3,0,100.0,0.0,Female
CATARINA,1963,5,5,0,100.0,0.0,Female
CONCEPCION,1963,13,13,0,100.0,0.0,Female
MARIE-JOSIANE,1963,8,8,0,100.0,0.0,Female
CATHY,1963,653,653,0,100.0,0.0,Female
CARMELINA,1963,25,25,0,100.0,0.0,Female
FRANCA,1963,55,55,0,100.0,0.0,Female
MARIE-FREDE,1963,5,5,0,100.0,0.0,Female
MARY,1963,42,42,0,100.0,0.0,Female
ANNE-PASCALE,1963,7,7,0,100.0,0.0,Female
CORNELIE,1963,4,4,0,100.0,0.0,Female
JOANY,1963,3,0,3,0.0,100.0,Male
ALMIRE,1963,3,0,3,0.0,100.0,Male
BENAISSA,1963,3,0,3,0.0,100.0,Male
PAUL-ANDRÉ,1963,4,0,4,0.0,100.0,Male
SIDOINE,1963,5,0,5,0.0,100.0,Male
ROSS,1963,3,0,3,0.0,100.0,Male
NORADINE,1963,3,0,3,0.0,100.0,Male
TRISTAN,1963,38,0,38,0.0,100.0,Male
SIGISMOND,1963,3,0,3,0.0,100.0,Male
RENALDO,1963,6,0,6,0.0,100.0,Male
DRISS,1963,8,0,8,0.0,100.0,Male
MORENO,1963,7,0,7,0.0,100.0,Male
ETIENNE,1963,631,0,631,0.0,100.0,Male
DEMETRIO,1963,5,0,5,0.0,100.0,Male
MOLIERE,1963,3,0,3,0.0,100.0,Male
ARMANDO,1963,18,0,18,0.0,100.0,Male
GRÉGORY,1963,3,0,3,0.0,100.0,Male
FARES,1963,3,0,3,0.0,100.0,Male
FLORENTINO,1963,4,0,4,0.0,100.0,Male
RONEL,1963,3,0,3,0.0,100.0,Male
ABDOUL,1963,3,0,3,0.0,100.0,Male
MATHURIN,1963,17,0,17,0.0,100.0,Male
MOULAY,1963,6,0,6,0.0,100.0,Male
BIAGGIO,1963,3,0,3,0.0,100.0,Male
JULIANO,1963,3,0,3,0.0,100.0,Male
DANY,1963,26027,7836,18191,30.10719637299728,69.89280362700273,Unisex
JEANNICK,1963,2091,1305,786,62.4103299856528,37.589670014347206,Unisex
SCHOLASTIQUE,1963,1080,835,245,77.31481481481481,22.685185185185187,Unisex
PASQUALE,1963,585,144,441,24.615384615384617,75.38461538461539,Unisex
KIM,1963,6518,5270,1248,80.85302239950906,19.146977600490946,Unisex
ADDA,1963,397,209,188,52.64483627204031,47.3551637279597,Unisex
ARIEL,1963,2401,428,1973,17.8259058725531,82.17409412744689,Unisex
DANNY,1963,3396,610,2786,17.962308598351,82.037691401649,Unisex
CALIXTE,1963,3347,540,2807,16.13385121003884,83.86614878996116,Unisex
JEANNY,1963,968,718,250,74.17355371900827,25.82644628099173,Unisex
JANIC,1963,115,56,59,48.69565217391305,51.30434782608696,Unisex
NICAISE,1963,1786,1255,531,70.26875699888018,29.73124300111982,Unisex
_PRENOMS_RARES,1963,1760252,908578,851674,51.616359475802334,48.38364052419767,Unisex
JANNICK,1963,2792,1545,1247,55.336676217765046,44.66332378223496,Unisex
MARIE-JOSEPH,1963,2275,1830,445,80.43956043956044,19.56043956043956,Unisex
MEDARD,1963,1076,175,901,16.263940520446095,83.7360594795539,Unisex
HAMIDA,1963,759,628,131,82.74044795783925,17.25955204216074,Unisex
GABY,1963,4741,2448,2293,51.63467622864375,48.36532377135626,Unisex
DOMINIQUE,1963,409989,168027,241962,40.98329467375954,59.01670532624046,Unisex
MESMIN,1963,773,183,590,23.67399741267788,76.32600258732212,Unisex
CAMILLE,1963,287709,207732,79977,72.20212089298562,27.79787910701437,Unisex
JEANICK,1963,322,126,196,39.130434782608695,60.86956521739131,Unisex
AMARA,1963,1568,601,967,38.329081632653065,61.670918367346935,Unisex
EUSTACHE,1963,1376,277,1099,20.13081395348837,79.86918604651163,Unisex
FELICE,1963,396,204,192,51.51515151515152,48.48484848484848,Unisex
ADJILA,1964,5,5,0,100.0,0.0,Female
LOETITIA,1964,39,39,0,100.0,0.0,Female
ÉLISABETH,1964,12,12,0,100.0,0.0,Female
MARYLIN,1964,29,29,0,100.0,0.0,Female
MARIE-JOSÉE,1964,32,32,0,100.0,0.0,Female
MIRIAM,1964,9,9,0,100.0,0.0,Female
HONORINE,1964,12,12,0,100.0,0.0,Female
HÉLOÏSE,1964,5,5,0,100.0,0.0,Female
SILVIANE,1964,4,4,0,100.0,0.0,Female
MARIE-LAETITIA,1964,6,6,0,100.0,0.0,Female
MILOUDA,1964,3,3,0,100.0,0.0,Female
FADILA,1964,89,89,0,100.0,0.0,Female
BRIGIDA,1964,4,4,0,100.0,0.0,Female
CARLINE,1964,7,7,0,100.0,0.0,Female
ROLANDE,1964,92,92,0,100.0,0.0,Female
MAIMOUNA,1964,3,3,0,100.0,0.0,Female
NOELE,1964,6,6,0,100.0,0.0,Female
EDMONDE,1964,20,20,0,100.0,0.0,Female
CONNIE,1964,8,8,0,100.0,0.0,Female
ANIE,1964,7,7,0,100.0,0.0,Female
SABAH,1964,38,38,0,100.0,0.0,Female
MARYLIS,1964,5,5,0,100.0,0.0,Female
DIANA,1964,60,60,0,100.0,0.0,Female
CLAIRE-MARIE,1964,11,11,0,100.0,0.0,Female
PASCALINE,1964,207,207,0,100.0,0.0,Female
KADOUR,1964,11,0,11,0.0,100.0,Male
MICHAËL,1964,10,0,10,0.0,100.0,Male
ANGE,1964,21831,2649,19182,12.134121203792771,87.86587879620723,Male
BEN,1964,20,0,20,0.0,100.0,Male
SAID,1964,209,0,209,0.0,100.0,Male
AMEDE,1964,4,0,4,0.0,100.0,Male
GEOFFROY,1964,34,0,34,0.0,100.0,Male
HASSEM,1964,3,0,3,0.0,100.0,Male
FRANKY,1964,6,0,6,0.0,100.0,Male
ALFIO,1964,4,0,4,0.0,100.0,Male
VLADIMIR,1964,6,0,6,0.0,100.0,Male
GAUTHIER,1964,23,0,23,0.0,100.0,Male
PIERRE-MICHEL,1964,13,0,13,0.0,100.0,Male
EDWIN,1964,6,0,6,0.0,100.0,Male
PIERRE-ALEXANDRE,1964,3,0,3,0.0,100.0,Male
TAYEB,1964,28,0,28,0.0,100.0,Male
RINO,1964,7,0,7,0.0,100.0,Male
AXEL,1964,67,0,67,0.0,100.0,Male
ROSAIRE,1964,24,0,24,0.0,100.0,Male
FELICE,1964,5,0,5,0.0,100.0,Male
LENNY,1964,3,0,3,0.0,100.0,Male
MANFRED,1964,4,0,4,0.0,100.0,Male
TANNEGUY,1964,3,0,3,0.0,100.0,Male
VALÉRY,1964,599,77,522,12.85475792988314,87.14524207011685,Male
PHILBERT,1964,3,0,3,0.0,100.0,Male
JEANICK,1964,322,126,196,39.130434782608695,60.86956521739131,Unisex
PASQUALE,1964,585,144,441,24.615384615384617,75.38461538461539,Unisex
JANNICK,1964,2792,1545,1247,55.336676217765046,44.66332378223496,Unisex
YANNIC,1964,671,104,567,15.499254843517138,84.50074515648286,Unisex
CALIXTE,1964,3347,540,2807,16.13385121003884,83.86614878996116,Unisex
JANY,1964,3897,2256,1641,57.89068514241724,42.10931485758276,Unisex
PLACIDE,1964,1098,214,884,19.489981785063755,80.51001821493625,Unisex
DOMINIQUE,1964,409989,168027,241962,40.98329467375954,59.01670532624046,Unisex
GEORGE,1964,2417,650,1767,26.89284236657013,73.10715763342988,Unisex
JOSY,1964,1021,840,181,82.27228207639568,17.72771792360431,Unisex
DANICK,1964,205,69,136,33.65853658536586,66.34146341463415,Unisex
EUSTACHE,1964,1376,277,1099,20.13081395348837,79.86918604651163,Unisex
KIM,1964,6518,5270,1248,80.85302239950906,19.146977600490946,Unisex
YANICK,1964,3028,482,2546,15.918097754293262,84.08190224570674,Unisex
CLAUDY,1964,2240,835,1405,37.27678571428572,62.72321428571429,Unisex
DANY,1964,26027,7836,18191,30.10719637299728,69.89280362700273,Unisex
SABAS,1964,607,220,387,36.24382207578254,63.75617792421746,Unisex
CAROL,1964,3507,2953,554,84.20302252637582,15.79697747362418,Unisex
MARIE-JOSEPH,1964,2275,1830,445,80.43956043956044,19.56043956043956,Unisex
_PRENOMS_RARES,1964,1760252,908578,851674,51.616359475802334,48.38364052419767,Unisex
ROSARIO,1964,1546,781,765,50.51746442432082,49.48253557567917,Unisex
JANNY,1964,1044,617,427,59.099616858237546,40.90038314176245,Unisex
MODESTE,1964,1853,656,1197,35.4020507285483,64.59794927145171,Unisex
FRANCKIE,1964,483,73,410,15.113871635610764,84.88612836438924,Unisex
JEANNICK,1964,2091,1305,786,62.4103299856528,37.589670014347206,Unisex
DALINDA,1965,3,3,0,100.0,0.0,Female
MARIE-MANUELLE,1965,3,3,0,100.0,0.0,Female
MARIE-CHRISTEL,1965,8,8,0,100.0,0.0,Female
MARLEINE,1965,4,4,0,100.0,0.0,Female
ANNAICK,1965,33,33,0,100.0,0.0,Female
SOISICK,1965,4,4,0,100.0,0.0,Female
OUAHIBA,1965,5,5,0,100.0,0.0,Female
HADJIRA,1965,5,5,0,100.0,0.0,Female
BAPTISTINE,1965,7,7,0,100.0,0.0,Female
TANYA,1965,4,4,0,100.0,0.0,Female
MARI,1965,5,5,0,100.0,0.0,Female
AMELLE,1965,5,5,0,100.0,0.0,Female
ANNE-CAROLINE,1965,7,7,0,100.0,0.0,Female
TASSADIT,1965,13,13,0,100.0,0.0,Female
SAMIRA,1965,45,45,0,100.0,0.0,Female
SHIRLEY,1965,12,12,0,100.0,0.0,Female
FADELLA,1965,7,7,0,100.0,0.0,Female
JEANNETTE,1965,84,84,0,100.0,0.0,Female
ALBERTE,1965,38,38,0,100.0,0.0,Female
DABIA,1965,7,7,0,100.0,0.0,Female
TANIA,1965,101,101,0,100.0,0.0,Female
IMANE,1965,3,3,0,100.0,0.0,Female
GUENOLEE,1965,3,3,0,100.0,0.0,Female
EVA-MARIA,1965,3,3,0,100.0,0.0,Female
FRANCELISE,1965,21,21,0,100.0,0.0,Female
AZOUZ,1965,6,0,6,0.0,100.0,Male
JOSÉ-MARIA,1965,14,0,14,0.0,100.0,Male
PIERRE-MARC,1965,4,0,4,0.0,100.0,Male
JOHN,1965,116,0,116,0.0,100.0,Male
NICHOLAS,1965,3,0,3,0.0,100.0,Male
JEAN-SERGE,1965,6,0,6,0.0,100.0,Male
CAMILLO,1965,3,0,3,0.0,100.0,Male
ALAIN,1965,11291,0,11291,0.0,100.0,Male
JEAN-LOUIS,1965,1806,0,1806,0.0,100.0,Male
MARC-PIERRE,1965,4,0,4,0.0,100.0,Male
BARNABE,1965,6,0,6,0.0,100.0,Male
BOUBAKER,1965,4,0,4,0.0,100.0,Male
FAOUZI,1965,22,0,22,0.0,100.0,Male
RENAUD,1965,327,0,327,0.0,100.0,Male
CONSTANT,1965,35,0,35,0.0,100.0,Male
YANNIG,1965,15,0,15,0.0,100.0,Male
BACHIR,1965,62,0,62,0.0,100.0,Male
SYLVAIN,1965,3027,0,3027,0.0,100.0,Male
TAYEB,1965,21,0,21,0.0,100.0,Male
TARIK,1965,4,0,4,0.0,100.0,Male
DANIEL,1965,5024,0,5024,0.0,100.0,Male
VICENZO,1965,3,0,3,0.0,100.0,Male
ABDELKADER,1965,226,0,226,0.0,100.0,Male
NORDINE,1965,192,0,192,0.0,100.0,Male
MATTHIEU,1965,66,0,66,0.0,100.0,Male
MARIE-JOSEPH,1965,2275,1830,445,80.43956043956044,19.56043956043956,Unisex
NICAISE,1965,1786,1255,531,70.26875699888018,29.73124300111982,Unisex
GABY,1965,4741,2448,2293,51.63467622864375,48.36532377135626,Unisex
KIM,1965,6518,5270,1248,80.85302239950906,19.146977600490946,Unisex
JANICK,1965,4109,2203,1906,53.61401800924799,46.38598199075201,Unisex
JEANNICK,1965,2091,1305,786,62.4103299856528,37.589670014347206,Unisex
DANNY,1965,3396,610,2786,17.962308598351,82.037691401649,Unisex
ARIEL,1965,2401,428,1973,17.8259058725531,82.17409412744689,Unisex
_PRENOMS_RARES,1965,1760252,908578,851674,51.616359475802334,48.38364052419767,Unisex
CAROL,1965,3507,2953,554,84.20302252637582,15.79697747362418,Unisex
GEORGE,1965,2417,650,1767,26.89284236657013,73.10715763342988,Unisex
JOSY,1965,1021,840,181,82.27228207639568,17.72771792360431,Unisex
ROSARIO,1965,1546,781,765,50.51746442432082,49.48253557567917,Unisex
CARMEL,1965,409,197,212,48.16625916870416,51.83374083129584,Unisex
DOMINIQUE,1965,409989,168027,241962,40.98329467375954,59.01670532624046,Unisex
ADDA,1965,397,209,188,52.64483627204031,47.3551637279597,Unisex
CAMILLE,1965,287709,207732,79977,72.20212089298562,27.79787910701437,Unisex
CLAUDY,1965,2240,835,1405,37.27678571428572,62.72321428571429,Unisex
GABRIELE,1965,993,563,430,56.6968781470292,43.3031218529708,Unisex
ALIX,1965,37305,28371,8934,76.05146763168477,23.94853236831524,Unisex
JEANICK,1965,322,126,196,39.130434782608695,60.86956521739131,Unisex
VANIA,1965,402,316,86,78.60696517412936,21.393034825870647,Unisex
AMARA,1965,1568,601,967,38.329081632653065,61.670918367346935,Unisex
HYACINTHE,1965,4679,1173,3506,25.069459286172258,74.93054071382774,Unisex
DANY,1965,26027,7836,18191,30.10719637299728,69.89280362700273,Unisex
MARIE-NADIA,1966,5,5,0,100.0,0.0,Female
MONSERRAT,1966,6,6,0,100.0,0.0,Female
ZELIA,1966,4,4,0,100.0,0.0,Female
ADA,1966,6,6,0,100.0,0.0,Female
ANNE-CLAIRE,1966,67,67,0,100.0,0.0,Female
CIDALIA,1966,3,3,0,100.0,0.0,Female
MARIE-PIA,1966,7,7,0,100.0,0.0,Female
APOLLINE,1966,4,4,0,100.0,0.0,Female
ARIANNE,1966,4,4,0,100.0,0.0,Female
FLORIANE,1966,64,64,0,100.0,0.0,Female
ORANE,1966,3,3,0,100.0,0.0,Female
JANNIQUE,1966,5,5,0,100.0,0.0,Female
ARIELE,1966,14,14,0,100.0,0.0,Female
SIGOLENE,1966,3,3,0,100.0,0.0,Female
ROSINA,1966,14,14,0,100.0,0.0,Female
JOSEPHE,1966,12,12,0,100.0,0.0,Female
ROSEMARIE,1966,4,4,0,100.0,0.0,Female
NOELLA,1966,55,55,0,100.0,0.0,Female
HOURYA,1966,3,3,0,100.0,0.0,Female
GRAZIELLE,1966,4,4,0,100.0,0.0,Female
SALOI,1966,3,3,0,100.0,0.0,Female
OUZNA,1966,3,3,0,100.0,0.0,Female
KADIJA,1966,8,8,0,100.0,0.0,Female
MARIE-BRIGITTE,1966,15,15,0,100.0,0.0,Female
ARMELE,1966,6,6,0,100.0,0.0,Female
MUSTAFA,1966,29,0,29,0.0,100.0,Male
LAURIS,1966,4,0,4,0.0,100.0,Male
NORBERT,1966,448,0,448,0.0,100.0,Male
XAVIER,1966,2588,0,2588,0.0,100.0,Male
SANDRO,1966,46,0,46,0.0,100.0,Male
YOHAN,1966,3,0,3,0.0,100.0,Male
SAID,1966,220,0,220,0.0,100.0,Male
JEAN-RAPHAËL,1966,5,0,5,0.0,100.0,Male
JEAN-PASCAL,1966,238,0,238,0.0,100.0,Male
RUFIN,1966,3,0,3,0.0,100.0,Male
YOLAND,1966,30,0,30,0.0,100.0,Male
AYMERIC,1966,16,0,16,0.0,100.0,Male
MOHAMED,1966,665,0,665,0.0,100.0,Male
LAHCEN,1966,9,0,9,0.0,100.0,Male
RINO,1966,6,0,6,0.0,100.0,Male
MALO,1966,3,0,3,0.0,100.0,Male
BOUBAKAR,1966,3,0,3,0.0,100.0,Male
ALBANO,1966,4,0,4,0.0,100.0,Male
DIONISIO,1966,7,0,7,0.0,100.0,Male
WENCESLAS,1966,3,0,3,0.0,100.0,Male
KHELIFA,1966,5,0,5,0.0,100.0,Male
STEVES,1966,3,0,3,0.0,100.0,Male
AZOUZ,1966,3,0,3,0.0,100.0,Male
LÉON,1966,63,0,63,0.0,100.0,Male
CIRO,1966,5,0,5,0.0,100.0,Male
JANY,1966,3897,2256,1641,57.89068514241724,42.10931485758276,Unisex
CAMILLE,1966,287709,207732,79977,72.20212089298562,27.79787910701437,Unisex
NICAISE,1966,1786,1255,531,70.26875699888018,29.73124300111982,Unisex
YANNE,1966,420,204,216,48.57142857142857,51.42857142857142,Unisex
ALIX,1966,37305,28371,8934,76.05146763168477,23.94853236831524,Unisex
_PRENOMS_RARES,1966,1760252,908578,851674,51.616359475802334,48.38364052419767,Unisex
DOMINIQUE,1966,409989,168027,241962,40.98329467375954,59.01670532624046,Unisex
CALIXTE,1966,3347,540,2807,16.13385121003884,83.86614878996116,Unisex
JANICK,1966,4109,2203,1906,53.61401800924799,46.38598199075201,Unisex
KIM,1966,6518,5270,1248,80.85302239950906,19.146977600490946,Unisex
THANH,1966,630,259,371,41.11111111111111,58.88888888888889,Unisex
JOSY,1966,1021,840,181,82.27228207639568,17.72771792360431,Unisex
YANICK,1966,3028,482,2546,15.918097754293262,84.08190224570674,Unisex
IRENEE,1966,6155,1854,4301,30.121852152721363,69.87814784727864,Unisex
JEANNY,1966,968,718,250,74.17355371900827,25.82644628099173,Unisex
HYACINTHE,1966,4679,1173,3506,25.069459286172258,74.93054071382774,Unisex
ADDA,1966,397,209,188,52.64483627204031,47.3551637279597,Unisex
GEORGE,1966,2417,650,1767,26.89284236657013,73.10715763342988,Unisex
ANGE-MARIE,1966,650,290,360,44.61538461538462,55.38461538461539,Unisex
ROSARIO,1966,1546,781,765,50.51746442432082,49.48253557567917,Unisex
CLAUDY,1966,2240,835,1405,37.27678571428572,62.72321428571429,Unisex
DANNY,1966,3396,610,2786,17.962308598351,82.037691401649,Unisex
JEANICK,1966,322,126,196,39.130434782608695,60.86956521739131,Unisex
ARIEL,1966,2401,428,1973,17.8259058725531,82.17409412744689,Unisex
PASQUALE,1966,585,144,441,24.615384615384617,75.38461538461539,Unisex
CORALIE,1967,224,224,0,100.0,0.0,Female
ZORRA,1967,4,4,0,100.0,0.0,Female
ANNE-CLAUDE,1967,37,37,0,100.0,0.0,Female
THI,1967,15,15,0,100.0,0.0,Female
MALICA,1967,12,12,0,100.0,0.0,Female
SOAD,1967,5,5,0,100.0,0.0,Female
NADINE,1967,3624,3624,0,100.0,0.0,Female
SYLVIANE,1967,800,800,0,100.0,0.0,Female
DELICIA,1967,3,3,0,100.0,0.0,Female
GWENAELE,1967,28,28,0,100.0,0.0,Female
ORIETTA,1967,3,3,0,100.0,0.0,Female
AURÉLIA,1967,5,5,0,100.0,0.0,Female
CELESTINA,1967,4,4,0,100.0,0.0,Female
MARYSA,1967,4,4,0,100.0,0.0,Female
MIKAELLE,1967,5,5,0,100.0,0.0,Female
HANNELORE,1967,5,5,0,100.0,0.0,Female
MARIA-LUISA,1967,25,25,0,100.0,0.0,Female
ISILDA,1967,3,3,0,100.0,0.0,Female
DEBORAH,1967,12,12,0,100.0,0.0,Female
JAMELLA,1967,4,4,0,100.0,0.0,Female
HAUDE,1967,8,8,0,100.0,0.0,Female
ANNE-FRANÇOISE,1967,68,68,0,100.0,0.0,Female
LAMIA,1967,7,7,0,100.0,0.0,Female
JACINTHE,1967,9,9,0,100.0,0.0,Female
MARGARETH,1967,42,42,0,100.0,0.0,Female
JOËL,1967,2644,0,2644,0.0,100.0,Male
CARMINE,1967,7,0,7,0.0,100.0,Male
ALFRED,1967,85,0,85,0.0,100.0,Male
JULIEN,1967,205,0,205,0.0,100.0,Male
ABDELMAGID,1967,3,0,3,0.0,100.0,Male
ARY,1967,10,0,10,0.0,100.0,Male
IGOR,1967,81,0,81,0.0,100.0,Male
CESAR,1967,24,0,24,0.0,100.0,Male
LARBI,1967,39,0,39,0.0,100.0,Male
JOSÉ-ANGEL,1967,3,0,3,0.0,100.0,Male
MORAD,1967,51,0,51,0.0,100.0,Male
CLÉMENT,1967,108,0,108,0.0,100.0,Male
GUYTO,1967,10,0,10,0.0,100.0,Male
RAFAEL,1967,68,0,68,0.0,100.0,Male
RABAH,1967,95,0,95,0.0,100.0,Male
HERALD,1967,4,0,4,0.0,100.0,Male
GUIDO,1967,12,0,12,0.0,100.0,Male
SADI,1967,9,0,9,0.0,100.0,Male
ABDELOUAB,1967,3,0,3,0.0,100.0,Male
ASSAN,1967,5,0,5,0.0,100.0,Male
HERMANN,1967,14,0,14,0.0,100.0,Male
YANIC,1967,4,0,4,0.0,100.0,Male
FAOUZI,1967,29,0,29,0.0,100.0,Male
GWENDAL,1967,8,0,8,0.0,100.0,Male
LUC,1967,1732,0,1732,0.0,100.0,Male
DOMINIQUE,1967,409989,168027,241962,40.98329467375954,59.01670532624046,Unisex
JEANNICK,1967,2091,1305,786,62.4103299856528,37.589670014347206,Unisex
JANNY,1967,1044,617,427,59.099616858237546,40.90038314176245,Unisex
CAMILLE,1967,287709,207732,79977,72.20212089298562,27.79787910701437,Unisex
YANICK,1967,3028,482,2546,15.918097754293262,84.08190224570674,Unisex
NICAISE,1967,1786,1255,531,70.26875699888018,29.73124300111982,Unisex
CAROL,1967,3507,2953,554,84.20302252637582,15.79697747362418,Unisex
_PRENOMS_RARES,1967,1760252,908578,851674,51.616359475802334,48.38364052419767,Unisex
ADDA,1967,397,209,188,52.64483627204031,47.3551637279597,Unisex
MARIE-BERNARD,1967,410,337,73,82.1951219512195,17.804878048780488,Unisex
PASQUALE,1967,585,144,441,24.615384615384617,75.38461538461539,Unisex
JANICK,1967,4109,2203,1906,53.61401800924799,46.38598199075201,Unisex
JANY,1967,3897,2256,1641,57.89068514241724,42.10931485758276,Unisex
JANNICK,1967,2792,1545,1247,55.336676217765046,44.66332378223496,Unisex
PEGUY,1967,277,234,43,84.47653429602889,15.52346570397112,Unisex
YANNE,1967,420,204,216,48.57142857142857,51.42857142857142,Unisex
GABY,1967,4741,2448,2293,51.63467622864375,48.36532377135626,Unisex
YAEL,1967,6161,3036,3125,49.27771465671157,50.72228534328843,Unisex
CLARENCE,1967,2943,924,2019,31.39653414882773,68.60346585117227,Unisex
ALIX,1967,37305,28371,8934,76.05146763168477,23.94853236831524,Unisex
HYACINTHE,1967,4679,1173,3506,25.069459286172258,74.93054071382774,Unisex
JOSY,1967,1021,840,181,82.27228207639568,17.72771792360431,Unisex
ARIEL,1967,2401,428,1973,17.8259058725531,82.17409412744689,Unisex
CALIXTE,1967,3347,540,2807,16.13385121003884,83.86614878996116,Unisex
DANY,1967,26027,7836,18191,30.10719637299728,69.89280362700273,Unisex
FRANCIANE,1968,43,43,0,100.0,0.0,Female
MARIE-MARTINE,1968,4,4,0,100.0,0.0,Female
MARIA-ISABELLE,1968,10,10,0,100.0,0.0,Female
RIKA,1968,4,4,0,100.0,0.0,Female
MARIA-TERESA,1968,21,21,0,100.0,0.0,Female
PRISCILLIA,1968,4,4,0,100.0,0.0,Female
INCARNATION,1968,11,11,0,100.0,0.0,Female
MARIE-ANNA,1968,3,3,0,100.0,0.0,Female
MARIE-SUZANNE,1968,6,6,0,100.0,0.0,Female
SANIA,1968,3,3,0,100.0,0.0,Female
CYPRIENNE,1968,4,4,0,100.0,0.0,Female
ANGELINE,1968,66,66,0,100.0,0.0,Female
MYRIAM,1968,99058,98878,180,99.81828827555572,0.1817117244442649,Female
ANNE,1968,364561,364227,334,99.9083829592304,0.0916170407695831,Female
SIGRIED,1968,3,3,0,100.0,0.0,Female
LISA,1968,31,31,0,100.0,0.0,Female
MERCEDES,1968,83,83,0,100.0,0.0,Female
CLÉMENCE,1968,35,35,0,100.0,0.0,Female
AUGUSTA,1968,7,7,0,100.0,0.0,Female
MARIE-LYSE,1968,6,6,0,100.0,0.0,Female
SUZELLE,1968,21,21,0,100.0,0.0,Female
JOCELYNE,1968,925,925,0,100.0,0.0,Female
GINESA,1968,4,4,0,100.0,0.0,Female
ELYSABETH,1968,4,4,0,100.0,0.0,Female
NADRA,1968,4,4,0,100.0,0.0,Female
SANDRINO,1968,3,0,3,0.0,100.0,Male
ABDOU,1968,4,0,4,0.0,100.0,Male
ROCH,1968,24,0,24,0.0,100.0,Male
HASSEIN,1968,4,0,4,0.0,100.0,Male
SMAEL,1968,5,0,5,0.0,100.0,Male
MOUNIR,1968,38,0,38,0.0,100.0,Male
THIERRY,1968,13182,0,13182,0.0,100.0,Male
GWENAEL,1968,8337,596,7741,7.148854504018232,92.85114549598175,Male
NADJIM,1968,3,0,3,0.0,100.0,Male
GUY,1968,1331,0,1331,0.0,100.0,Male
SAADI,1968,6,0,6,0.0,100.0,Male
ANTONIO,1968,826,0,826,0.0,100.0,Male
REDHA,1968,4,0,4,0.0,100.0,Male
NOREDDINE,1968,5,0,5,0.0,100.0,Male
GIOVANNI,1968,134,0,134,0.0,100.0,Male
DANTE,1968,3,0,3,0.0,100.0,Male
SYLVANO,1968,4,0,4,0.0,100.0,Male
CLAUDIO,1968,53,0,53,0.0,100.0,Male
ABDELLAH,1968,15,0,15,0.0,100.0,Male
JUDES,1968,8,0,8,0.0,100.0,Male
RENZO,1968,3,0,3,0.0,100.0,Male
MAHMOUD,1968,17,0,17,0.0,100.0,Male
AZDIN,1968,3,0,3,0.0,100.0,Male
MOUSSA,1968,53,0,53,0.0,100.0,Male
VICTORIO,1968,4,0,4,0.0,100.0,Male
MALLORY,1968,2883,2151,732,74.60978147762746,25.390218522372525,Unisex
GEORGE,1968,2417,650,1767,26.89284236657013,73.10715763342988,Unisex
KIM,1968,6518,5270,1248,80.85302239950906,19.146977600490946,Unisex
THANH,1968,630,259,371,41.11111111111111,58.88888888888889,Unisex
_PRENOMS_RARES,1968,1760252,908578,851674,51.616359475802334,48.38364052419767,Unisex
MARIE-JEAN,1968,143,73,70,51.048951048951054,48.95104895104895,Unisex
SAADA,1968,232,167,65,71.98275862068965,28.01724137931034,Unisex
ARIEL,1968,2401,428,1973,17.8259058725531,82.17409412744689,Unisex
JEANNICK,1968,2091,1305,786,62.4103299856528,37.589670014347206,Unisex
JEANICK,1968,322,126,196,39.130434782608695,60.86956521739131,Unisex
CLARENCE,1968,2943,924,2019,31.39653414882773,68.60346585117227,Unisex
PASQUALE,1968,585,144,441,24.615384615384617,75.38461538461539,Unisex
JANY,1968,3897,2256,1641,57.89068514241724,42.10931485758276,Unisex
IRENEE,1968,6155,1854,4301,30.121852152721363,69.87814784727864,Unisex
YAEL,1968,6161,3036,3125,49.27771465671157,50.72228534328843,Unisex
JANIK,1968,500,287,213,57.4,42.6,Unisex
DANY,1968,26027,7836,18191,30.10719637299728,69.89280362700273,Unisex
JANNICK,1968,2792,1545,1247,55.336676217765046,44.66332378223496,Unisex
CAROL,1968,3507,2953,554,84.20302252637582,15.79697747362418,Unisex
YANNE,1968,420,204,216,48.57142857142857,51.42857142857142,Unisex
BENILDE,1968,78,40,38,51.28205128205128,48.71794871794872,Unisex
JOSY,1968,1021,840,181,82.27228207639568,17.72771792360431,Unisex
ROSARIO,1968,1546,781,765,50.51746442432082,49.48253557567917,Unisex
DOMINIQUE,1968,409989,168027,241962,40.98329467375954,59.01670532624046,Unisex
NICAISE,1968,1786,1255,531,70.26875699888018,29.73124300111982,Unisex
FATMA,1969,138,138,0,100.0,0.0,Female
AMARA,1969,20,20,0,100.0,0.0,Female
TATJANA,1969,4,4,0,100.0,0.0,Female
SILVINA,1969,6,6,0,100.0,0.0,Female
MIRELLA,1969,65,65,0,100.0,0.0,Female
ANISSA,1969,17,17,0,100.0,0.0,Female
MARIE-GAELLE,1969,6,6,0,100.0,0.0,Female
STEPHANIA,1969,9,9,0,100.0,0.0,Female
LAETITIA,1969,1021,1021,0,100.0,0.0,Female
ROSA,1969,176,176,0,100.0,0.0,Female
ARIELE,1969,7,7,0,100.0,0.0,Female
MONETTE,1969,9,9,0,100.0,0.0,Female
MARIE-ANTOINETTE,1969,54,54,0,100.0,0.0,Female
KHADIJA,1969,30,30,0,100.0,0.0,Female
LAURE-EMMANUELLE,1969,3,3,0,100.0,0.0,Female
CHRISTEL,1969,21700,21223,477,97.80184331797234,2.19815668202765,Female
BENEDICT,1969,4,4,0,100.0,0.0,Female
SIBYL,1969,3,3,0,100.0,0.0,Female
SERGINE,1969,25,25,0,100.0,0.0,Female
KARYNE,1969,9,9,0,100.0,0.0,Female
MARIE-ROSE,1969,99,99,0,100.0,0.0,Female
MARYAM,1969,7,7,0,100.0,0.0,Female
SORIA,1969,13,13,0,100.0,0.0,Female
EMANUELA,1969,8,8,0,100.0,0.0,Female
AKIMA,1969,27,27,0,100.0,0.0,Female
ALBERIC,1969,10,0,10,0.0,100.0,Male
LUIGI,1969,52,0,52,0.0,100.0,Male
LYSIAN,1969,6,0,6,0.0,100.0,Male
JEAN-GUILLAUME,1969,14,0,14,0.0,100.0,Male
YOUCEF,1969,72,0,72,0.0,100.0,Male
OURI,1969,3,0,3,0.0,100.0,Male
NOURDDINE,1969,3,0,3,0.0,100.0,Male
CAMILO,1969,6,0,6,0.0,100.0,Male
YACINE,1969,29,0,29,0.0,100.0,Male
YVES-MICHEL,1969,5,0,5,0.0,100.0,Male
JEHAN,1969,5,0,5,0.0,100.0,Male
GASTON,1969,35,0,35,0.0,100.0,Male
MARCELLO,1969,5,0,5,0.0,100.0,Male
TANNEGUY,1969,6,0,6,0.0,100.0,Male
RAOUF,1969,6,0,6,0.0,100.0,Male
ARNAULD,1969,60,0,60,0.0,100.0,Male
JOSELITO,1969,25,0,25,0.0,100.0,Male
ABDESSELEM,1969,3,0,3,0.0,100.0,Male
EMILIANO,1969,5,0,5,0.0,100.0,Male
BERNARDINO,1969,5,0,5,0.0,100.0,Male
DENYS,1969,17,0,17,0.0,100.0,Male
FRÉDÉRIK,1969,7,0,7,0.0,100.0,Male
ISSA,1969,4,0,4,0.0,100.0,Male
ABDELKRIME,1969,3,0,3,0.0,100.0,Male
THÉO,1969,6,0,6,0.0,100.0,Male
ALIX,1969,37305,28371,8934,76.05146763168477,23.94853236831524,Unisex
CLAUDY,1969,2240,835,1405,37.27678571428572,62.72321428571429,Unisex
HYACINTHE,1969,4679,1173,3506,25.069459286172258,74.93054071382774,Unisex
DANY,1969,26027,7836,18191,30.10719637299728,69.89280362700273,Unisex
JANIK,1969,500,287,213,57.4,42.6,Unisex
GEORGE,1969,2417,650,1767,26.89284236657013,73.10715763342988,Unisex
YANNE,1969,420,204,216,48.57142857142857,51.42857142857142,Unisex
CYRILE,1969,240,38,202,15.833333333333332,84.16666666666667,Unisex
JEANNY,1969,968,718,250,74.17355371900827,25.82644628099173,Unisex
ROSARIO,1969,1546,781,765,50.51746442432082,49.48253557567917,Unisex
DOMINIQUE,1969,409989,168027,241962,40.98329467375954,59.01670532624046,Unisex
YANICK,1969,3028,482,2546,15.918097754293262,84.08190224570674,Unisex
SERVAIS,1969,812,150,662,18.47290640394089,81.5270935960591,Unisex
_PRENOMS_RARES,1969,1760252,908578,851674,51.616359475802334,48.38364052419767,Unisex
JANY,1969,3897,2256,1641,57.89068514241724,42.10931485758276,Unisex
YANNIC,1969,671,104,567,15.499254843517138,84.50074515648286,Unisex
ANGE-MARIE,1969,650,290,360,44.61538461538462,55.38461538461539,Unisex
JOSY,1969,1021,840,181,82.27228207639568,17.72771792360431,Unisex
CAMILLE,1969,287709,207732,79977,72.20212089298562,27.79787910701437,Unisex
YANIK,1969,330,50,280,15.151515151515152,84.84848484848484,Unisex
CAROL,1969,3507,2953,554,84.20302252637582,15.79697747362418,Unisex
GABY,1969,4741,2448,2293,51.63467622864375,48.36532377135626,Unisex
KAREL,1969,1060,233,827,21.9811320754717,78.01886792452831,Unisex
JEANNICK,1969,2091,1305,786,62.4103299856528,37.589670014347206,Unisex
JANICK,1969,4109,2203,1906,53.61401800924799,46.38598199075201,Unisex
QUETTY,1970,4,4,0,100.0,0.0,Female
ZARA,1970,3,3,0,100.0,0.0,Female
CHANTAL,1970,1693,1693,0,100.0,0.0,Female
VALENTINE,1970,64,64,0,100.0,0.0,Female
PRISCILLA,1970,26,26,0,100.0,0.0,Female
VANNINA,1970,14,14,0,100.0,0.0,Female
SELMA,1970,7,7,0,100.0,0.0,Female
CARMELA,1970,36,36,0,100.0,0.0,Female
MARIE-MICHELLE,1970,17,17,0,100.0,0.0,Female
AUGUSTINE,1970,9,9,0,100.0,0.0,Female
MARIA-HELENA,1970,30,30,0,100.0,0.0,Female
CATHELINE,1970,3,3,0,100.0,0.0,Female
ANNELYSE,1970,9,9,0,100.0,0.0,Female
BETSY,1970,3,3,0,100.0,0.0,Female
MILOUDA,1970,7,7,0,100.0,0.0,Female
DJAMELA,1970,4,4,0,100.0,0.0,Female
REMEDIOS,1970,4,4,0,100.0,0.0,Female
KATHIE,1970,10,10,0,100.0,0.0,Female
GLADYS,1970,125,125,0,100.0,0.0,Female
MADELY,1970,3,3,0,100.0,0.0,Female
CRISTINA,1970,112,112,0,100.0,0.0,Female
DJAMILAH,1970,3,3,0,100.0,0.0,Female
MARCIA,1970,4,4,0,100.0,0.0,Female
ASSOMPTION,1970,4,4,0,100.0,0.0,Female
ANGÈLE,1970,100,100,0,100.0,0.0,Female
MAHER,1970,4,0,4,0.0,100.0,Male
ANDREW,1970,5,0,5,0.0,100.0,Male
GEORGES,1970,405954,611,405343,0.1505096636564734,99.84949033634352,Male
BOUCIF,1970,8,0,8,0.0,100.0,Male
GREGORIO,1970,11,0,11,0.0,100.0,Male
BERTE,1970,3,0,3,0.0,100.0,Male
AMERICO,1970,14,0,14,0.0,100.0,Male
ROLAND,1970,389,0,389,0.0,100.0,Male
DJIMMY,1970,4,0,4,0.0,100.0,Male
JACQUELIN,1970,3,0,3,0.0,100.0,Male
JHONNY,1970,14,0,14,0.0,100.0,Male
JEAN-VALERE,1970,3,0,3,0.0,100.0,Male
WILL,1970,3,0,3,0.0,100.0,Male
HERALD,1970,6,0,6,0.0,100.0,Male
EVARISTE,1970,10,0,10,0.0,100.0,Male
JOAQUIN,1970,30,0,30,0.0,100.0,Male
IANNIS,1970,3,0,3,0.0,100.0,Male
CATALDO,1970,3,0,3,0.0,100.0,Male
BASTIEN,1970,22,0,22,0.0,100.0,Male
ARNOLD,1970,33,0,33,0.0,100.0,Male
MICHAËL,1970,168,0,168,0.0,100.0,Male
CLEMENTE,1970,3,0,3,0.0,100.0,Male
MUSTAPHA,1970,222,0,222,0.0,100.0,Male
ZAHIR,1970,4,0,4,0.0,100.0,Male
OUASSINI,1970,6,0,6,0.0,100.0,Male
CYRILE,1970,240,38,202,15.833333333333332,84.16666666666667,Unisex
HYACINTHE,1970,4679,1173,3506,25.069459286172258,74.93054071382774,Unisex
ROSARIO,1970,1546,781,765,50.51746442432082,49.48253557567917,Unisex
MARIE-BERNARD,1970,410,337,73,82.1951219512195,17.804878048780488,Unisex
PEGUY,1970,277,234,43,84.47653429602889,15.52346570397112,Unisex
JANNICK,1970,2792,1545,1247,55.336676217765046,44.66332378223496,Unisex
ARIEL,1970,2401,428,1973,17.8259058725531,82.17409412744689,Unisex
GEORGIE,1970,255,164,91,64.31372549019608,35.68627450980392,Unisex
YANICK,1970,3028,482,2546,15.918097754293262,84.08190224570674,Unisex
JEANNICK,1970,2091,1305,786,62.4103299856528,37.589670014347206,Unisex
CAROL,1970,3507,2953,554,84.20302252637582,15.79697747362418,Unisex
HAMIDA,1970,759,628,131,82.74044795783925,17.25955204216074,Unisex
KAROL,1970,450,114,336,25.333333333333336,74.66666666666667,Unisex
ALIX,1970,37305,28371,8934,76.05146763168477,23.94853236831524,Unisex
FRANCKIE,1970,483,73,410,15.113871635610764,84.88612836438924,Unisex
_PRENOMS_RARES,1970,1760252,908578,851674,51.616359475802334,48.38364052419767,Unisex
GREGORIE,1970,211,32,179,15.165876777251183,84.83412322274881,Unisex
CAMILLE,1970,287709,207732,79977,72.20212089298562,27.79787910701437,Unisex
GEORGE,1970,2417,650,1767,26.89284236657013,73.10715763342988,Unisex
NADY,1970,313,246,67,78.59424920127796,21.40575079872205,Unisex
JANY,1970,3897,2256,1641,57.89068514241724,42.10931485758276,Unisex
DOMINIQUE,1970,409989,168027,241962,40.98329467375954,59.01670532624046,Unisex
MARY,1970,6861,5830,1031,84.97303600058301,15.026963999416996,Unisex
JESSY,1970,17091,3993,13098,23.363173600140424,76.63682639985957,Unisex
DANNY,1970,3396,610,2786,17.962308598351,82.037691401649,Unisex
LUCILLA,1971,3,3,0,100.0,0.0,Female
KATHLEEN,1971,15,15,0,100.0,0.0,Female
MARIETTA,1971,16,16,0,100.0,0.0,Female
PERRINE,1971,55,55,0,100.0,0.0,Female
CARMEN,1971,217,217,0,100.0,0.0,Female
LAURÈNE,1971,5,5,0,100.0,0.0,Female
SALIRA,1971,4,4,0,100.0,0.0,Female
LUCILLE,1971,6,6,0,100.0,0.0,Female
NOEMIE,1971,26,26,0,100.0,0.0,Female
KAOUTHAR,1971,3,3,0,100.0,0.0,Female
MARIE-SABRINA,1971,3,3,0,100.0,0.0,Female
IVANA,1971,8,8,0,100.0,0.0,Female
HOURYA,1971,3,3,0,100.0,0.0,Female
LILIANNE,1971,3,3,0,100.0,0.0,Female
CHRISLINE,1971,3,3,0,100.0,0.0,Female
SOUHAD,1971,10,10,0,100.0,0.0,Female
MARILYNE,1971,332,332,0,100.0,0.0,Female
MERIAM,1971,12,12,0,100.0,0.0,Female
PAULETTE,1971,53,53,0,100.0,0.0,Female
ANNE-MICHÈLE,1971,5,5,0,100.0,0.0,Female
SOAD,1971,5,5,0,100.0,0.0,Female
KARÈNE,1971,4,4,0,100.0,0.0,Female
DJEMILLA,1971,5,5,0,100.0,0.0,Female
SILVIE,1971,8,8,0,100.0,0.0,Female
MARIA-FATIMA,1971,25,25,0,100.0,0.0,Female
RACHIDE,1971,12,0,12,0.0,100.0,Male
RAMUNTCHO,1971,10,0,10,0.0,100.0,Male
PETERS,1971,3,0,3,0.0,100.0,Male
TUGDUAL,1971,5,0,5,0.0,100.0,Male
ALBAN,1971,207,0,207,0.0,100.0,Male
STAN,1971,3,0,3,0.0,100.0,Male
NORBERTO,1971,9,0,9,0.0,100.0,Male
WILLY,1971,631,0,631,0.0,100.0,Male
PIERRE-LOÏC,1971,3,0,3,0.0,100.0,Male
BASILE,1971,11,0,11,0.0,100.0,Male
DONATO,1971,10,0,10,0.0,100.0,Male
DINIS,1971,6,0,6,0.0,100.0,Male
ANDY,1971,6,0,6,0.0,100.0,Male
ERICO,1971,4,0,4,0.0,100.0,Male
PHILIP,1971,18,0,18,0.0,100.0,Male
PAUL-ANTOINE,1971,5,0,5,0.0,100.0,Male
ABDESLAM,1971,6,0,6,0.0,100.0,Male
FRANCO,1971,33,0,33,0.0,100.0,Male
JEREMY,1971,64,0,64,0.0,100.0,Male
ILARIO,1971,5,0,5,0.0,100.0,Male
WLADIMIR,1971,9,0,9,0.0,100.0,Male
CÉSAR,1971,3,0,3,0.0,100.0,Male
RENAN,1971,39,0,39,0.0,100.0,Male
ALCINO,1971,5,0,5,0.0,100.0,Male
MANSOUR,1971,12,0,12,0.0,100.0,Male
VANIA,1971,402,316,86,78.60696517412936,21.393034825870647,Unisex
MARIE-JOSEPH,1971,2275,1830,445,80.43956043956044,19.56043956043956,Unisex
CYRILE,1971,240,38,202,15.833333333333332,84.16666666666667,Unisex
PASQUALE,1971,585,144,441,24.615384615384617,75.38461538461539,Unisex
KIM,1971,6518,5270,1248,80.85302239950906,19.146977600490946,Unisex
CLARENCE,1971,2943,924,2019,31.39653414882773,68.60346585117227,Unisex
ARIEL,1971,2401,428,1973,17.8259058725531,82.17409412744689,Unisex
YANICK,1971,3028,482,2546,15.918097754293262,84.08190224570674,Unisex
JOHANE,1971,818,633,185,77.3838630806846,22.6161369193154,Unisex
CAMILLE,1971,287709,207732,79977,72.20212089298562,27.79787910701437,Unisex
HAMIDA,1971,759,628,131,82.74044795783925,17.25955204216074,Unisex
JANNICK,1971,2792,1545,1247,55.336676217765046,44.66332378223496,Unisex
NICAISE,1971,1786,1255,531,70.26875699888018,29.73124300111982,Unisex
IRENEE,1971,6155,1854,4301,30.121852152721363,69.87814784727864,Unisex
JESSY,1971,17091,3993,13098,23.363173600140424,76.63682639985957,Unisex
GEORGE,1971,2417,650,1767,26.89284236657013,73.10715763342988,Unisex
_PRENOMS_RARES,1971,1760252,908578,851674,51.616359475802334,48.38364052419767,Unisex
FRANCKIE,1971,483,73,410,15.113871635610764,84.88612836438924,Unisex
GWEN,1971,941,419,522,44.52709883103082,55.47290116896918,Unisex
HYACINTHE,1971,4679,1173,3506,25.069459286172258,74.93054071382774,Unisex
ROSARIO,1971,1546,781,765,50.51746442432082,49.48253557567917,Unisex
YAEL,1971,6161,3036,3125,49.27771465671157,50.72228534328843,Unisex
GWENN,1971,1848,1201,647,64.98917748917748,35.01082251082251,Unisex
JANICK,1971,4109,2203,1906,53.61401800924799,46.38598199075201,Unisex
JEANNICK,1971,2091,1305,786,62.4103299856528,37.589670014347206,Unisex
LIDIJA,1972,3,3,0,100.0,0.0,Female
OLIVERA,1972,11,11,0,100.0,0.0,Female
KATJA,1972,6,6,0,100.0,0.0,Female
JULIANE,1972,11,11,0,100.0,0.0,Female
EDITE,1972,7,7,0,100.0,0.0,Female
GORETTE,1972,7,7,0,100.0,0.0,Female
FANJA,1972,4,4,0,100.0,0.0,Female
MARJORY,1972,14,14,0,100.0,0.0,Female
DORKA,1972,3,3,0,100.0,0.0,Female
MARIE-RÉGINE,1972,3,3,0,100.0,0.0,Female
NAGETE,1972,3,3,0,100.0,0.0,Female
PETRA,1972,5,5,0,100.0,0.0,Female
BLANCHE,1972,30,30,0,100.0,0.0,Female
GUENAELE,1972,8,8,0,100.0,0.0,Female
GIULIA,1972,4,4,0,100.0,0.0,Female
MARIE-AUDE,1972,50,50,0,100.0,0.0,Female
VIRGINIE,1972,5292,5292,0,100.0,0.0,Female
MAYLIS,1972,35,35,0,100.0,0.0,Female
VERENE,1972,5,5,0,100.0,0.0,Female
ELENA,1972,44,44,0,100.0,0.0,Female
MELAINE,1972,7,7,0,100.0,0.0,Female
EMILIA,1972,60,60,0,100.0,0.0,Female
KADIDJA,1972,5,5,0,100.0,0.0,Female
HACINA,1972,10,10,0,100.0,0.0,Female
KARELLE,1972,55,55,0,100.0,0.0,Female
THEOPHILE,1972,6,0,6,0.0,100.0,Male
CLOVIS,1972,22,0,22,0.0,100.0,Male
ADERITO,1972,12,0,12,0.0,100.0,Male
JULIAN,1972,26,0,26,0.0,100.0,Male
PAQUITO,1972,4,0,4,0.0,100.0,Male
GASTON,1972,32,0,32,0.0,100.0,Male
ERICK,1972,101,0,101,0.0,100.0,Male
JOSSE,1972,3,0,3,0.0,100.0,Male
NAJIB,1972,18,0,18,0.0,100.0,Male
CHEICK,1972,3,0,3,0.0,100.0,Male
GUY-ANDRÉ,1972,5,0,5,0.0,100.0,Male
JOBY,1972,4,0,4,0.0,100.0,Male
AVNER,1972,3,0,3,0.0,100.0,Male
GERMINAL,1972,7,0,7,0.0,100.0,Male
CHOUKRI,1972,15,0,15,0.0,100.0,Male
ACACIO,1972,6,0,6,0.0,100.0,Male
ABDOUL,1972,4,0,4,0.0,100.0,Male
NATHAN,1972,6,0,6,0.0,100.0,Male
ALLEL,1972,3,0,3,0.0,100.0,Male
ANTAR,1972,6,0,6,0.0,100.0,Male
JEAN-ANTOINE,1972,8,0,8,0.0,100.0,Male
GIANFRANCO,1972,3,0,3,0.0,100.0,Male
JOHN,1972,400,0,400,0.0,100.0,Male
JEHAN,1972,5,0,5,0.0,100.0,Male
CASIMIRO,1972,5,0,5,0.0,100.0,Male
CLARENCE,1972,2943,924,2019,31.39653414882773,68.60346585117227,Unisex
ANGE-MARIE,1972,650,290,360,44.61538461538462,55.38461538461539,Unisex
JANNICK,1972,2792,1545,1247,55.336676217765046,44.66332378223496,Unisex
FRANCKIE,1972,483,73,410,15.113871635610764,84.88612836438924,Unisex
GWENN,1972,1848,1201,647,64.98917748917748,35.01082251082251,Unisex
DOMINIQUE,1972,409989,168027,241962,40.98329467375954,59.01670532624046,Unisex
VANIA,1972,402,316,86,78.60696517412936,21.393034825870647,Unisex
KIM,1972,6518,5270,1248,80.85302239950906,19.146977600490946,Unisex
YAEL,1972,6161,3036,3125,49.27771465671157,50.72228534328843,Unisex
JANY,1972,3897,2256,1641,57.89068514241724,42.10931485758276,Unisex
JANICK,1972,4109,2203,1906,53.61401800924799,46.38598199075201,Unisex
CAMILLE,1972,287709,207732,79977,72.20212089298562,27.79787910701437,Unisex
GREGORIE,1972,211,32,179,15.165876777251183,84.83412322274881,Unisex
ROSARIO,1972,1546,781,765,50.51746442432082,49.48253557567917,Unisex
JOHANE,1972,818,633,185,77.3838630806846,22.6161369193154,Unisex
MODESTE,1972,1853,656,1197,35.4020507285483,64.59794927145171,Unisex
HAMIDA,1972,759,628,131,82.74044795783925,17.25955204216074,Unisex
LOÏS,1972,11236,3416,7820,30.40227839088644,69.59772160911356,Unisex
KAREL,1972,1060,233,827,21.9811320754717,78.01886792452831,Unisex
DANY,1972,26027,7836,18191,30.10719637299728,69.89280362700273,Unisex
YANNE,1972,420,204,216,48.57142857142857,51.42857142857142,Unisex
JESSY,1972,17091,3993,13098,23.363173600140424,76.63682639985957,Unisex
CAROL,1972,3507,2953,554,84.20302252637582,15.79697747362418,Unisex
HYACINTHE,1972,4679,1173,3506,25.069459286172258,74.93054071382774,Unisex
YANICK,1972,3028,482,2546,15.918097754293262,84.08190224570674,Unisex
MELYNDA,1973,6,6,0,100.0,0.0,Female
SMINA,1973,3,3,0,100.0,0.0,Female
ANGÈLIQUE,1973,3,3,0,100.0,0.0,Female
ANOUK,1973,50,50,0,100.0,0.0,Female
ROSINA,1973,4,4,0,100.0,0.0,Female
NADIA,1973,2466,2466,0,100.0,0.0,Female
ADELINA,1973,12,12,0,100.0,0.0,Female
SUZANA,1973,25,25,0,100.0,0.0,Female
LOETICIA,1973,4,4,0,100.0,0.0,Female
MARIE-DENISE,1973,3,3,0,100.0,0.0,Female
PHILIPPA,1973,5,5,0,100.0,0.0,Female
MARI,1973,9,9,0,100.0,0.0,Female
AZIZA,1973,40,40,0,100.0,0.0,Female
SONYA,1973,11,11,0,100.0,0.0,Female
JEMILA,1973,4,4,0,100.0,0.0,Female
ANGÈLE,1973,97,97,0,100.0,0.0,Female
AUGUSTA,1973,8,8,0,100.0,0.0,Female
LINE,1973,137,137,0,100.0,0.0,Female
SARHA,1973,9,9,0,100.0,0.0,Female
MYRIAM,1973,2287,2287,0,100.0,0.0,Female
ELEONORE,1973,83,83,0,100.0,0.0,Female
NAGETTE,1973,6,6,0,100.0,0.0,Female
EULALIA,1973,7,7,0,100.0,0.0,Female
ZAKIA,1973,51,51,0,100.0,0.0,Female
LOËTITIA,1973,7,7,0,100.0,0.0,Female
KEN,1973,5,0,5,0.0,100.0,Male
JEAN-CHRISTIAN,1973,39,0,39,0.0,100.0,Male
JEAN-DIDIER,1973,8,0,8,0.0,100.0,Male
NGUYEN,1973,3,0,3,0.0,100.0,Male
MARYAN,1973,3,0,3,0.0,100.0,Male
ROLANDO,1973,4,0,4,0.0,100.0,Male
TOUFIK,1973,46,0,46,0.0,100.0,Male
TARIQ,1973,3,0,3,0.0,100.0,Male
ADAM,1973,29,0,29,0.0,100.0,Male
ALBAN,1973,342,0,342,0.0,100.0,Male
BOUBACAR,1973,5,0,5,0.0,100.0,Male
LUGUY,1973,3,0,3,0.0,100.0,Male
GUY-NOËL,1973,4,0,4,0.0,100.0,Male
HICHEM,1973,18,0,18,0.0,100.0,Male
JIM,1973,40,0,40,0.0,100.0,Male
ANGÉLO,1973,3,0,3,0.0,100.0,Male
ERIC,1973,9795,0,9795,0.0,100.0,Male
ANIELLO,1973,3,0,3,0.0,100.0,Male
BRIAC,1973,3,0,3,0.0,100.0,Male
JOFFREY,1973,61,0,61,0.0,100.0,Male
RÉDA,1973,3,0,3,0.0,100.0,Male
HENRYK,1973,3,0,3,0.0,100.0,Male
TOM,1973,7,0,7,0.0,100.0,Male
ISRAEL,1973,4,0,4,0.0,100.0,Male
JEAN-FRANCIS,1973,10,0,10,0.0,100.0,Male
LENAICK,1973,695,402,293,57.84172661870504,42.15827338129496,Unisex
GANAEL,1973,163,33,130,20.245398773006134,79.75460122699386,Unisex
HYACINTHE,1973,4679,1173,3506,25.069459286172258,74.93054071382774,Unisex
YAEL,1973,6161,3036,3125,49.27771465671157,50.72228534328843,Unisex
JEANNICK,1973,2091,1305,786,62.4103299856528,37.589670014347206,Unisex
CLAUDY,1973,2240,835,1405,37.27678571428572,62.72321428571429,Unisex
MALORY,1973,2305,1892,413,82.08242950108459,17.9175704989154,Unisex
HAMIDA,1973,759,628,131,82.74044795783925,17.25955204216074,Unisex
GABY,1973,4741,2448,2293,51.63467622864375,48.36532377135626,Unisex
JANNY,1973,1044,617,427,59.099616858237546,40.90038314176245,Unisex
EMANUELE,1973,160,40,120,25.0,75.0,Unisex
LENAIK,1973,280,203,77,72.5,27.500000000000004,Unisex
JANIK,1973,500,287,213,57.4,42.6,Unisex
GILLIAN,1973,947,327,620,34.53009503695882,65.46990496304119,Unisex
VANIA,1973,402,316,86,78.60696517412936,21.393034825870647,Unisex
DANNY,1973,3396,610,2786,17.962308598351,82.037691401649,Unisex
YANNE,1973,420,204,216,48.57142857142857,51.42857142857142,Unisex
JANICK,1973,4109,2203,1906,53.61401800924799,46.38598199075201,Unisex
YANICK,1973,3028,482,2546,15.918097754293262,84.08190224570674,Unisex
DOMINIQUE,1973,409989,168027,241962,40.98329467375954,59.01670532624046,Unisex
ROSARIO,1973,1546,781,765,50.51746442432082,49.48253557567917,Unisex
MINH,1973,738,185,553,25.067750677506773,74.93224932249322,Unisex
PEGUY,1973,277,234,43,84.47653429602889,15.52346570397112,Unisex
JESSY,1973,17091,3993,13098,23.363173600140424,76.63682639985957,Unisex
GREGORIE,1973,211,32,179,15.165876777251183,84.83412322274881,Unisex
CLOE,1974,4,4,0,100.0,0.0,Female
FANNIE,1974,8,8,0,100.0,0.0,Female
ANNE-THÉRÈSE,1974,5,5,0,100.0,0.0,Female
ELVIRE,1974,37,37,0,100.0,0.0,Female
SHEHERAZADE,1974,21,21,0,100.0,0.0,Female
AWATEF,1974,4,4,0,100.0,0.0,Female
SUZEL,1974,14,14,0,100.0,0.0,Female
JOSEPHE,1974,4,4,0,100.0,0.0,Female
MARIE-SOPHIE,1974,49,49,0,100.0,0.0,Female
LAUREEN,1974,9,9,0,100.0,0.0,Female
ZOUINA,1974,14,14,0,100.0,0.0,Female
ANNE-JOSEE,1974,3,3,0,100.0,0.0,Female
HANENE,1974,5,5,0,100.0,0.0,Female
MILLY,1974,3,3,0,100.0,0.0,Female
SALOMÉ,1974,7,7,0,100.0,0.0,Female
MARIA-FERNANDA,1974,5,5,0,100.0,0.0,Female
STELLA-MARIA,1974,4,4,0,100.0,0.0,Female
MAUREEN,1974,20,20,0,100.0,0.0,Female
MARLISE,1974,4,4,0,100.0,0.0,Female
VITTORIA,1974,4,4,0,100.0,0.0,Female
JOSEFA,1974,24,24,0,100.0,0.0,Female
SEVGI,1974,8,8,0,100.0,0.0,Female
GRAZIELLA,1974,187,187,0,100.0,0.0,Female
SAFIYA,1974,4,4,0,100.0,0.0,Female
ANAÏS,1974,42,42,0,100.0,0.0,Female
HATIM,1974,4,0,4,0.0,100.0,Male
OCTAVIO,1974,6,0,6,0.0,100.0,Male
ANTHONY,1974,1954,0,1954,0.0,100.0,Male
FILIP,1974,8,0,8,0.0,100.0,Male
CHAFI,1974,3,0,3,0.0,100.0,Male
ARMENIO,1974,8,0,8,0.0,100.0,Male
KADIR,1974,8,0,8,0.0,100.0,Male
THIEBAULT,1974,3,0,3,0.0,100.0,Male
YVANN,1974,3,0,3,0.0,100.0,Male
OLLIVIER,1974,37,0,37,0.0,100.0,Male
SALAH,1974,83,0,83,0.0,100.0,Male
LOIG,1974,13,0,13,0.0,100.0,Male
ABDELJALIL,1974,5,0,5,0.0,100.0,Male
SABAR,1974,3,0,3,0.0,100.0,Male
ARMANDO,1974,40,0,40,0.0,100.0,Male
JEAN-JOSÉ,1974,9,0,9,0.0,100.0,Male
THEOPHILE,1974,6,0,6,0.0,100.0,Male
YASSER,1974,6,0,6,0.0,100.0,Male
VALDEMAR,1974,4,0,4,0.0,100.0,Male
GEORGET,1974,7,0,7,0.0,100.0,Male
KARL,1974,255,0,255,0.0,100.0,Male
STEFAN,1974,60,0,60,0.0,100.0,Male
CHARLES-ALBERT,1974,3,0,3,0.0,100.0,Male
MEDDY,1974,6,0,6,0.0,100.0,Male
RICHARD,1974,1577,0,1577,0.0,100.0,Male
MERRY,1974,368,220,148,59.78260869565217,40.21739130434783,Unisex
JOSY,1974,1021,840,181,82.27228207639568,17.72771792360431,Unisex
GWENN,1974,1848,1201,647,64.98917748917748,35.01082251082251,Unisex
ALIX,1974,37305,28371,8934,76.05146763168477,23.94853236831524,Unisex
GILLIAN,1974,947,327,620,34.53009503695882,65.46990496304119,Unisex
GWEN,1974,941,419,522,44.52709883103082,55.47290116896918,Unisex
SANTIANA,1974,108,73,35,67.5925925925926,32.407407407407405,Unisex
ADDA,1974,397,209,188,52.64483627204031,47.3551637279597,Unisex
JEANNICK,1974,2091,1305,786,62.4103299856528,37.589670014347206,Unisex
GABY,1974,4741,2448,2293,51.63467622864375,48.36532377135626,Unisex
KAREL,1974,1060,233,827,21.9811320754717,78.01886792452831,Unisex
CLAUDY,1974,2240,835,1405,37.27678571428572,62.72321428571429,Unisex
HYACINTHE,1974,4679,1173,3506,25.069459286172258,74.93054071382774,Unisex
ROSARIO,1974,1546,781,765,50.51746442432082,49.48253557567917,Unisex
JOHANE,1974,818,633,185,77.3838630806846,22.6161369193154,Unisex
CHARLIE,1974,30211,15480,14731,51.23961470987389,48.76038529012611,Unisex
PEGGUY,1974,124,102,22,82.25806451612904,17.741935483870968,Unisex
KIM,1974,6518,5270,1248,80.85302239950906,19.146977600490946,Unisex
JESSY,1974,17091,3993,13098,23.363173600140424,76.63682639985957,Unisex
GEORGE,1974,2417,650,1767,26.89284236657013,73.10715763342988,Unisex
AMARA,1974,1568,601,967,38.329081632653065,61.670918367346935,Unisex
VANIA,1974,402,316,86,78.60696517412936,21.393034825870647,Unisex
HAMIDA,1974,759,628,131,82.74044795783925,17.25955204216074,Unisex
JANICK,1974,4109,2203,1906,53.61401800924799,46.38598199075201,Unisex
ANGE-MARIE,1974,650,290,360,44.61538461538462,55.38461538461539,Unisex
CASILDA,1975,3,3,0,100.0,0.0,Female
BETTY,1975,503,503,0,100.0,0.0,Female
ARNAUDE,1975,4,4,0,100.0,0.0,Female
BARKA,1975,5,5,0,100.0,0.0,Female
GHARIBA,1975,10,10,0,100.0,0.0,Female
GWENNAËLLE,1975,5,5,0,100.0,0.0,Female
AMBRE,1975,20,20,0,100.0,0.0,Female
AUDE,1975,31602,31480,122,99.61394848427317,0.3860515157268527,Female
LEILLA,1975,6,6,0,100.0,0.0,Female
KAWTAR,1975,3,3,0,100.0,0.0,Female
ELISABETTE,1975,6,6,0,100.0,0.0,Female
EVE-MARIE,1975,9,9,0,100.0,0.0,Female
RÉGINA,1975,4,4,0,100.0,0.0,Female
YVETTE,1975,40,40,0,100.0,0.0,Female
KAOUTHAR,1975,5,5,0,100.0,0.0,Female
FANIE,1975,3,3,0,100.0,0.0,Female
JESSICA,1975,290,290,0,100.0,0.0,Female
MONIQUE,1975,217,217,0,100.0,0.0,Female
GAËLE,1975,15,15,0,100.0,0.0,Female
MICHAËLLE,1975,6,6,0,100.0,0.0,Female
ZULMIRA,1975,3,3,0,100.0,0.0,Female
ANNE-CATHERINE,1975,80,80,0,100.0,0.0,Female
MARIE-LYS,1975,4,4,0,100.0,0.0,Female
JILL,1975,3,3,0,100.0,0.0,Female
ZAHERA,1975,3,3,0,100.0,0.0,Female
YOANE,1975,3,0,3,0.0,100.0,Male
MISEL,1975,6,0,6,0.0,100.0,Male
MALCOLM,1975,4,0,4,0.0,100.0,Male
TOUFIK,1975,48,0,48,0.0,100.0,Male
MARKO,1975,5,0,5,0.0,100.0,Male
LENY,1975,8,0,8,0.0,100.0,Male
AMAEL,1975,6,0,6,0.0,100.0,Male
JEAN-MARCEL,1975,4,0,4,0.0,100.0,Male
SAMY,1975,115,0,115,0.0,100.0,Male
ABD,1975,17,0,17,0.0,100.0,Male
FRANCY,1975,3,0,3,0.0,100.0,Male
JEAN-EDDY,1975,3,0,3,0.0,100.0,Male
ALFRED,1975,37,0,37,0.0,100.0,Male
LOIK,1975,4,0,4,0.0,100.0,Male
NORMAN,1975,15,0,15,0.0,100.0,Male
IDRIS,1975,13,0,13,0.0,100.0,Male
NAPOLEON,1975,3,0,3,0.0,100.0,Male
REDOUANE,1975,16,0,16,0.0,100.0,Male
ABDELILAH,1975,5,0,5,0.0,100.0,Male
HAROLD,1975,98,0,98,0.0,100.0,Male
MARWANE,1975,3,0,3,0.0,100.0,Male
AZZDINE,1975,4,0,4,0.0,100.0,Male
VELI,1975,3,0,3,0.0,100.0,Male
JEAN-DAVID,1975,39,0,39,0.0,100.0,Male
MARCK,1975,4,0,4,0.0,100.0,Male
YAEL,1975,6161,3036,3125,49.27771465671157,50.72228534328843,Unisex
HYACINTHE,1975,4679,1173,3506,25.069459286172258,74.93054071382774,Unisex
JANNICK,1975,2792,1545,1247,55.336676217765046,44.66332378223496,Unisex
GABY,1975,4741,2448,2293,51.63467622864375,48.36532377135626,Unisex
DANY,1975,26027,7836,18191,30.10719637299728,69.89280362700273,Unisex
PEGUY,1975,277,234,43,84.47653429602889,15.52346570397112,Unisex
ADAMA,1975,3805,1078,2727,28.3311432325887,71.6688567674113,Unisex
LORY,1975,1231,941,290,76.44191714053615,23.55808285946385,Unisex
SANTIANA,1975,108,73,35,67.5925925925926,32.407407407407405,Unisex
JANY,1975,3897,2256,1641,57.89068514241724,42.10931485758276,Unisex
NAJAH,1975,323,274,49,84.82972136222911,15.1702786377709,Unisex
MALLORY,1975,2883,2151,732,74.60978147762746,25.390218522372525,Unisex
JOHANE,1975,818,633,185,77.3838630806846,22.6161369193154,Unisex
ARIEL,1975,2401,428,1973,17.8259058725531,82.17409412744689,Unisex
JANICK,1975,4109,2203,1906,53.61401800924799,46.38598199075201,Unisex
YANNE,1975,420,204,216,48.57142857142857,51.42857142857142,Unisex
CLAUDY,1975,2240,835,1405,37.27678571428572,62.72321428571429,Unisex
KAREL,1975,1060,233,827,21.9811320754717,78.01886792452831,Unisex
CAMILLE,1975,287709,207732,79977,72.20212089298562,27.79787910701437,Unisex
GEORGE,1975,2417,650,1767,26.89284236657013,73.10715763342988,Unisex
CAROL,1975,3507,2953,554,84.20302252637582,15.79697747362418,Unisex
LENAIC,1975,1610,423,1187,26.27329192546584,73.72670807453416,Unisex
CHARLIE,1975,30211,15480,14731,51.23961470987389,48.76038529012611,Unisex
DENIZ,1975,1954,675,1279,34.54452405322416,65.45547594677585,Unisex
JOSY,1975,1021,840,181,82.27228207639568,17.72771792360431,Unisex
EUNICE,1976,7,7,0,100.0,0.0,Female
LÉTITIA,1976,3,3,0,100.0,0.0,Female
ALGIA,1976,3,3,0,100.0,0.0,Female
VERONICA,1976,19,19,0,100.0,0.0,Female
WILHELMINE,1976,5,5,0,100.0,0.0,Female
RAQUEL,1976,36,36,0,100.0,0.0,Female
WILMA,1976,5,5,0,100.0,0.0,Female
MARIE-ANGELIQUE,1976,9,9,0,100.0,0.0,Female
NAJATE,1976,28,28,0,100.0,0.0,Female
NADJAT,1976,6,6,0,100.0,0.0,Female
KADRA,1976,5,5,0,100.0,0.0,Female
MAËVA,1976,4,4,0,100.0,0.0,Female
JACINTHE,1976,18,18,0,100.0,0.0,Female
OUARDA,1976,32,32,0,100.0,0.0,Female
GEORGETTE,1976,11,11,0,100.0,0.0,Female
ANTOINETTE,1976,40,40,0,100.0,0.0,Female
HIND,1976,16,16,0,100.0,0.0,Female
DOROTHY,1976,4,4,0,100.0,0.0,Female
SOUFIA,1976,6,6,0,100.0,0.0,Female
VIOLENE,1976,5,5,0,100.0,0.0,Female
VALENTINE,1976,73,73,0,100.0,0.0,Female
FLEUR,1976,70,70,0,100.0,0.0,Female
EDMONDE,1976,4,4,0,100.0,0.0,Female
ASSIA,1976,48,48,0,100.0,0.0,Female
JANINE,1976,7,7,0,100.0,0.0,Female
CHERIF,1976,51,0,51,0.0,100.0,Male
WILLIE,1976,4,0,4,0.0,100.0,Male
CARLOS,1976,456,0,456,0.0,100.0,Male
MOIZ,1976,3,0,3,0.0,100.0,Male
GUENHAEL,1976,4,0,4,0.0,100.0,Male
GERVAIS,1976,5,0,5,0.0,100.0,Male
MASSIMILIANO,1976,3,0,3,0.0,100.0,Male
AROLD,1976,3,0,3,0.0,100.0,Male
ALEKSANDAR,1976,16,0,16,0.0,100.0,Male
MARC-ETIENNE,1976,3,0,3,0.0,100.0,Male
JOSIAN,1976,25,0,25,0.0,100.0,Male
AMANDIO,1976,4,0,4,0.0,100.0,Male
MAEL,1976,33274,539,32735,1.6198833924385403,98.38011660756146,Male
RAMZI,1976,39,0,39,0.0,100.0,Male
PHILIPPE,1976,4241,0,4241,0.0,100.0,Male
CHRISTOPHE,1976,13106,0,13106,0.0,100.0,Male
BRUCE,1976,98,0,98,0.0,100.0,Male
ABDOU,1976,8,0,8,0.0,100.0,Male
EMERIC,1976,145,0,145,0.0,100.0,Male
JEAN-FRANCIS,1976,3,0,3,0.0,100.0,Male
LUIS-MIGUEL,1976,10,0,10,0.0,100.0,Male
RONNY,1976,13,0,13,0.0,100.0,Male
ANGEL,1976,24,0,24,0.0,100.0,Male
BLAISE,1976,38,0,38,0.0,100.0,Male
IOAN,1976,3,0,3,0.0,100.0,Male
LOÏS,1976,11236,3416,7820,30.40227839088644,69.59772160911356,Unisex
ADAMA,1976,3805,1078,2727,28.3311432325887,71.6688567674113,Unisex
GEORGE,1976,2417,650,1767,26.89284236657013,73.10715763342988,Unisex
MORGANN,1976,1229,459,770,37.34743694060212,62.65256305939788,Unisex
GWENHAEL,1976,225,76,149,33.77777777777778,66.22222222222223,Unisex
ALIX,1976,37305,28371,8934,76.05146763168477,23.94853236831524,Unisex
JANICK,1976,4109,2203,1906,53.61401800924799,46.38598199075201,Unisex
NAJAH,1976,323,274,49,84.82972136222911,15.1702786377709,Unisex
CAMILLE,1976,287709,207732,79977,72.20212089298562,27.79787910701437,Unisex
HYACINTHE,1976,4679,1173,3506,25.069459286172258,74.93054071382774,Unisex
LENAIC,1976,1610,423,1187,26.27329192546584,73.72670807453416,Unisex
_PRENOMS_RARES,1976,1760252,908578,851674,51.616359475802334,48.38364052419767,Unisex
ROSARIO,1976,1546,781,765,50.51746442432082,49.48253557567917,Unisex
MALEK,1976,3570,1060,2510,29.69187675070028,70.30812324929971,Unisex
DENIZ,1976,1954,675,1279,34.54452405322416,65.45547594677585,Unisex
LENAICK,1976,695,402,293,57.84172661870504,42.15827338129496,Unisex
DOMINIQUE,1976,409989,168027,241962,40.98329467375954,59.01670532624046,Unisex
BERYL,1976,762,607,155,79.65879265091863,20.341207349081365,Unisex
ADDA,1976,397,209,188,52.64483627204031,47.3551637279597,Unisex
MELAINE,1976,1656,1288,368,77.77777777777779,22.22222222222222,Unisex
FRANCKIE,1976,483,73,410,15.113871635610764,84.88612836438924,Unisex
YANNE,1976,420,204,216,48.57142857142857,51.42857142857142,Unisex
DANY,1976,26027,7836,18191,30.10719637299728,69.89280362700273,Unisex
LORY,1976,1231,941,290,76.44191714053615,23.55808285946385,Unisex
VANIA,1976,402,316,86,78.60696517412936,21.393034825870647,Unisex
AMPARO,1977,4,4,0,100.0,0.0,Female
SANDRINE,1977,11060,11060,0,100.0,0.0,Female
MARIE-ANGELIQUE,1977,8,8,0,100.0,0.0,Female
MÉLINDA,1977,31,31,0,100.0,0.0,Female
CÉDRINE,1977,7,7,0,100.0,0.0,Female
MARIE-DOMINIQUE,1977,39,39,0,100.0,0.0,Female
NAJED,1977,3,3,0,100.0,0.0,Female
SOUAAD,1977,14,14,0,100.0,0.0,Female
CLAIRE-LISE,1977,14,14,0,100.0,0.0,Female
NAJOIE,1977,3,3,0,100.0,0.0,Female
MERYL,1977,2926,2586,340,88.38004101161997,11.61995898838004,Female
MARIE-ANGÈLE,1977,7,7,0,100.0,0.0,Female
ISMAELLE,1977,3,3,0,100.0,0.0,Female
MARTHE,1977,33,33,0,100.0,0.0,Female
FEIZA,1977,5,5,0,100.0,0.0,Female
MARIE-EVELYNE,1977,3,3,0,100.0,0.0,Female
HILDA,1977,4,4,0,100.0,0.0,Female
WIDED,1977,5,5,0,100.0,0.0,Female
ISMA,1977,9,9,0,100.0,0.0,Female
DERYA,1977,9,9,0,100.0,0.0,Female
HULYA,1977,31,31,0,100.0,0.0,Female
ZAIRA,1977,3,3,0,100.0,0.0,Female
KATELL,1977,128,128,0,100.0,0.0,Female
YASMINA,1977,261,261,0,100.0,0.0,Female
FATIHA,1977,262,262,0,100.0,0.0,Female
YURI,1977,4,0,4,0.0,100.0,Male
CHARLES-EMMANUEL,1977,7,0,7,0.0,100.0,Male
SONNY,1977,2699,47,2652,1.7413856984068172,98.25861430159318,Male
MAEL,1977,33274,539,32735,1.6198833924385403,98.38011660756146,Male
URIEL,1977,4,0,4,0.0,100.0,Male
NIKOLA,1977,11,0,11,0.0,100.0,Male
JEAN-COME,1977,3,0,3,0.0,100.0,Male
RUI-MANUEL,1977,10,0,10,0.0,100.0,Male
ELIEZER,1977,6,0,6,0.0,100.0,Male
GODEFROY,1977,4,0,4,0.0,100.0,Male
ARNO,1977,5,0,5,0.0,100.0,Male
YOUNOUS,1977,4,0,4,0.0,100.0,Male
MARYAN,1977,837,34,803,4.062126642771804,95.9378733572282,Male
ABDELOUAHAB,1977,6,0,6,0.0,100.0,Male
BECHIR,1977,14,0,14,0.0,100.0,Male
KADDOUR,1977,4,0,4,0.0,100.0,Male
TARZAN,1977,5,0,5,0.0,100.0,Male
NADJIM,1977,6,0,6,0.0,100.0,Male
BARTHÉLÉMY,1977,9,0,9,0.0,100.0,Male
HELMI,1977,4,0,4,0.0,100.0,Male
MEDY,1977,5,0,5,0.0,100.0,Male
MARCELIN,1977,4,0,4,0.0,100.0,Male
RONAN,1977,385,0,385,0.0,100.0,Male
SMAINE,1977,7,0,7,0.0,100.0,Male
NIDAL,1977,5,0,5,0.0,100.0,Male
GWENHAEL,1977,225,76,149,33.77777777777778,66.22222222222223,Unisex
JANICK,1977,4109,2203,1906,53.61401800924799,46.38598199075201,Unisex
DANNY,1977,3396,610,2786,17.962308598351,82.037691401649,Unisex
CAMILLE,1977,287709,207732,79977,72.20212089298562,27.79787910701437,Unisex
GILLIAN,1977,947,327,620,34.53009503695882,65.46990496304119,Unisex
YAËL,1977,3502,1564,1938,44.66019417475729,55.33980582524271,Unisex
LENAIC,1977,1610,423,1187,26.27329192546584,73.72670807453416,Unisex
KAREL,1977,1060,233,827,21.9811320754717,78.01886792452831,Unisex
ANGE-MARIE,1977,650,290,360,44.61538461538462,55.38461538461539,Unisex
DENIZ,1977,1954,675,1279,34.54452405322416,65.45547594677585,Unisex
MORGANN,1977,1229,459,770,37.34743694060212,62.65256305939788,Unisex
DOMINIQUE,1977,409989,168027,241962,40.98329467375954,59.01670532624046,Unisex
MALLORY,1977,2883,2151,732,74.60978147762746,25.390218522372525,Unisex
VANIA,1977,402,316,86,78.60696517412936,21.393034825870647,Unisex
NGOC,1977,641,437,204,68.17472698907956,31.82527301092044,Unisex
HYACINTHE,1977,4679,1173,3506,25.069459286172258,74.93054071382774,Unisex
YANNE,1977,420,204,216,48.57142857142857,51.42857142857142,Unisex
YAEL,1977,6161,3036,3125,49.27771465671157,50.72228534328843,Unisex
LORRY,1977,389,169,220,43.44473007712082,56.555269922879184,Unisex
ROSARIO,1977,1546,781,765,50.51746442432082,49.48253557567917,Unisex
KIM,1977,6518,5270,1248,80.85302239950906,19.146977600490946,Unisex
CLAUDY,1977,2240,835,1405,37.27678571428572,62.72321428571429,Unisex
ADAMA,1977,3805,1078,2727,28.3311432325887,71.6688567674113,Unisex
GWENN,1977,1848,1201,647,64.98917748917748,35.01082251082251,Unisex
SADIO,1977,1523,895,628,58.76559422193039,41.2344057780696,Unisex
DIEYNABA,1978,6,6,0,100.0,0.0,Female
NAHIMA,1978,7,7,0,100.0,0.0,Female
SAFIA,1978,59,59,0,100.0,0.0,Female
ALINE,1978,1103,1103,0,100.0,0.0,Female
RANIA,1978,26,26,0,100.0,0.0,Female
GRACINDA,1978,5,5,0,100.0,0.0,Female
IVANA,1978,7,7,0,100.0,0.0,Female
GWENHAELLE,1978,5,5,0,100.0,0.0,Female
BERTHE,1978,4,4,0,100.0,0.0,Female
MARIA-LUISA,1978,4,4,0,100.0,0.0,Female
MICHELINE,1978,48,48,0,100.0,0.0,Female
ALIDA,1978,13,13,0,100.0,0.0,Female
SILVANA,1978,13,13,0,100.0,0.0,Female
BAPTISTINE,1978,4,4,0,100.0,0.0,Female
MONICA,1978,31,31,0,100.0,0.0,Female
CARINNE,1978,42,42,0,100.0,0.0,Female
EMANUELLE,1978,8,8,0,100.0,0.0,Female
FADIMA,1978,3,3,0,100.0,0.0,Female
CARMELA,1978,12,12,0,100.0,0.0,Female
LALA,1978,5,5,0,100.0,0.0,Female
DORINE,1978,44,44,0,100.0,0.0,Female
LÉA,1978,118,118,0,100.0,0.0,Female
KRISTEL,1978,76,76,0,100.0,0.0,Female
HAFEDA,1978,9,9,0,100.0,0.0,Female
ELISABETE,1978,45,45,0,100.0,0.0,Female
JOAO,1978,98,0,98,0.0,100.0,Male
LIESSE,1978,3,0,3,0.0,100.0,Male
OUALID,1978,49,0,49,0.0,100.0,Male
CHI,1978,5,0,5,0.0,100.0,Male
AKIM,1978,97,0,97,0.0,100.0,Male
GATIEN,1978,13,0,13,0.0,100.0,Male
HIPPOLYTE,1978,4,0,4,0.0,100.0,Male
IVAN,1978,99,0,99,0.0,100.0,Male
YALCIN,1978,5,0,5,0.0,100.0,Male
FAWZI,1978,6,0,6,0.0,100.0,Male
JEAN-PATRICE,1978,9,0,9,0.0,100.0,Male
NASSIM,1978,41,0,41,0.0,100.0,Male
REUNAN,1978,4,0,4,0.0,100.0,Male
IKER,1978,5,0,5,0.0,100.0,Male
ALFRED,1978,36,0,36,0.0,100.0,Male
VALENTIN,1978,93,0,93,0.0,100.0,Male
VINCENZO,1978,6,0,6,0.0,100.0,Male
DAMIEN,1978,3199,0,3199,0.0,100.0,Male
MATHIS,1978,6,0,6,0.0,100.0,Male
MOHAMADOU,1978,4,0,4,0.0,100.0,Male
ELIAS,1978,8,0,8,0.0,100.0,Male
METIN,1978,14,0,14,0.0,100.0,Male
WILHEM,1978,3,0,3,0.0,100.0,Male
RABIH,1978,7,0,7,0.0,100.0,Male
MAYEUL,1978,8,0,8,0.0,100.0,Male
VANIA,1978,402,316,86,78.60696517412936,21.393034825870647,Unisex
GWENHAEL,1978,225,76,149,33.77777777777778,66.22222222222223,Unisex
MELAINE,1978,1656,1288,368,77.77777777777779,22.22222222222222,Unisex
CLARENCE,1978,2943,924,2019,31.39653414882773,68.60346585117227,Unisex
ADAMA,1978,3805,1078,2727,28.3311432325887,71.6688567674113,Unisex
DOMINIQUE,1978,409989,168027,241962,40.98329467375954,59.01670532624046,Unisex
LENAIC,1978,1610,423,1187,26.27329192546584,73.72670807453416,Unisex
MALEK,1978,3570,1060,2510,29.69187675070028,70.30812324929971,Unisex
MALORY,1978,2305,1892,413,82.08242950108459,17.9175704989154,Unisex
FRANCKIE,1978,483,73,410,15.113871635610764,84.88612836438924,Unisex
JANNY,1978,1044,617,427,59.099616858237546,40.90038314176245,Unisex
YAEL,1978,6161,3036,3125,49.27771465671157,50.72228534328843,Unisex
MALLORY,1978,2883,2151,732,74.60978147762746,25.390218522372525,Unisex
KELIG,1978,415,123,292,29.63855421686747,70.36144578313252,Unisex
_PRENOMS_RARES,1978,1760252,908578,851674,51.616359475802334,48.38364052419767,Unisex
M,1978,226,41,185,18.141592920353983,81.85840707964603,Unisex
JORDANE,1978,4682,1785,2897,38.12473302007689,61.875266979923104,Unisex
ANAEL,1978,2957,1241,1716,41.96821102468719,58.031788975312814,Unisex
GWENN,1978,1848,1201,647,64.98917748917748,35.01082251082251,Unisex
ANH,1978,394,164,230,41.62436548223351,58.37563451776649,Unisex
KRISTEN,1978,939,532,407,56.656017039403615,43.34398296059638,Unisex
JANNICK,1978,2792,1545,1247,55.336676217765046,44.66332378223496,Unisex
CAROL,1978,3507,2953,554,84.20302252637582,15.79697747362418,Unisex
NGOC,1978,641,437,204,68.17472698907956,31.82527301092044,Unisex
KAREL,1978,1060,233,827,21.9811320754717,78.01886792452831,Unisex
FELICIA,1979,23,23,0,100.0,0.0,Female
HATOUMATA,1979,4,4,0,100.0,0.0,Female
BERYL,1979,7,7,0,100.0,0.0,Female
FÉLICIA,1979,6,6,0,100.0,0.0,Female
HERMANCE,1979,4,4,0,100.0,0.0,Female
CIGDEM,1979,3,3,0,100.0,0.0,Female
MAHJOUBA,1979,5,5,0,100.0,0.0,Female
HIND,1979,36,36,0,100.0,0.0,Female
MARGARET,1979,15,15,0,100.0,0.0,Female
POMME,1979,4,4,0,100.0,0.0,Female
JEANIE,1979,3,3,0,100.0,0.0,Female
HOURYA,1979,3,3,0,100.0,0.0,Female
LILIANA,1979,7,7,0,100.0,0.0,Female
HÉLÈNE,1979,3752,3752,0,100.0,0.0,Female
YELIZ,1979,6,6,0,100.0,0.0,Female
MARIEVE,1979,9,9,0,100.0,0.0,Female
CORALINE,1979,64,64,0,100.0,0.0,Female
ROXANA,1979,3,3,0,100.0,0.0,Female
CHLOÉ,1979,325,325,0,100.0,0.0,Female
NAWAL,1979,40,40,0,100.0,0.0,Female
HÉLÈNA,1979,12,12,0,100.0,0.0,Female
EDWINA,1979,11,11,0,100.0,0.0,Female
HAJAR,1979,5,5,0,100.0,0.0,Female
VIOLETA,1979,10,10,0,100.0,0.0,Female
VICTORIA,1979,60,60,0,100.0,0.0,Female
REGIS,1979,851,0,851,0.0,100.0,Male
FADIL,1979,4,0,4,0.0,100.0,Male
JEAN-BERNARD,1979,89,0,89,0.0,100.0,Male
MORAND,1979,3,0,3,0.0,100.0,Male
ANISSE,1979,11,0,11,0.0,100.0,Male
LORIN,1979,4,0,4,0.0,100.0,Male
HASSEN,1979,50,0,50,0.0,100.0,Male
HASSAN,1979,131,0,131,0.0,100.0,Male
JUDICAËL,1979,8,0,8,0.0,100.0,Male
GHAZI,1979,5,0,5,0.0,100.0,Male
KEVINE,1979,4,0,4,0.0,100.0,Male
FILIPPO,1979,3,0,3,0.0,100.0,Male
ALEKSANDAR,1979,21,0,21,0.0,100.0,Male
NELSO,1979,10,0,10,0.0,100.0,Male
RÉMY,1979,628,0,628,0.0,100.0,Male
MAURAD,1979,6,0,6,0.0,100.0,Male
HAITHEM,1979,3,0,3,0.0,100.0,Male
ATIK,1979,3,0,3,0.0,100.0,Male
IMAD,1979,38,0,38,0.0,100.0,Male
JEAN-PASCAL,1979,65,0,65,0.0,100.0,Male
BLAISE,1979,44,0,44,0.0,100.0,Male
GORA,1979,3,0,3,0.0,100.0,Male
COLAS,1979,12,0,12,0.0,100.0,Male
JERRY,1979,33,0,33,0.0,100.0,Male
NARCISSE,1979,5,0,5,0.0,100.0,Male
JORDANE,1979,4682,1785,2897,38.12473302007689,61.875266979923104,Unisex
GWENHAEL,1979,225,76,149,33.77777777777778,66.22222222222223,Unisex
MERRYL,1979,409,342,67,83.61858190709046,16.381418092909534,Unisex
CLAUDY,1979,2240,835,1405,37.27678571428572,62.72321428571429,Unisex
SADIO,1979,1523,895,628,58.76559422193039,41.2344057780696,Unisex
ADAMA,1979,3805,1078,2727,28.3311432325887,71.6688567674113,Unisex
MELAINE,1979,1656,1288,368,77.77777777777779,22.22222222222222,Unisex
NAJAH,1979,323,274,49,84.82972136222911,15.1702786377709,Unisex
HAMIDA,1979,759,628,131,82.74044795783925,17.25955204216074,Unisex
AÏSSA,1979,1505,405,1100,26.91029900332225,73.08970099667775,Unisex
JANICK,1979,4109,2203,1906,53.61401800924799,46.38598199075201,Unisex
GWENN,1979,1848,1201,647,64.98917748917748,35.01082251082251,Unisex
JESSY,1979,17091,3993,13098,23.363173600140424,76.63682639985957,Unisex
JOHANE,1979,818,633,185,77.3838630806846,22.6161369193154,Unisex
CAMILLE,1979,287709,207732,79977,72.20212089298562,27.79787910701437,Unisex
NGOC,1979,641,437,204,68.17472698907956,31.82527301092044,Unisex
LORY,1979,1231,941,290,76.44191714053615,23.55808285946385,Unisex
KAREL,1979,1060,233,827,21.9811320754717,78.01886792452831,Unisex
YANNE,1979,420,204,216,48.57142857142857,51.42857142857142,Unisex
CHAN,1979,209,93,116,44.49760765550239,55.50239234449761,Unisex
ISA,1979,730,291,439,39.86301369863013,60.136986301369866,Unisex
KAELIG,1979,475,80,395,16.842105263157894,83.15789473684211,Unisex
KAROL,1979,450,114,336,25.333333333333336,74.66666666666667,Unisex
CHRISTY,1979,584,396,188,67.8082191780822,32.19178082191781,Unisex
LOÏS,1979,11236,3416,7820,30.40227839088644,69.59772160911356,Unisex
KRISTELL,1980,93,93,0,100.0,0.0,Female
MIKAELLE,1980,6,6,0,100.0,0.0,Female
RAHMA,1980,12,12,0,100.0,0.0,Female
LÉLIA,1980,5,5,0,100.0,0.0,Female
LAURENE,1980,88,88,0,100.0,0.0,Female
MARION,1980,1916,1916,0,100.0,0.0,Female
SOULEF,1980,11,11,0,100.0,0.0,Female
RAOUDA,1980,7,7,0,100.0,0.0,Female
NAIMA,1980,258,258,0,100.0,0.0,Female
KARYN,1980,7,7,0,100.0,0.0,Female
HAYETT,1980,3,3,0,100.0,0.0,Female
CLORINDE,1980,4,4,0,100.0,0.0,Female
HANNEN,1980,3,3,0,100.0,0.0,Female
RAPHAELLE,1980,111,111,0,100.0,0.0,Female
ALICIA,1980,86,86,0,100.0,0.0,Female
JUSTINE,1980,301,301,0,100.0,0.0,Female
VIOLÈNE,1980,3,3,0,100.0,0.0,Female
KATTALIN,1980,3,3,0,100.0,0.0,Female
LAÏLA,1980,28,28,0,100.0,0.0,Female
MELUSINE,1980,9,9,0,100.0,0.0,Female
MARIE-MICHELLE,1980,9,9,0,100.0,0.0,Female
SCHEHERAZADE,1980,9,9,0,100.0,0.0,Female
OLYMPE,1980,16,16,0,100.0,0.0,Female
HAJAR,1980,4,4,0,100.0,0.0,Female
MICHAELE,1980,5,5,0,100.0,0.0,Female
IBRAHIME,1980,3,0,3,0.0,100.0,Male
DOMINGOS,1980,10,0,10,0.0,100.0,Male
JEAN-MARY,1980,7,0,7,0.0,100.0,Male
SOFIENE,1980,13,0,13,0.0,100.0,Male
GWENDAL,1980,82,0,82,0.0,100.0,Male
ANDRES,1980,6,0,6,0.0,100.0,Male
BATISTE,1980,5,0,5,0.0,100.0,Male
CÉLIAN,1980,6,0,6,0.0,100.0,Male
MAXIMILIEN,1980,149,0,149,0.0,100.0,Male
TOU,1980,4,0,4,0.0,100.0,Male
JEAN-ARNAUD,1980,6,0,6,0.0,100.0,Male
SIDY,1980,7,0,7,0.0,100.0,Male
BILAL,1980,27,0,27,0.0,100.0,Male
KADDOUR,1980,8,0,8,0.0,100.0,Male
SYLVIAN,1980,9,0,9,0.0,100.0,Male
JEAN-CLAUDE,1980,218,0,218,0.0,100.0,Male
FREDERICK,1980,161,0,161,0.0,100.0,Male
JOSQUIN,1980,6,0,6,0.0,100.0,Male
MARC,1980,2279,0,2279,0.0,100.0,Male
ZOHIR,1980,7,0,7,0.0,100.0,Male
KAAN,1980,4,0,4,0.0,100.0,Male
HASSAN,1980,134,0,134,0.0,100.0,Male
IRFAN,1980,5,0,5,0.0,100.0,Male
ZORAN,1980,13,0,13,0.0,100.0,Male
FOUHAD,1980,3,0,3,0.0,100.0,Male
ALIX,1980,37305,28371,8934,76.05146763168477,23.94853236831524,Unisex
DENIZ,1980,1954,675,1279,34.54452405322416,65.45547594677585,Unisex
CLAUDY,1980,2240,835,1405,37.27678571428572,62.72321428571429,Unisex
HYACINTHE,1980,4679,1173,3506,25.069459286172258,74.93054071382774,Unisex
DANY,1980,26027,7836,18191,30.10719637299728,69.89280362700273,Unisex
MINH,1980,738,185,553,25.067750677506773,74.93224932249322,Unisex
LENAICK,1980,695,402,293,57.84172661870504,42.15827338129496,Unisex
KAREL,1980,1060,233,827,21.9811320754717,78.01886792452831,Unisex
DOMINIQUE,1980,409989,168027,241962,40.98329467375954,59.01670532624046,Unisex
_PRENOMS_RARES,1980,1760252,908578,851674,51.616359475802334,48.38364052419767,Unisex
GWENN,1980,1848,1201,647,64.98917748917748,35.01082251082251,Unisex
YANNE,1980,420,204,216,48.57142857142857,51.42857142857142,Unisex
JORDANE,1980,4682,1785,2897,38.12473302007689,61.875266979923104,Unisex
MERRYL,1980,409,342,67,83.61858190709046,16.381418092909534,Unisex
ANAEL,1980,2957,1241,1716,41.96821102468719,58.031788975312814,Unisex
ADAMA,1980,3805,1078,2727,28.3311432325887,71.6688567674113,Unisex
HEIDY,1980,271,201,70,74.16974169741697,25.830258302583022,Unisex
KEVINE,1980,269,98,171,36.43122676579926,63.56877323420075,Unisex
KAROL,1980,450,114,336,25.333333333333336,74.66666666666667,Unisex
SADIO,1980,1523,895,628,58.76559422193039,41.2344057780696,Unisex
MALLORY,1980,2883,2151,732,74.60978147762746,25.390218522372525,Unisex
THANH,1980,630,259,371,41.11111111111111,58.88888888888889,Unisex
IKRAM,1980,2750,2311,439,84.03636363636363,15.963636363636365,Unisex
GWENHAEL,1980,225,76,149,33.77777777777778,66.22222222222223,Unisex
JANNICK,1980,2792,1545,1247,55.336676217765046,44.66332378223496,Unisex
BAHIA,1981,10,10,0,100.0,0.0,Female
EURIELLE,1981,4,4,0,100.0,0.0,Female
AMY,1981,5,5,0,100.0,0.0,Female
FLAMINE,1981,4,4,0,100.0,0.0,Female
MARIA-THERESA,1981,3,3,0,100.0,0.0,Female
SANIA,1981,9,9,0,100.0,0.0,Female
HAIAT,1981,6,6,0,100.0,0.0,Female
FOUZIA,1981,105,105,0,100.0,0.0,Female
FATIMA-ZOHRA,1981,11,11,0,100.0,0.0,Female
AFEF,1981,10,10,0,100.0,0.0,Female
ELYA,1981,3,3,0,100.0,0.0,Female
LENAÏG,1981,5,5,0,100.0,0.0,Female
MARIE-JESSICA,1981,4,4,0,100.0,0.0,Female
PRICILLIA,1981,5,5,0,100.0,0.0,Female
OLIVERA,1981,4,4,0,100.0,0.0,Female
LIVA,1981,3,3,0,100.0,0.0,Female
FOUZYA,1981,5,5,0,100.0,0.0,Female
MANA,1981,4,4,0,100.0,0.0,Female
WINDY,1981,6,6,0,100.0,0.0,Female
MAROUSSIA,1981,13,13,0,100.0,0.0,Female
ZOUHRA,1981,4,4,0,100.0,0.0,Female
VERA,1981,10,10,0,100.0,0.0,Female
FAWZIA,1981,4,4,0,100.0,0.0,Female
AMANE,1981,3,3,0,100.0,0.0,Female
MARGARET,1981,13,13,0,100.0,0.0,Female
BRUNO,1981,1803,0,1803,0.0,100.0,Male
CHRISTOPHE,1981,8097,0,8097,0.0,100.0,Male
AADEL,1981,5,0,5,0.0,100.0,Male
AMANDIO,1981,5,0,5,0.0,100.0,Male
RABIE,1981,9,0,9,0.0,100.0,Male
GILLIAN,1981,7,0,7,0.0,100.0,Male
DJEMEL,1981,12,0,12,0.0,100.0,Male
IRWIN,1981,14,0,14,0.0,100.0,Male
AMADOU,1981,52,0,52,0.0,100.0,Male
TIMOTHÉE,1981,152,0,152,0.0,100.0,Male
LOUIS-JOSEPH,1981,3,0,3,0.0,100.0,Male
CALIXTE,1981,3,0,3,0.0,100.0,Male
CHARAF,1981,7,0,7,0.0,100.0,Male
GRATIEN,1981,15,0,15,0.0,100.0,Male
FOUHAD,1981,3,0,3,0.0,100.0,Male
PACÔME,1981,5,0,5,0.0,100.0,Male
LEE,1981,3,0,3,0.0,100.0,Male
LIONEL,1981,2019,0,2019,0.0,100.0,Male
GUILLAUME,1981,8838,0,8838,0.0,100.0,Male
SEFIANE,1981,3,0,3,0.0,100.0,Male
FREDY,1981,30,0,30,0.0,100.0,Male
CHARLES-PIERRE,1981,3,0,3,0.0,100.0,Male
MURAT,1981,56,0,56,0.0,100.0,Male
HICHAM,1981,180,0,180,0.0,100.0,Male
YANNIG,1981,6,0,6,0.0,100.0,Male
CHARLIE,1981,30211,15480,14731,51.23961470987389,48.76038529012611,Unisex
JANICK,1981,4109,2203,1906,53.61401800924799,46.38598199075201,Unisex
PHUONG,1981,204,173,31,84.80392156862744,15.196078431372548,Unisex
GABY,1981,4741,2448,2293,51.63467622864375,48.36532377135626,Unisex
BAO,1981,294,112,182,38.095238095238095,61.90476190476191,Unisex
CAROL,1981,3507,2953,554,84.20302252637582,15.79697747362418,Unisex
MALORY,1981,2305,1892,413,82.08242950108459,17.9175704989154,Unisex
MALLORY,1981,2883,2151,732,74.60978147762746,25.390218522372525,Unisex
DENIZ,1981,1954,675,1279,34.54452405322416,65.45547594677585,Unisex
ALIX,1981,37305,28371,8934,76.05146763168477,23.94853236831524,Unisex
LORY,1981,1231,941,290,76.44191714053615,23.55808285946385,Unisex
MELAINE,1981,1656,1288,368,77.77777777777779,22.22222222222222,Unisex
JEANNICK,1981,2091,1305,786,62.4103299856528,37.589670014347206,Unisex
JORDANE,1981,4682,1785,2897,38.12473302007689,61.875266979923104,Unisex
LÉNAÏC,1981,409,93,316,22.73838630806846,77.26161369193154,Unisex
XUAN,1981,274,134,140,48.9051094890511,51.09489051094891,Unisex
LY,1981,327,215,112,65.74923547400611,34.25076452599388,Unisex
GWENN,1981,1848,1201,647,64.98917748917748,35.01082251082251,Unisex
LENAIC,1981,1610,423,1187,26.27329192546584,73.72670807453416,Unisex
JOHANE,1981,818,633,185,77.3838630806846,22.6161369193154,Unisex
MINH,1981,738,185,553,25.067750677506773,74.93224932249322,Unisex
NAJAH,1981,323,274,49,84.82972136222911,15.1702786377709,Unisex
KRISTEN,1981,939,532,407,56.656017039403615,43.34398296059638,Unisex
YANNE,1981,420,204,216,48.57142857142857,51.42857142857142,Unisex
MORGANN,1981,1229,459,770,37.34743694060212,62.65256305939788,Unisex
BEATRIX,1982,3,3,0,100.0,0.0,Female
FATMATA,1982,5,5,0,100.0,0.0,Female
RAPHAELLE,1982,136,136,0,100.0,0.0,Female
ADELINE,1982,2196,2196,0,100.0,0.0,Female
LILIA,1982,65,65,0,100.0,0.0,Female
AUDE,1982,1273,1273,0,100.0,0.0,Female
MOKHTARIA,1982,8,8,0,100.0,0.0,Female
ANIA,1982,9,9,0,100.0,0.0,Female
NOÉMI,1982,4,4,0,100.0,0.0,Female
YOUSRA,1982,15,15,0,100.0,0.0,Female
CELYNE,1982,7,7,0,100.0,0.0,Female
CÉDRINE,1982,7,7,0,100.0,0.0,Female
DEHBIA,1982,3,3,0,100.0,0.0,Female
MINE,1982,5,5,0,100.0,0.0,Female
PEROLINE,1982,3,3,0,100.0,0.0,Female
ALLISON,1982,84,84,0,100.0,0.0,Female
TOURYA,1982,4,4,0,100.0,0.0,Female
MILENA,1982,12,12,0,100.0,0.0,Female
ISADORA,1982,8,8,0,100.0,0.0,Female
MOFIDA,1982,3,3,0,100.0,0.0,Female
ALISA,1982,4,4,0,100.0,0.0,Female
IBTISSAM,1982,19,19,0,100.0,0.0,Female
ANOUK,1982,30,30,0,100.0,0.0,Female
HAZAR,1982,5,5,0,100.0,0.0,Female
GUENAELLE,1982,31,31,0,100.0,0.0,Female
OSCAR,1982,19,0,19,0.0,100.0,Male
FABIEN,1982,4274,0,4274,0.0,100.0,Male
CLOTAIRE,1982,9,0,9,0.0,100.0,Male
JEAN-GAEL,1982,6,0,6,0.0,100.0,Male
THONG,1982,6,0,6,0.0,100.0,Male
EKAITZ,1982,3,0,3,0.0,100.0,Male
OSWALD,1982,12,0,12,0.0,100.0,Male
JARNO,1982,4,0,4,0.0,100.0,Male
GWENAEL,1982,8337,596,7741,7.148854504018232,92.85114549598175,Male
CURTIS,1982,5,0,5,0.0,100.0,Male
MARVIN,1982,6,0,6,0.0,100.0,Male
RIYAD,1982,5,0,5,0.0,100.0,Male
TOMISLAV,1982,3,0,3,0.0,100.0,Male
ALPASLAN,1982,4,0,4,0.0,100.0,Male
BOUCHAIB,1982,6,0,6,0.0,100.0,Male
MANU,1982,5,0,5,0.0,100.0,Male
AKIM,1982,95,0,95,0.0,100.0,Male
GREGOR,1982,10,0,10,0.0,100.0,Male
PAUL-EMMANUEL,1982,5,0,5,0.0,100.0,Male
JOANICK,1982,3,0,3,0.0,100.0,Male
ATIF,1982,9,0,9,0.0,100.0,Male
ANICET,1982,10,0,10,0.0,100.0,Male
PIERRE-MICHEL,1982,8,0,8,0.0,100.0,Male
JEAN-CEDRIC,1982,11,0,11,0.0,100.0,Male
LUDOVIC,1982,5278,0,5278,0.0,100.0,Male
GWENHAEL,1982,225,76,149,33.77777777777778,66.22222222222223,Unisex
CAROL,1982,3507,2953,554,84.20302252637582,15.79697747362418,Unisex
JANNICK,1982,2792,1545,1247,55.336676217765046,44.66332378223496,Unisex
JORDANE,1982,4682,1785,2897,38.12473302007689,61.875266979923104,Unisex
LENAICK,1982,695,402,293,57.84172661870504,42.15827338129496,Unisex
THIEN,1982,171,63,108,36.84210526315789,63.1578947368421,Unisex
LENAIC,1982,1610,423,1187,26.27329192546584,73.72670807453416,Unisex
KAREL,1982,1060,233,827,21.9811320754717,78.01886792452831,Unisex
MORGANN,1982,1229,459,770,37.34743694060212,62.65256305939788,Unisex
MINH,1982,738,185,553,25.067750677506773,74.93224932249322,Unisex
MALLORY,1982,2883,2151,732,74.60978147762746,25.390218522372525,Unisex
LORY,1982,1231,941,290,76.44191714053615,23.55808285946385,Unisex
ALIX,1982,37305,28371,8934,76.05146763168477,23.94853236831524,Unisex
YAEL,1982,6161,3036,3125,49.27771465671157,50.72228534328843,Unisex
LOÏS,1982,11236,3416,7820,30.40227839088644,69.59772160911356,Unisex
YOHANNE,1982,172,53,119,30.813953488372093,69.18604651162791,Unisex
SIDNEY,1982,2484,951,1533,38.28502415458937,61.71497584541063,Unisex
JESSY,1982,17091,3993,13098,23.363173600140424,76.63682639985957,Unisex
MELAINE,1982,1656,1288,368,77.77777777777779,22.22222222222222,Unisex
HYACINTHE,1982,4679,1173,3506,25.069459286172258,74.93054071382774,Unisex
_PRENOMS_RARES,1982,1760252,908578,851674,51.616359475802334,48.38364052419767,Unisex
LY,1982,327,215,112,65.74923547400611,34.25076452599388,Unisex
SULTAN,1982,775,518,257,66.83870967741935,33.16129032258065,Unisex
KEVINE,1982,269,98,171,36.43122676579926,63.56877323420075,Unisex
SADIO,1982,1523,895,628,58.76559422193039,41.2344057780696,Unisex
NAJAT,1983,85,85,0,100.0,0.0,Female
MARIE-LÉA,1983,5,5,0,100.0,0.0,Female
LISE-MARIE,1983,14,14,0,100.0,0.0,Female
MARIANE,1983,27,27,0,100.0,0.0,Female
MORWENA,1983,3,3,0,100.0,0.0,Female
ZARA,1983,5,5,0,100.0,0.0,Female
LESLIE,1983,655,655,0,100.0,0.0,Female
DJAMILLA,1983,3,3,0,100.0,0.0,Female
FANELLY,1983,3,3,0,100.0,0.0,Female
MAJIDA,1983,13,13,0,100.0,0.0,Female
NAZMIYE,1983,4,4,0,100.0,0.0,Female
HAMEL,1983,14,14,0,100.0,0.0,Female
ZOUINA,1983,6,6,0,100.0,0.0,Female
AÏSSA,1983,3,3,0,100.0,0.0,Female
SABRIA,1983,14,14,0,100.0,0.0,Female
MONELLE,1983,6,6,0,100.0,0.0,Female
JULIETTE,1983,580,580,0,100.0,0.0,Female
EVA,1983,322,322,0,100.0,0.0,Female
PERNELLE,1983,6,6,0,100.0,0.0,Female
GISÈLE,1983,43,43,0,100.0,0.0,Female
NAJWA,1983,15,15,0,100.0,0.0,Female
CIHAM,1983,4,4,0,100.0,0.0,Female
AMNA,1983,6,6,0,100.0,0.0,Female
BARBARA,1983,531,531,0,100.0,0.0,Female
AMANE,1983,5,5,0,100.0,0.0,Female
ANAS,1983,16,0,16,0.0,100.0,Male
DONOVAN,1983,13,0,13,0.0,100.0,Male
CHAIB,1983,4,0,4,0.0,100.0,Male
AZZDINE,1983,4,0,4,0.0,100.0,Male
DAVID,1983,7593,0,7593,0.0,100.0,Male
OTMANE,1983,4,0,4,0.0,100.0,Male
ILYES,1983,7,0,7,0.0,100.0,Male
VIANNEY,1983,100,0,100,0.0,100.0,Male
ABDALLAH,1983,43,0,43,0.0,100.0,Male
AMINE,1983,95,0,95,0.0,100.0,Male
YASSINE,1983,212,0,212,0.0,100.0,Male
SONER,1983,12,0,12,0.0,100.0,Male
EDGARD,1983,5,0,5,0.0,100.0,Male
JESSON,1983,8,0,8,0.0,100.0,Male
ROSUEL,1983,3,0,3,0.0,100.0,Male
JOAQUIN,1983,5,0,5,0.0,100.0,Male
ABDEL-KADER,1983,4,0,4,0.0,100.0,Male
AZDDINE,1983,3,0,3,0.0,100.0,Male
FAYSAL,1983,13,0,13,0.0,100.0,Male
CHAKIR,1983,14,0,14,0.0,100.0,Male
REMZI,1983,3,0,3,0.0,100.0,Male
NORY,1983,5,0,5,0.0,100.0,Male
CESAR,1983,37,0,37,0.0,100.0,Male
FELICIEN,1983,13,0,13,0.0,100.0,Male
GAVIN,1983,3,0,3,0.0,100.0,Male
JESSY,1983,17091,3993,13098,23.363173600140424,76.63682639985957,Unisex
MAELIG,1983,554,238,316,42.96028880866426,57.03971119133574,Unisex
MALLORY,1983,2883,2151,732,74.60978147762746,25.390218522372525,Unisex
MELAINE,1983,1656,1288,368,77.77777777777779,22.22222222222222,Unisex
YOHANNE,1983,172,53,119,30.813953488372093,69.18604651162791,Unisex
AUDREN,1983,391,92,299,23.52941176470588,76.47058823529412,Unisex
KA,1983,101,56,45,55.44554455445545,44.55445544554456,Unisex
FRANCKIE,1983,483,73,410,15.113871635610764,84.88612836438924,Unisex
JANY,1983,3897,2256,1641,57.89068514241724,42.10931485758276,Unisex
HALIME,1983,279,207,72,74.19354838709677,25.806451612903224,Unisex
THANH,1983,630,259,371,41.11111111111111,58.88888888888889,Unisex
HONG,1983,175,107,68,61.142857142857146,38.85714285714285,Unisex
KAREL,1983,1060,233,827,21.9811320754717,78.01886792452831,Unisex
JORDANE,1983,4682,1785,2897,38.12473302007689,61.875266979923104,Unisex
LOÏS,1983,11236,3416,7820,30.40227839088644,69.59772160911356,Unisex
ISLAM,1983,1463,253,1210,17.293233082706767,82.70676691729322,Unisex
LORY,1983,1231,941,290,76.44191714053615,23.55808285946385,Unisex
WINDY,1983,436,359,77,82.33944954128441,17.660550458715598,Unisex
KEVINE,1983,269,98,171,36.43122676579926,63.56877323420075,Unisex
ANH,1983,394,164,230,41.62436548223351,58.37563451776649,Unisex
CLAUDY,1983,2240,835,1405,37.27678571428572,62.72321428571429,Unisex
LY,1983,327,215,112,65.74923547400611,34.25076452599388,Unisex
JANICK,1983,4109,2203,1906,53.61401800924799,46.38598199075201,Unisex
OUISSEM,1983,307,57,250,18.56677524429968,81.43322475570032,Unisex
HAMIDE,1983,229,102,127,44.54148471615721,55.45851528384279,Unisex
UMMU,1984,4,4,0,100.0,0.0,Female
NESRINE,1984,33,33,0,100.0,0.0,Female
FAROUDJA,1984,5,5,0,100.0,0.0,Female
MARIE-VANESSA,1984,3,3,0,100.0,0.0,Female
DJEYNABA,1984,3,3,0,100.0,0.0,Female
HERMIONE,1984,3,3,0,100.0,0.0,Female
RITA,1984,29,29,0,100.0,0.0,Female
SOLEN,1984,19,19,0,100.0,0.0,Female
NIMET,1984,7,7,0,100.0,0.0,Female
MARIE-ESTHER,1984,6,6,0,100.0,0.0,Female
CAPUCINE,1984,111,111,0,100.0,0.0,Female
FAYROUZ,1984,9,9,0,100.0,0.0,Female
MARIE-ELEONORE,1984,3,3,0,100.0,0.0,Female
URSULA,1984,15,15,0,100.0,0.0,Female
GABRIELLE,1984,243,243,0,100.0,0.0,Female
AKIMA,1984,10,10,0,100.0,0.0,Female
ESE,1984,3,3,0,100.0,0.0,Female
GHYSLAINE,1984,4,4,0,100.0,0.0,Female
MARIE-ADELAIDE,1984,3,3,0,100.0,0.0,Female
MARYAMA,1984,6,6,0,100.0,0.0,Female
SYLVIANA,1984,7,7,0,100.0,0.0,Female
ONDINE,1984,11,11,0,100.0,0.0,Female
EMELYNE,1984,50,50,0,100.0,0.0,Female
STEPHANY,1984,15,15,0,100.0,0.0,Female
CYNDRA,1984,4,4,0,100.0,0.0,Female
GEORDIE,1984,7,0,7,0.0,100.0,Male
YONIS,1984,3,0,3,0.0,100.0,Male
YASINE,1984,8,0,8,0.0,100.0,Male
JOEY,1984,4,0,4,0.0,100.0,Male
WIELFRIED,1984,3,0,3,0.0,100.0,Male
MOUHCINE,1984,4,0,4,0.0,100.0,Male
MAHMADOU,1984,3,0,3,0.0,100.0,Male
BORA,1984,5,0,5,0.0,100.0,Male
BOUALEM,1984,7,0,7,0.0,100.0,Male
JOCERAN,1984,4,0,4,0.0,100.0,Male
NOUREDINE,1984,32,0,32,0.0,100.0,Male
ISAAC,1984,19,0,19,0.0,100.0,Male
ANSELME,1984,3,0,3,0.0,100.0,Male
ALDRIC,1984,29,0,29,0.0,100.0,Male
MORY,1984,3,0,3,0.0,100.0,Male
FREDERICK,1984,110,0,110,0.0,100.0,Male
FULBERT,1984,5,0,5,0.0,100.0,Male
IANIS,1984,7,0,7,0.0,100.0,Male
GEORGY,1984,7,0,7,0.0,100.0,Male
PRINCE,1984,4,0,4,0.0,100.0,Male
ABDELMALEK,1984,12,0,12,0.0,100.0,Male
YUSSUF,1984,3,0,3,0.0,100.0,Male
YAHAYA,1984,3,0,3,0.0,100.0,Male
ILLAN,1984,4,0,4,0.0,100.0,Male
ANGELO,1984,121,0,121,0.0,100.0,Male
BERYL,1984,762,607,155,79.65879265091863,20.341207349081365,Unisex
JORDANE,1984,4682,1785,2897,38.12473302007689,61.875266979923104,Unisex
JESSY,1984,17091,3993,13098,23.363173600140424,76.63682639985957,Unisex
AUDREN,1984,391,92,299,23.52941176470588,76.47058823529412,Unisex
SOK,1984,70,29,41,41.42857142857143,58.57142857142858,Unisex
JOHANE,1984,818,633,185,77.3838630806846,22.6161369193154,Unisex
LENAIC,1984,1610,423,1187,26.27329192546584,73.72670807453416,Unisex
CHARLIE,1984,30211,15480,14731,51.23961470987389,48.76038529012611,Unisex
NOUHA,1984,689,401,288,58.20029027576198,41.79970972423803,Unisex
SAADA,1984,232,167,65,71.98275862068965,28.01724137931034,Unisex
MELAINE,1984,1656,1288,368,77.77777777777779,22.22222222222222,Unisex
MINH,1984,738,185,553,25.067750677506773,74.93224932249322,Unisex
WINDY,1984,436,359,77,82.33944954128441,17.660550458715598,Unisex
MALEK,1984,3570,1060,2510,29.69187675070028,70.30812324929971,Unisex
WISSAM,1984,2491,451,2040,18.105178643115213,81.89482135688479,Unisex
MADY,1984,2286,1197,1089,52.362204724409445,47.63779527559055,Unisex
PHUONG,1984,204,173,31,84.80392156862744,15.196078431372548,Unisex
HOANG,1984,383,125,258,32.637075718015666,67.36292428198433,Unisex
IKRAM,1984,2750,2311,439,84.03636363636363,15.963636363636365,Unisex
JODY,1984,896,622,274,69.41964285714286,30.580357142857142,Unisex
MAELIG,1984,554,238,316,42.96028880866426,57.03971119133574,Unisex
_PRENOMS_RARES,1984,1760252,908578,851674,51.616359475802334,48.38364052419767,Unisex
HILAL,1984,1545,1011,534,65.4368932038835,34.56310679611651,Unisex
CLAUDY,1984,2240,835,1405,37.27678571428572,62.72321428571429,Unisex
ISLAM,1984,1463,253,1210,17.293233082706767,82.70676691729322,Unisex
ANNE-SOLÈNE,1985,14,14,0,100.0,0.0,Female
SAMRA,1985,4,4,0,100.0,0.0,Female
ANABELA,1985,6,6,0,100.0,0.0,Female
MARIE-ALINE,1985,17,17,0,100.0,0.0,Female
MAGNOLIA,1985,6,6,0,100.0,0.0,Female
MÉLANIE,1985,5775,5775,0,100.0,0.0,Female
ILANA,1985,13,13,0,100.0,0.0,Female
ADJA,1985,4,4,0,100.0,0.0,Female
BILITIS,1985,8,8,0,100.0,0.0,Female
CAROLYN,1985,7,7,0,100.0,0.0,Female
INASSE,1985,3,3,0,100.0,0.0,Female
ANISSA,1985,376,376,0,100.0,0.0,Female
KATELL,1985,38,38,0,100.0,0.0,Female
MELVINA,1985,4,4,0,100.0,0.0,Female
NAOMI,1985,34,34,0,100.0,0.0,Female
EMINE,1985,38,38,0,100.0,0.0,Female
PRIYA,1985,3,3,0,100.0,0.0,Female
SYNTIA,1985,3,3,0,100.0,0.0,Female
FRANCESCA,1985,31,31,0,100.0,0.0,Female
LEYLA,1985,40,40,0,100.0,0.0,Female
NESSIMA,1985,3,3,0,100.0,0.0,Female
SAADIA,1985,24,24,0,100.0,0.0,Female
ESTHEL,1985,3,3,0,100.0,0.0,Female
KLARA,1985,4,4,0,100.0,0.0,Female
ANAELE,1985,3,3,0,100.0,0.0,Female
MAHIEDDINE,1985,5,0,5,0.0,100.0,Male
GARY,1985,331,0,331,0.0,100.0,Male
ISMAÏL,1985,5,0,5,0.0,100.0,Male
ABDELLATIF,1985,26,0,26,0.0,100.0,Male
MOHAMMAD,1985,26,0,26,0.0,100.0,Male
NUNO,1985,14,0,14,0.0,100.0,Male
MARC-ETIENNE,1985,4,0,4,0.0,100.0,Male
FAKRI,1985,4,0,4,0.0,100.0,Male
CHAOUKI,1985,15,0,15,0.0,100.0,Male
PABLO,1985,52,0,52,0.0,100.0,Male
REDOUAN,1985,4,0,4,0.0,100.0,Male
RIDA,1985,36,0,36,0.0,100.0,Male
PIERRE-ETIENNE,1985,39,0,39,0.0,100.0,Male
ALLAL,1985,3,0,3,0.0,100.0,Male
ABDEL-ILLAH,1985,4,0,4,0.0,100.0,Male
EMIR,1985,7,0,7,0.0,100.0,Male
BOUABDALLAH,1985,3,0,3,0.0,100.0,Male
CHARLES-PHILIPPE,1985,3,0,3,0.0,100.0,Male
YAMIN,1985,3,0,3,0.0,100.0,Male
JACQUES-YVES,1985,3,0,3,0.0,100.0,Male
PASCAL,1985,892,0,892,0.0,100.0,Male
MIKAEL,1985,611,0,611,0.0,100.0,Male
SABIR,1985,5,0,5,0.0,100.0,Male
AHMET,1985,44,0,44,0.0,100.0,Male
IVAIN,1985,3,0,3,0.0,100.0,Male
DARA,1985,349,151,198,43.26647564469914,56.73352435530086,Unisex
HILAL,1985,1545,1011,534,65.4368932038835,34.56310679611651,Unisex
JANNICK,1985,2792,1545,1247,55.336676217765046,44.66332378223496,Unisex
LÉNAÏC,1985,409,93,316,22.73838630806846,77.26161369193154,Unisex
MALLORY,1985,2883,2151,732,74.60978147762746,25.390218522372525,Unisex
JANICK,1985,4109,2203,1906,53.61401800924799,46.38598199075201,Unisex
ALIX,1985,37305,28371,8934,76.05146763168477,23.94853236831524,Unisex
YAEL,1985,6161,3036,3125,49.27771465671157,50.72228534328843,Unisex
JANNY,1985,1044,617,427,59.099616858237546,40.90038314176245,Unisex
GWEN,1985,941,419,522,44.52709883103082,55.47290116896918,Unisex
SWANNY,1985,534,310,224,58.05243445692884,41.94756554307117,Unisex
CHRISTY,1985,584,396,188,67.8082191780822,32.19178082191781,Unisex
ANOUSONE,1985,81,20,61,24.69135802469136,75.30864197530865,Unisex
LOÏS,1985,11236,3416,7820,30.40227839088644,69.59772160911356,Unisex
CAMILLE,1985,287709,207732,79977,72.20212089298562,27.79787910701437,Unisex
ISA,1985,730,291,439,39.86301369863013,60.136986301369866,Unisex
LENAÏC,1985,163,44,119,26.993865030674847,73.00613496932516,Unisex
JANY,1985,3897,2256,1641,57.89068514241724,42.10931485758276,Unisex
MALORY,1985,2305,1892,413,82.08242950108459,17.9175704989154,Unisex
CHARLIE,1985,30211,15480,14731,51.23961470987389,48.76038529012611,Unisex
SWANN,1985,8143,2279,5864,27.98722829424045,72.01277170575955,Unisex
HONG,1985,175,107,68,61.142857142857146,38.85714285714285,Unisex
KRISTEN,1985,939,532,407,56.656017039403615,43.34398296059638,Unisex
ANH,1985,394,164,230,41.62436548223351,58.37563451776649,Unisex
DENIZ,1985,1954,675,1279,34.54452405322416,65.45547594677585,Unisex
FATIMA-ZAHRA,1986,6,6,0,100.0,0.0,Female
MARIE-LYSE,1986,3,3,0,100.0,0.0,Female
MARIKA,1986,26,26,0,100.0,0.0,Female
LAMIA,1986,81,81,0,100.0,0.0,Female
AMARIA,1986,3,3,0,100.0,0.0,Female
ÉVELYNE,1986,3,3,0,100.0,0.0,Female
EMERENCE,1986,3,3,0,100.0,0.0,Female
JOSY,1986,4,4,0,100.0,0.0,Female
RIM,1986,26,26,0,100.0,0.0,Female
FRANCISCA,1986,10,10,0,100.0,0.0,Female
ELEONORA,1986,3,3,0,100.0,0.0,Female
CAROLANE,1986,11,11,0,100.0,0.0,Female
FANETTE,1986,22,22,0,100.0,0.0,Female
ANNE-CHARLOTTE,1986,302,302,0,100.0,0.0,Female
MARIE-ANNE,1986,97,97,0,100.0,0.0,Female
KA,1986,3,3,0,100.0,0.0,Female
MÉRYL,1986,6,6,0,100.0,0.0,Female
NAJATTE,1986,6,6,0,100.0,0.0,Female
ANNIA,1986,3,3,0,100.0,0.0,Female
YASEMIN,1986,24,24,0,100.0,0.0,Female
FLEUR,1986,114,114,0,100.0,0.0,Female
HALIMA,1986,110,110,0,100.0,0.0,Female
ASMINE,1986,3,3,0,100.0,0.0,Female
MARIE-AIMÉE,1986,4,4,0,100.0,0.0,Female
AISSE,1986,12,12,0,100.0,0.0,Female
EDER,1986,4,0,4,0.0,100.0,Male
JEAN-RENÉ,1986,43,0,43,0.0,100.0,Male
GUÉNOLÉ,1986,4,0,4,0.0,100.0,Male
ABDELATIF,1986,19,0,19,0.0,100.0,Male
ALIAUME,1986,3,0,3,0.0,100.0,Male
ANDRÉ,1986,244,0,244,0.0,100.0,Male
DOV,1986,4,0,4,0.0,100.0,Male
TUNCAY,1986,9,0,9,0.0,100.0,Male
AZDINE,1986,7,0,7,0.0,100.0,Male
HADJ,1986,9,0,9,0.0,100.0,Male
MAHAMADOU,1986,89,0,89,0.0,100.0,Male
DARRY,1986,4,0,4,0.0,100.0,Male
JEAN-FLORENT,1986,5,0,5,0.0,100.0,Male
TRUNG,1986,3,0,3,0.0,100.0,Male
ANTONI,1986,26,0,26,0.0,100.0,Male
MOUHAMADOU,1986,12,0,12,0.0,100.0,Male
JEF,1986,8,0,8,0.0,100.0,Male
SYLVAN,1986,5,0,5,0.0,100.0,Male
VENCESLAS,1986,4,0,4,0.0,100.0,Male
ALICK,1986,6,0,6,0.0,100.0,Male
LOUNES,1986,5,0,5,0.0,100.0,Male
ETHAN,1986,3,0,3,0.0,100.0,Male
EDGARD,1986,10,0,10,0.0,100.0,Male
SOUFIAN,1986,26,0,26,0.0,100.0,Male
JAUFFRAY,1986,3,0,3,0.0,100.0,Male
AINA,1986,736,618,118,83.96739130434783,16.032608695652172,Unisex
MALLORY,1986,2883,2151,732,74.60978147762746,25.390218522372525,Unisex
SWANNY,1986,534,310,224,58.05243445692884,41.94756554307117,Unisex
JESSY,1986,17091,3993,13098,23.363173600140424,76.63682639985957,Unisex
KIM,1986,6518,5270,1248,80.85302239950906,19.146977600490946,Unisex
SADIO,1986,1523,895,628,58.76559422193039,41.2344057780696,Unisex
ISLAM,1986,1463,253,1210,17.293233082706767,82.70676691729322,Unisex
KERRY,1986,306,91,215,29.73856209150327,70.26143790849673,Unisex
CHRISTY,1986,584,396,188,67.8082191780822,32.19178082191781,Unisex
SWANN,1986,8143,2279,5864,27.98722829424045,72.01277170575955,Unisex
JORDANE,1986,4682,1785,2897,38.12473302007689,61.875266979923104,Unisex
HYACINTHE,1986,4679,1173,3506,25.069459286172258,74.93054071382774,Unisex
LY,1986,327,215,112,65.74923547400611,34.25076452599388,Unisex
BERYL,1986,762,607,155,79.65879265091863,20.341207349081365,Unisex
DANY,1986,26027,7836,18191,30.10719637299728,69.89280362700273,Unisex
_PRENOMS_RARES,1986,1760252,908578,851674,51.616359475802334,48.38364052419767,Unisex
LOÏS,1986,11236,3416,7820,30.40227839088644,69.59772160911356,Unisex
JANIS,1986,1364,884,480,64.80938416422288,35.19061583577713,Unisex
THANH,1986,630,259,371,41.11111111111111,58.88888888888889,Unisex
MAELIG,1986,554,238,316,42.96028880866426,57.03971119133574,Unisex
ADAMA,1986,3805,1078,2727,28.3311432325887,71.6688567674113,Unisex
LENAIC,1986,1610,423,1187,26.27329192546584,73.72670807453416,Unisex
NGOC,1986,641,437,204,68.17472698907956,31.82527301092044,Unisex
AUDRY,1986,293,54,239,18.43003412969283,81.56996587030717,Unisex
YAEL,1986,6161,3036,3125,49.27771465671157,50.72228534328843,Unisex
VALENE,1987,5,5,0,100.0,0.0,Female
NASTASSJA,1987,7,7,0,100.0,0.0,Female
HAMIDE,1987,4,4,0,100.0,0.0,Female
CLIO,1987,36,36,0,100.0,0.0,Female
MANEL,1987,28,28,0,100.0,0.0,Female
SUZANE,1987,3,3,0,100.0,0.0,Female
MARIE-GABRIELLE,1987,15,15,0,100.0,0.0,Female
FILIZ,1987,32,32,0,100.0,0.0,Female
TATA,1987,4,4,0,100.0,0.0,Female
LORELEÏ,1987,10,10,0,100.0,0.0,Female
MARIE-SOPHIE,1987,82,82,0,100.0,0.0,Female
ANNE-MARINE,1987,4,4,0,100.0,0.0,Female
TO,1987,3,3,0,100.0,0.0,Female
ROKIA,1987,6,6,0,100.0,0.0,Female
KELTOUMA,1987,6,6,0,100.0,0.0,Female
HASIBA,1987,3,3,0,100.0,0.0,Female
ISMAHENE,1987,3,3,0,100.0,0.0,Female
CÉLESTINE,1987,3,3,0,100.0,0.0,Female
AISSIA,1987,3,3,0,100.0,0.0,Female
MALINA,1987,3,3,0,100.0,0.0,Female
CHRISLENE,1987,3,3,0,100.0,0.0,Female
LAURAINE,1987,5,5,0,100.0,0.0,Female
CHIRAZ,1987,11,11,0,100.0,0.0,Female
SOLVEIG,1987,20,20,0,100.0,0.0,Female
RADIA,1987,19,19,0,100.0,0.0,Female
PIERRE-DAMIEN,1987,4,0,4,0.0,100.0,Male
ABDELLATIF,1987,20,0,20,0.0,100.0,Male
STANY,1987,6,0,6,0.0,100.0,Male
BEKIR,1987,7,0,7,0.0,100.0,Male
DERICK,1987,3,0,3,0.0,100.0,Male
POL,1987,10,0,10,0.0,100.0,Male
MARICK,1987,5,0,5,0.0,100.0,Male
RITCHY,1987,7,0,7,0.0,100.0,Male
OCTAVE,1987,13,0,13,0.0,100.0,Male
CLYDE,1987,6,0,6,0.0,100.0,Male
NACIM,1987,32,0,32,0.0,100.0,Male
GWENDAL,1987,85,0,85,0.0,100.0,Male
GEORGES,1987,162,0,162,0.0,100.0,Male
AVI,1987,6,0,6,0.0,100.0,Male
OUALIDE,1987,4,0,4,0.0,100.0,Male
PIOTR,1987,4,0,4,0.0,100.0,Male
HAIKEL,1987,9,0,9,0.0,100.0,Male
NIMA,1987,7,0,7,0.0,100.0,Male
JEAN-ALEXIS,1987,10,0,10,0.0,100.0,Male
SORY,1987,4,0,4,0.0,100.0,Male
JOHANNES,1987,20,0,20,0.0,100.0,Male
MERLIN,1987,6,0,6,0.0,100.0,Male
BOUJEMAA,1987,4,0,4,0.0,100.0,Male
ABDELWAHED,1987,4,0,4,0.0,100.0,Male
ILKAY,1987,3,0,3,0.0,100.0,Male
JOHANNY,1987,547,133,414,24.314442413162705,75.68555758683729,Unisex
NIKITA,1987,1692,1106,586,65.36643026004728,34.63356973995272,Unisex
LE,1987,221,114,107,51.58371040723983,48.41628959276018,Unisex
MENDY,1987,1198,737,461,61.51919866444074,38.48080133555926,Unisex
REYHAN,1987,370,280,90,75.67567567567568,24.324324324324326,Unisex
MINH,1987,738,185,553,25.067750677506773,74.93224932249322,Unisex
JANICK,1987,4109,2203,1906,53.61401800924799,46.38598199075201,Unisex
HOANG,1987,383,125,258,32.637075718015666,67.36292428198433,Unisex
GWENN,1987,1848,1201,647,64.98917748917748,35.01082251082251,Unisex
THANH,1987,630,259,371,41.11111111111111,58.88888888888889,Unisex
AUDREN,1987,391,92,299,23.52941176470588,76.47058823529412,Unisex
GABY,1987,4741,2448,2293,51.63467622864375,48.36532377135626,Unisex
KRISTEN,1987,939,532,407,56.656017039403615,43.34398296059638,Unisex
LORY,1987,1231,941,290,76.44191714053615,23.55808285946385,Unisex
LORI,1987,430,327,103,76.04651162790698,23.953488372093023,Unisex
CAMILLE,1987,287709,207732,79977,72.20212089298562,27.79787910701437,Unisex
LY,1987,327,215,112,65.74923547400611,34.25076452599388,Unisex
_PRENOMS_RARES,1987,1760252,908578,851674,51.616359475802334,48.38364052419767,Unisex
ISLEM,1987,2699,701,1998,25.972582437939977,74.02741756206002,Unisex
DOMINIQUE,1987,409989,168027,241962,40.98329467375954,59.01670532624046,Unisex
STEVIE,1987,579,111,468,19.170984455958543,80.82901554404145,Unisex
AÏSSA,1987,1505,405,1100,26.91029900332225,73.08970099667775,Unisex
MADY,1987,2286,1197,1089,52.362204724409445,47.63779527559055,Unisex
LENAIC,1987,1610,423,1187,26.27329192546584,73.72670807453416,Unisex
HILAL,1987,1545,1011,534,65.4368932038835,34.56310679611651,Unisex
SHEERAZADE,1988,6,6,0,100.0,0.0,Female
SYLVANA,1988,24,24,0,100.0,0.0,Female
KRISTELLE,1988,16,16,0,100.0,0.0,Female
HEDWIGE,1988,7,7,0,100.0,0.0,Female
ALISSA,1988,14,14,0,100.0,0.0,Female
SOUADE,1988,9,9,0,100.0,0.0,Female
ELODY,1988,53,53,0,100.0,0.0,Female
ALESSIA,1988,4,4,0,100.0,0.0,Female
WASILA,1988,4,4,0,100.0,0.0,Female
DORSAF,1988,8,8,0,100.0,0.0,Female
INA,1988,4,4,0,100.0,0.0,Female
ARZU,1988,17,17,0,100.0,0.0,Female
HACINA,1988,4,4,0,100.0,0.0,Female
MARIE-HÉLÈNE,1988,79,79,0,100.0,0.0,Female
NAVY,1988,3,3,0,100.0,0.0,Female
TIFANNY,1988,10,10,0,100.0,0.0,Female
CLÉMENCE,1988,1525,1525,0,100.0,0.0,Female
PAULETTE,1988,8,8,0,100.0,0.0,Female
MÉLODY,1988,86,86,0,100.0,0.0,Female
TESS,1988,13,13,0,100.0,0.0,Female
GLORIA,1988,37,37,0,100.0,0.0,Female
ANTA,1988,5,5,0,100.0,0.0,Female
ROSANA,1988,5,5,0,100.0,0.0,Female
MARIJA,1988,6,6,0,100.0,0.0,Female
ELISE,1988,1520,1520,0,100.0,0.0,Female
AVRAHAM,1988,4,0,4,0.0,100.0,Male
CYRILLE,1988,38448,1590,36858,4.135455680399501,95.8645443196005,Male
AMAR,1988,72,0,72,0.0,100.0,Male
KAAN,1988,4,0,4,0.0,100.0,Male
BADREDINE,1988,5,0,5,0.0,100.0,Male
KILIAN,1988,38,0,38,0.0,100.0,Male
ANIS,1988,60,0,60,0.0,100.0,Male
ABDELWAHID,1988,3,0,3,0.0,100.0,Male
HUBERT,1988,133,0,133,0.0,100.0,Male
THEAU,1988,8,0,8,0.0,100.0,Male
REDDA,1988,4,0,4,0.0,100.0,Male
JOHNNY,1988,465,0,465,0.0,100.0,Male
FERREOL,1988,3,0,3,0.0,100.0,Male
MENAHEM,1988,5,0,5,0.0,100.0,Male
MOISE,1988,68,0,68,0.0,100.0,Male
FLORIAN,1988,5048,0,5048,0.0,100.0,Male
HOWARD,1988,4,0,4,0.0,100.0,Male
HICHEME,1988,7,0,7,0.0,100.0,Male
BAKARY,1988,22,0,22,0.0,100.0,Male
ENZO,1988,58,0,58,0.0,100.0,Male
JEAN-JOSEPH,1988,13,0,13,0.0,100.0,Male
VEDAT,1988,3,0,3,0.0,100.0,Male
MUHAMMED,1988,16,0,16,0.0,100.0,Male
ANASSE,1988,8,0,8,0.0,100.0,Male
NASSIR,1988,4,0,4,0.0,100.0,Male
DOMINIQUE,1988,409989,168027,241962,40.98329467375954,59.01670532624046,Unisex
CYRIEL,1988,332,116,216,34.93975903614458,65.06024096385542,Unisex
CAMILLE,1988,287709,207732,79977,72.20212089298562,27.79787910701437,Unisex
CAROL,1988,3507,2953,554,84.20302252637582,15.79697747362418,Unisex
JESSY,1988,17091,3993,13098,23.363173600140424,76.63682639985957,Unisex
GWEN,1988,941,419,522,44.52709883103082,55.47290116896918,Unisex
SOK,1988,70,29,41,41.42857142857143,58.57142857142858,Unisex
KIM,1988,6518,5270,1248,80.85302239950906,19.146977600490946,Unisex
ANAEL,1988,2957,1241,1716,41.96821102468719,58.031788975312814,Unisex
KAREL,1988,1060,233,827,21.9811320754717,78.01886792452831,Unisex
SYDNEY,1988,2101,1236,865,58.829128986197055,41.17087101380295,Unisex
THIEN,1988,171,63,108,36.84210526315789,63.1578947368421,Unisex
CLARENCE,1988,2943,924,2019,31.39653414882773,68.60346585117227,Unisex
DENIZ,1988,1954,675,1279,34.54452405322416,65.45547594677585,Unisex
KANDE,1988,209,98,111,46.889952153110045,53.11004784688996,Unisex
OUISSAM,1988,216,68,148,31.48148148148148,68.51851851851852,Unisex
SWANN,1988,8143,2279,5864,27.98722829424045,72.01277170575955,Unisex
WANDY,1988,132,60,72,45.45454545454545,54.54545454545454,Unisex
LENAÏC,1988,163,44,119,26.993865030674847,73.00613496932516,Unisex
LORI,1988,430,327,103,76.04651162790698,23.953488372093023,Unisex
SULTAN,1988,775,518,257,66.83870967741935,33.16129032258065,Unisex
_PRENOMS_RARES,1988,1760252,908578,851674,51.616359475802334,48.38364052419767,Unisex
WINDY,1988,436,359,77,82.33944954128441,17.660550458715598,Unisex
HOANG,1988,383,125,258,32.637075718015666,67.36292428198433,Unisex
JODY,1988,896,622,274,69.41964285714286,30.580357142857142,Unisex
CARLINE,1989,12,12,0,100.0,0.0,Female
MARCIE,1989,5,5,0,100.0,0.0,Female
ADÉLAIDE,1989,4,4,0,100.0,0.0,Female
ALMA,1989,12,12,0,100.0,0.0,Female
CANSU,1989,10,10,0,100.0,0.0,Female
ADÉLIE,1989,9,9,0,100.0,0.0,Female
CHRYSTELLE,1989,88,88,0,100.0,0.0,Female
EURYDICE,1989,14,14,0,100.0,0.0,Female
TIFANIE,1989,17,17,0,100.0,0.0,Female
FATOU,1989,45,45,0,100.0,0.0,Female
DONATIENNE,1989,4,4,0,100.0,0.0,Female
DOMITILLE,1989,72,72,0,100.0,0.0,Female
NEVIN,1989,3,3,0,100.0,0.0,Female
SOUNIA,1989,9,9,0,100.0,0.0,Female
GLAWDYS,1989,13,13,0,100.0,0.0,Female
HASSANA,1989,4,4,0,100.0,0.0,Female
JEHANNE,1989,18,18,0,100.0,0.0,Female
ROSELINE,1989,54,54,0,100.0,0.0,Female
ANNIE,1989,101,101,0,100.0,0.0,Female
VIOLÈNE,1989,5,5,0,100.0,0.0,Female
ANGELA,1989,146,146,0,100.0,0.0,Female
CHIMENE,1989,4,4,0,100.0,0.0,Female
NABILA,1989,113,113,0,100.0,0.0,Female
BILLIE,1989,8,8,0,100.0,0.0,Female
MAËVA,1989,112,112,0,100.0,0.0,Female
MORY,1989,7,0,7,0.0,100.0,Male
HUSEYIN,1989,31,0,31,0.0,100.0,Male
AMALRIC,1989,3,0,3,0.0,100.0,Male
CHAHIR,1989,3,0,3,0.0,100.0,Male
FAHEM,1989,10,0,10,0.0,100.0,Male
PAUL-HENRY,1989,7,0,7,0.0,100.0,Male
HOUSSINE,1989,7,0,7,0.0,100.0,Male
USMAN,1989,3,0,3,0.0,100.0,Male
MARCEAU,1989,20,0,20,0.0,100.0,Male
JEAN-DAVID,1989,48,0,48,0.0,100.0,Male
CHERIF,1989,31,0,31,0.0,100.0,Male
KERIM,1989,16,0,16,0.0,100.0,Male
DUY,1989,4,0,4,0.0,100.0,Male
ZAHER,1989,3,0,3,0.0,100.0,Male
SAIDOU,1989,13,0,13,0.0,100.0,Male
FRÉDÉRICK,1989,8,0,8,0.0,100.0,Male
OURY,1989,3,0,3,0.0,100.0,Male
AISSAM,1989,13,0,13,0.0,100.0,Male
MEVLUT,1989,5,0,5,0.0,100.0,Male
GEORGES-MARIE,1989,4,0,4,0.0,100.0,Male
VICTORIEN,1989,155,0,155,0.0,100.0,Male
DAN,1989,86,0,86,0.0,100.0,Male
ILIASS,1989,8,0,8,0.0,100.0,Male
ARSENE,1989,18,0,18,0.0,100.0,Male
ZORAN,1989,3,0,3,0.0,100.0,Male
LYSANDRE,1989,1858,363,1495,19.53713670613563,80.46286329386437,Unisex
GILLIAN,1989,947,327,620,34.53009503695882,65.46990496304119,Unisex
SIDNEY,1989,2484,951,1533,38.28502415458937,61.71497584541063,Unisex
HEIDY,1989,271,201,70,74.16974169741697,25.830258302583022,Unisex
ALVINE,1989,362,215,147,59.39226519337016,40.60773480662984,Unisex
LORY,1989,1231,941,290,76.44191714053615,23.55808285946385,Unisex
JANNICK,1989,2792,1545,1247,55.336676217765046,44.66332378223496,Unisex
LORI,1989,430,327,103,76.04651162790698,23.953488372093023,Unisex
SOK,1989,70,29,41,41.42857142857143,58.57142857142858,Unisex
DILAN,1989,1452,360,1092,24.793388429752067,75.20661157024794,Unisex
KENDY,1989,502,84,418,16.733067729083665,83.26693227091634,Unisex
WISSEM,1989,3049,682,2367,22.36798950475566,77.63201049524434,Unisex
MALEK,1989,3570,1060,2510,29.69187675070028,70.30812324929971,Unisex
CAROL,1989,3507,2953,554,84.20302252637582,15.79697747362418,Unisex
GABY,1989,4741,2448,2293,51.63467622864375,48.36532377135626,Unisex
JOHANNY,1989,547,133,414,24.314442413162705,75.68555758683729,Unisex
JANICK,1989,4109,2203,1906,53.61401800924799,46.38598199075201,Unisex
JILLIAN,1989,307,100,207,32.57328990228013,67.42671009771986,Unisex
CYRIEL,1989,332,116,216,34.93975903614458,65.06024096385542,Unisex
NIL,1989,1500,451,1049,30.06666666666667,69.93333333333334,Unisex
KIM,1989,6518,5270,1248,80.85302239950906,19.146977600490946,Unisex
SADIO,1989,1523,895,628,58.76559422193039,41.2344057780696,Unisex
JODY,1989,896,622,274,69.41964285714286,30.580357142857142,Unisex
FLORY,1989,195,123,72,63.07692307692307,36.92307692307693,Unisex
STEVIE,1989,579,111,468,19.170984455958543,80.82901554404145,Unisex
MAIWENN,1990,33,33,0,100.0,0.0,Female
AMAL,1990,3691,3538,153,95.8547819019236,4.145218098076402,Female
ANNE-SARAH,1990,5,5,0,100.0,0.0,Female
MUGUETTE,1990,3,3,0,100.0,0.0,Female
RAPHAËLA,1990,3,3,0,100.0,0.0,Female
ASMAE,1990,25,25,0,100.0,0.0,Female
STEFANIA,1990,3,3,0,100.0,0.0,Female
ANNAËLLE,1990,14,14,0,100.0,0.0,Female
SCHEHERAZADE,1990,17,17,0,100.0,0.0,Female
ROSE-MARIE,1990,34,34,0,100.0,0.0,Female
MAGNOLIA,1990,8,8,0,100.0,0.0,Female
MARIANNA,1990,11,11,0,100.0,0.0,Female
ANAELLE,1990,385,385,0,100.0,0.0,Female
SEMRA,1990,13,13,0,100.0,0.0,Female
SARRAH,1990,5,5,0,100.0,0.0,Female
LEONORA,1990,3,3,0,100.0,0.0,Female
ZELDA,1990,8,8,0,100.0,0.0,Female
SARATA,1990,3,3,0,100.0,0.0,Female
SOMALY,1990,5,5,0,100.0,0.0,Female
LOETITIA,1990,7,7,0,100.0,0.0,Female
LISA,1990,867,867,0,100.0,0.0,Female
FARIDA,1990,52,52,0,100.0,0.0,Female
OMBELINE,1990,54,54,0,100.0,0.0,Female
ROSELINE,1990,34,34,0,100.0,0.0,Female
DIANDRA,1990,8,8,0,100.0,0.0,Female
HISHAM,1990,3,0,3,0.0,100.0,Male
FIRAT,1990,7,0,7,0.0,100.0,Male
AYMARD,1990,3,0,3,0.0,100.0,Male
MERIC,1990,3,0,3,0.0,100.0,Male
BENAT,1990,3,0,3,0.0,100.0,Male
DRAGAN,1990,8,0,8,0.0,100.0,Male
OTTMAN,1990,6,0,6,0.0,100.0,Male
FRANCO,1990,4,0,4,0.0,100.0,Male
MODI,1990,5,0,5,0.0,100.0,Male
LOIK,1990,23,0,23,0.0,100.0,Male
MICHAËL,1990,137,0,137,0.0,100.0,Male
KARIM,1990,806,0,806,0.0,100.0,Male
ALEX,1990,31967,648,31319,2.02709043701317,97.97290956298684,Male
STEEVE,1990,317,0,317,0.0,100.0,Male
KURSAT,1990,3,0,3,0.0,100.0,Male
HERMAN,1990,11,0,11,0.0,100.0,Male
MASSIMILIANO,1990,3,0,3,0.0,100.0,Male
MOHAMAD,1990,12,0,12,0.0,100.0,Male
ILANE,1990,6,0,6,0.0,100.0,Male
ERDI,1990,6,0,6,0.0,100.0,Male
ABDELOUAHED,1990,4,0,4,0.0,100.0,Male
TOMAS,1990,18,0,18,0.0,100.0,Male
MOULOUD,1990,10,0,10,0.0,100.0,Male
KHALIFA,1990,4,0,4,0.0,100.0,Male
ICHEM,1990,14,0,14,0.0,100.0,Male
DANY,1990,26027,7836,18191,30.10719637299728,69.89280362700273,Unisex
SWANN,1990,8143,2279,5864,27.98722829424045,72.01277170575955,Unisex
JILLIAN,1990,307,100,207,32.57328990228013,67.42671009771986,Unisex
LENAIC,1990,1610,423,1187,26.27329192546584,73.72670807453416,Unisex
MADY,1990,2286,1197,1089,52.362204724409445,47.63779527559055,Unisex
_PRENOMS_RARES,1990,1760252,908578,851674,51.616359475802334,48.38364052419767,Unisex
SASHA,1990,18319,7736,10583,42.22937933293302,57.77062066706697,Unisex
ADAMA,1990,3805,1078,2727,28.3311432325887,71.6688567674113,Unisex
JORDANE,1990,4682,1785,2897,38.12473302007689,61.875266979923104,Unisex
MERRY,1990,368,220,148,59.78260869565217,40.21739130434783,Unisex
LENAICK,1990,695,402,293,57.84172661870504,42.15827338129496,Unisex
BERYL,1990,762,607,155,79.65879265091863,20.341207349081365,Unisex
MINH,1990,738,185,553,25.067750677506773,74.93224932249322,Unisex
ALIX,1990,37305,28371,8934,76.05146763168477,23.94853236831524,Unisex
MAELIG,1990,554,238,316,42.96028880866426,57.03971119133574,Unisex
CLARENCE,1990,2943,924,2019,31.39653414882773,68.60346585117227,Unisex
KIRAN,1990,385,66,319,17.142857142857142,82.85714285714286,Unisex
GABY,1990,4741,2448,2293,51.63467622864375,48.36532377135626,Unisex
SINA,1990,338,162,176,47.92899408284024,52.071005917159766,Unisex
SAPHIR,1990,587,109,478,18.56899488926746,81.43100511073254,Unisex
CAROL,1990,3507,2953,554,84.20302252637582,15.79697747362418,Unisex
ANAEL,1990,2957,1241,1716,41.96821102468719,58.031788975312814,Unisex
DOMINIQUE,1990,409989,168027,241962,40.98329467375954,59.01670532624046,Unisex
SIDNEY,1990,2484,951,1533,38.28502415458937,61.71497584541063,Unisex
HOANG,1990,383,125,258,32.637075718015666,67.36292428198433,Unisex
SIEGRID,1991,4,4,0,100.0,0.0,Female
ANGELIQUE,1991,1922,1922,0,100.0,0.0,Female
MELODINE,1991,4,4,0,100.0,0.0,Female
CERISE,1991,13,13,0,100.0,0.0,Female
OUMOU,1991,40,40,0,100.0,0.0,Female
CHANTAL,1991,51,51,0,100.0,0.0,Female
JULIETTE,1991,1364,1364,0,100.0,0.0,Female
ANNE-CAROLE,1991,3,3,0,100.0,0.0,Female
YVANNE,1991,4,4,0,100.0,0.0,Female
ANNECY,1991,8,8,0,100.0,0.0,Female
MARGAULT,1991,5,5,0,100.0,0.0,Female
THIPHAINE,1991,14,14,0,100.0,0.0,Female
LELIA,1991,16,16,0,100.0,0.0,Female
ALEXE,1991,4,4,0,100.0,0.0,Female
TENNESSEE,1991,6,6,0,100.0,0.0,Female
JOSIANE,1991,18,18,0,100.0,0.0,Female
KAROLINA,1991,4,4,0,100.0,0.0,Female
KADIDJA,1991,4,4,0,100.0,0.0,Female
MADISSON,1991,7,7,0,100.0,0.0,Female
EMIRA,1991,8,8,0,100.0,0.0,Female
SALOMÉ,1991,232,232,0,100.0,0.0,Female
MARGARET,1991,5,5,0,100.0,0.0,Female
PRÉSCILLIA,1991,4,4,0,100.0,0.0,Female
KAREN,1991,362,362,0,100.0,0.0,Female
GENA,1991,3,3,0,100.0,0.0,Female
RITCHIE,1991,11,0,11,0.0,100.0,Male
CYRUS,1991,5,0,5,0.0,100.0,Male
ABDELKADER,1991,98,0,98,0.0,100.0,Male
JEAN-MICKAEL,1991,12,0,12,0.0,100.0,Male
AMADOU,1991,53,0,53,0.0,100.0,Male
ZOUHAIR,1991,6,0,6,0.0,100.0,Male
YOANNE,1991,5,0,5,0.0,100.0,Male
KALED,1991,11,0,11,0.0,100.0,Male
LYDERIC,1991,9,0,9,0.0,100.0,Male
FADY,1991,5,0,5,0.0,100.0,Male
YONATHAN,1991,7,0,7,0.0,100.0,Male
GUNTER,1991,3,0,3,0.0,100.0,Male
ADNANE,1991,16,0,16,0.0,100.0,Male
BRENDON,1991,19,0,19,0.0,100.0,Male
MAREK,1991,11,0,11,0.0,100.0,Male
RAOUL,1991,25,0,25,0.0,100.0,Male
NADHIR,1991,4,0,4,0.0,100.0,Male
ULRIC,1991,17,0,17,0.0,100.0,Male
CHARLES-ADRIEN,1991,6,0,6,0.0,100.0,Male
YOËL,1991,3,0,3,0.0,100.0,Male
ZAKARIYA,1991,12,0,12,0.0,100.0,Male
HAROUNA,1991,24,0,24,0.0,100.0,Male
ABDERRAZAK,1991,3,0,3,0.0,100.0,Male
IVAN,1991,158,0,158,0.0,100.0,Male
LUCCA,1991,6,0,6,0.0,100.0,Male
CLARENCE,1991,2943,924,2019,31.39653414882773,68.60346585117227,Unisex
GABY,1991,4741,2448,2293,51.63467622864375,48.36532377135626,Unisex
LORY,1991,1231,941,290,76.44191714053615,23.55808285946385,Unisex
ISLEM,1991,2699,701,1998,25.972582437939977,74.02741756206002,Unisex
JIHAD,1991,692,175,517,25.289017341040463,74.71098265895954,Unisex
ARIEL,1991,2401,428,1973,17.8259058725531,82.17409412744689,Unisex
HAMIDA,1991,759,628,131,82.74044795783925,17.25955204216074,Unisex
ISA,1991,730,291,439,39.86301369863013,60.136986301369866,Unisex
CAROL,1991,3507,2953,554,84.20302252637582,15.79697747362418,Unisex
JOHANY,1991,273,57,216,20.87912087912088,79.12087912087912,Unisex
WISSEM,1991,3049,682,2367,22.36798950475566,77.63201049524434,Unisex
THANH,1991,630,259,371,41.11111111111111,58.88888888888889,Unisex
NGOC,1991,641,437,204,68.17472698907956,31.82527301092044,Unisex
DEVY,1991,290,45,245,15.517241379310343,84.48275862068965,Unisex
ISLAM,1991,1463,253,1210,17.293233082706767,82.70676691729322,Unisex
CHARLIE,1991,30211,15480,14731,51.23961470987389,48.76038529012611,Unisex
MALORY,1991,2305,1892,413,82.08242950108459,17.9175704989154,Unisex
THIEFAINE,1991,257,50,207,19.45525291828794,80.54474708171206,Unisex
JESSY,1991,17091,3993,13098,23.363173600140424,76.63682639985957,Unisex
MELAINE,1991,1656,1288,368,77.77777777777779,22.22222222222222,Unisex
KIRAN,1991,385,66,319,17.142857142857142,82.85714285714286,Unisex
CYRIEL,1991,332,116,216,34.93975903614458,65.06024096385542,Unisex
KIM,1991,6518,5270,1248,80.85302239950906,19.146977600490946,Unisex
ANAEL,1991,2957,1241,1716,41.96821102468719,58.031788975312814,Unisex
GWENN,1991,1848,1201,647,64.98917748917748,35.01082251082251,Unisex
LAMYA,1992,14,14,0,100.0,0.0,Female
MAURANE,1992,51,51,0,100.0,0.0,Female
EMEL,1992,21,21,0,100.0,0.0,Female
VALERIANNE,1992,7,7,0,100.0,0.0,Female
IBTISAM,1992,4,4,0,100.0,0.0,Female
RAHIME,1992,4,4,0,100.0,0.0,Female
YOSSRA,1992,4,4,0,100.0,0.0,Female
ELIZABETH,1992,41,41,0,100.0,0.0,Female
MARIATOU,1992,6,6,0,100.0,0.0,Female
ANNECY,1992,3,3,0,100.0,0.0,Female
STEFANIE,1992,9,9,0,100.0,0.0,Female
RACHELLE,1992,48,48,0,100.0,0.0,Female
KAOUTHAR,1992,10,10,0,100.0,0.0,Female
MARIE-BENEDICTE,1992,4,4,0,100.0,0.0,Female
CAROL-ANN,1992,8,8,0,100.0,0.0,Female
YOLINE,1992,5,5,0,100.0,0.0,Female
AYCAN,1992,3,3,0,100.0,0.0,Female
NAIKA,1992,3,3,0,100.0,0.0,Female
MADYSON,1992,6,6,0,100.0,0.0,Female
YMEN,1992,3,3,0,100.0,0.0,Female
OMBLINE,1992,6,6,0,100.0,0.0,Female
HEIDI,1992,2746,2480,266,90.31318281136198,9.68681718863802,Female
PRISCILIA,1992,57,57,0,100.0,0.0,Female
NOUR-EL-HOUDA,1992,3,3,0,100.0,0.0,Female
GERALDINE,1992,195,195,0,100.0,0.0,Female
SIDOINE,1992,4,0,4,0.0,100.0,Male
RONNY,1992,21,0,21,0.0,100.0,Male
RAFIK,1992,33,0,33,0.0,100.0,Male
BRIVAEL,1992,4,0,4,0.0,100.0,Male
ABDENOUR,1992,3,0,3,0.0,100.0,Male
MILOUD,1992,28,0,28,0.0,100.0,Male
WARREN,1992,103,0,103,0.0,100.0,Male
VIRGILE,1992,125,0,125,0.0,100.0,Male
JEAN-MANUEL,1992,6,0,6,0.0,100.0,Male
MARC,1992,1153,0,1153,0.0,100.0,Male
GIREG,1992,5,0,5,0.0,100.0,Male
SANDRO,1992,31,0,31,0.0,100.0,Male
KENNETH,1992,9,0,9,0.0,100.0,Male
MOHAND,1992,10,0,10,0.0,100.0,Male
JAWED,1992,11,0,11,0.0,100.0,Male
SELCUK,1992,7,0,7,0.0,100.0,Male
BRENDON,1992,21,0,21,0.0,100.0,Male
TIMO,1992,8,0,8,0.0,100.0,Male
MESUT,1992,24,0,24,0.0,100.0,Male
BRAHIMA,1992,7,0,7,0.0,100.0,Male
SKANDER,1992,7,0,7,0.0,100.0,Male
AKIN,1992,5,0,5,0.0,100.0,Male
BERANGER,1992,19,0,19,0.0,100.0,Male
FLAVIAN,1992,12,0,12,0.0,100.0,Male
MAIXENT,1992,5,0,5,0.0,100.0,Male
ANGY,1992,571,264,307,46.234676007005255,53.76532399299475,Unisex
LIOR,1992,1001,172,829,17.182817182817185,82.81718281718283,Unisex
JOHANNY,1992,547,133,414,24.314442413162705,75.68555758683729,Unisex
AMOUR,1992,782,287,495,36.70076726342711,63.29923273657288,Unisex
ISLAM,1992,1463,253,1210,17.293233082706767,82.70676691729322,Unisex
JIHAD,1992,692,175,517,25.289017341040463,74.71098265895954,Unisex
MERYLL,1992,335,258,77,77.01492537313432,22.98507462686567,Unisex
WINDY,1992,436,359,77,82.33944954128441,17.660550458715598,Unisex
HYACINTHE,1992,4679,1173,3506,25.069459286172258,74.93054071382774,Unisex
NEHEMIE,1992,469,250,219,53.30490405117271,46.695095948827294,Unisex
KIM,1992,6518,5270,1248,80.85302239950906,19.146977600490946,Unisex
_PRENOMS_RARES,1992,1760252,908578,851674,51.616359475802334,48.38364052419767,Unisex
JODY,1992,896,622,274,69.41964285714286,30.580357142857142,Unisex
DILAN,1992,1452,360,1092,24.793388429752067,75.20661157024794,Unisex
STEVIE,1992,579,111,468,19.170984455958543,80.82901554404145,Unisex
LORRY,1992,389,169,220,43.44473007712082,56.555269922879184,Unisex
LENAIC,1992,1610,423,1187,26.27329192546584,73.72670807453416,Unisex
NGOC,1992,641,437,204,68.17472698907956,31.82527301092044,Unisex
NIL,1992,1500,451,1049,30.06666666666667,69.93333333333334,Unisex
SYDNEY,1992,2101,1236,865,58.829128986197055,41.17087101380295,Unisex
LOUISON,1992,11456,6222,5234,54.31215083798882,45.687849162011176,Unisex
MENDY,1992,1198,737,461,61.51919866444074,38.48080133555926,Unisex
JAMIE,1992,683,155,528,22.69399707174232,77.30600292825768,Unisex
NIKITA,1992,1692,1106,586,65.36643026004728,34.63356973995272,Unisex
GWEN,1992,941,419,522,44.52709883103082,55.47290116896918,Unisex
ALEXINE,1993,19,19,0,100.0,0.0,Female
HEINDA,1993,3,3,0,100.0,0.0,Female
SAMIA,1993,244,244,0,100.0,0.0,Female
BOUCHRA,1993,45,45,0,100.0,0.0,Female
IHSANE,1993,8,8,0,100.0,0.0,Female
SELIMA,1993,3,3,0,100.0,0.0,Female
SOLEINE,1993,3,3,0,100.0,0.0,Female
MAEVANE,1993,5,5,0,100.0,0.0,Female
HANIFE,1993,5,5,0,100.0,0.0,Female
GRACINDA,1993,3,3,0,100.0,0.0,Female
NELLIE,1993,3,3,0,100.0,0.0,Female
DALLA,1993,7,7,0,100.0,0.0,Female
RAPHAELLA,1993,9,9,0,100.0,0.0,Female
MAWA,1993,3,3,0,100.0,0.0,Female
CHAHRA,1993,3,3,0,100.0,0.0,Female
MAJDELINE,1993,8,8,0,100.0,0.0,Female
RAPHAËLLA,1993,3,3,0,100.0,0.0,Female
ORLINE,1993,3,3,0,100.0,0.0,Female
CLOE,1993,208,208,0,100.0,0.0,Female
ELIZA,1993,7,7,0,100.0,0.0,Female
SELINE,1993,4,4,0,100.0,0.0,Female
CHARLAYNE,1993,5,5,0,100.0,0.0,Female
AMARYLLIS,1993,8,8,0,100.0,0.0,Female
MARGUERITE,1993,93,93,0,100.0,0.0,Female
ILIANA,1993,7,7,0,100.0,0.0,Female
CARLTON,1993,3,0,3,0.0,100.0,Male
JEAN-MICKAEL,1993,8,0,8,0.0,100.0,Male
YACINE,1993,16303,325,15978,1.9934981291786784,98.00650187082132,Male
NELSON,1993,174,0,174,0.0,100.0,Male
SATCHEL,1993,3,0,3,0.0,100.0,Male
YAYA,1993,16,0,16,0.0,100.0,Male
ALEXIAN,1993,7,0,7,0.0,100.0,Male
JOSEPH,1993,341,0,341,0.0,100.0,Male
HOUARI,1993,11,0,11,0.0,100.0,Male
JURGEN,1993,5,0,5,0.0,100.0,Male
YANICK,1993,4,0,4,0.0,100.0,Male
SAIF,1993,6,0,6,0.0,100.0,Male
FODE,1993,8,0,8,0.0,100.0,Male
ACHRAF,1993,53,0,53,0.0,100.0,Male
LORIC,1993,12,0,12,0.0,100.0,Male
ANDRÉAS,1993,4,0,4,0.0,100.0,Male
BENYAMINE,1993,4,0,4,0.0,100.0,Male
LYES,1993,53,0,53,0.0,100.0,Male
NEEL,1993,3,0,3,0.0,100.0,Male
YORAM,1993,5,0,5,0.0,100.0,Male
ERICKSON,1993,4,0,4,0.0,100.0,Male
TAIEB,1993,5,0,5,0.0,100.0,Male
LEVENT,1993,9,0,9,0.0,100.0,Male
MADANI,1993,7,0,7,0.0,100.0,Male
COLAS,1993,16,0,16,0.0,100.0,Male
WISSAM,1993,2491,451,2040,18.105178643115213,81.89482135688479,Unisex
SUNDY,1993,144,110,34,76.38888888888889,23.61111111111111,Unisex
YAEL,1993,6161,3036,3125,49.27771465671157,50.72228534328843,Unisex
JESSY,1993,17091,3993,13098,23.363173600140424,76.63682639985957,Unisex
MALORY,1993,2305,1892,413,82.08242950108459,17.9175704989154,Unisex
ANGY,1993,571,264,307,46.234676007005255,53.76532399299475,Unisex
HILAL,1993,1545,1011,534,65.4368932038835,34.56310679611651,Unisex
LOANN,1993,4020,941,3079,23.40796019900497,76.59203980099502,Unisex
DENIZ,1993,1954,675,1279,34.54452405322416,65.45547594677585,Unisex
CORY,1993,280,100,180,35.714285714285715,64.28571428571429,Unisex
MENDY,1993,1198,737,461,61.51919866444074,38.48080133555926,Unisex
STEVIE,1993,579,111,468,19.170984455958543,80.82901554404145,Unisex
CHARLIE,1993,30211,15480,14731,51.23961470987389,48.76038529012611,Unisex
LEE,1993,538,203,335,37.732342007434944,62.26765799256505,Unisex
MADY,1993,2286,1197,1089,52.362204724409445,47.63779527559055,Unisex
SASHA,1993,18319,7736,10583,42.22937933293302,57.77062066706697,Unisex
CYRIEL,1993,332,116,216,34.93975903614458,65.06024096385542,Unisex
MELAINE,1993,1656,1288,368,77.77777777777779,22.22222222222222,Unisex
OUISSEM,1993,307,57,250,18.56677524429968,81.43322475570032,Unisex
GABY,1993,4741,2448,2293,51.63467622864375,48.36532377135626,Unisex
DOMINIQUE,1993,409989,168027,241962,40.98329467375954,59.01670532624046,Unisex
JASMIN,1993,917,170,747,18.538713195201744,81.46128680479825,Unisex
HYACINTHE,1993,4679,1173,3506,25.069459286172258,74.93054071382774,Unisex
GLOIRE,1993,285,107,178,37.54385964912281,62.4561403508772,Unisex
WALLIS,1993,197,118,79,59.89847715736041,40.10152284263959,Unisex
EMILIE,1994,3214,3214,0,100.0,0.0,Female
MANALE,1994,7,7,0,100.0,0.0,Female
NICOLE,1994,33,33,0,100.0,0.0,Female
SHANEZE,1994,4,4,0,100.0,0.0,Female
MARIE-LOU,1994,77,77,0,100.0,0.0,Female
MARIKA,1994,21,21,0,100.0,0.0,Female
CHEIMA,1994,14,14,0,100.0,0.0,Female
VERENA,1994,7,7,0,100.0,0.0,Female
STELLY,1994,13,13,0,100.0,0.0,Female
ALISIA,1994,3,3,0,100.0,0.0,Female
NAELLA,1994,3,3,0,100.0,0.0,Female
AMNA,1994,4,4,0,100.0,0.0,Female
KHADRA,1994,5,5,0,100.0,0.0,Female
SHIREL,1994,3,3,0,100.0,0.0,Female
HAYA-MOUCHKA,1994,6,6,0,100.0,0.0,Female
ALYCIA,1994,65,65,0,100.0,0.0,Female
SERAPHINE,1994,6,6,0,100.0,0.0,Female
EVELYSE,1994,3,3,0,100.0,0.0,Female
COLEEN,1994,5,5,0,100.0,0.0,Female
MAJDOULINE,1994,8,8,0,100.0,0.0,Female
ANGÉLICA,1994,4,4,0,100.0,0.0,Female
AGNÈS,1994,191,191,0,100.0,0.0,Female
YVELINE,1994,5,5,0,100.0,0.0,Female
ELSA,1994,615,615,0,100.0,0.0,Female
EVANGELINE,1994,12,12,0,100.0,0.0,Female
JHONNY,1994,5,0,5,0.0,100.0,Male
ABOUBAKER,1994,3,0,3,0.0,100.0,Male
RAOUL,1994,24,0,24,0.0,100.0,Male
OGUZHAN,1994,12,0,12,0.0,100.0,Male
JAID,1994,3,0,3,0.0,100.0,Male
SULLYVANN,1994,3,0,3,0.0,100.0,Male
NINO,1994,39,0,39,0.0,100.0,Male
WASSIME,1994,5,0,5,0.0,100.0,Male
NAOUFEL,1994,8,0,8,0.0,100.0,Male
BRUNO,1994,454,0,454,0.0,100.0,Male
LIAM,1994,42038,160,41878,0.3806080213140492,99.61939197868595,Male
SWAN,1994,5865,639,5226,10.895140664961636,89.10485933503837,Male
LASSANA,1994,25,0,25,0.0,100.0,Male
HACHIM,1994,5,0,5,0.0,100.0,Male
JIMMY-LEE,1994,5,0,5,0.0,100.0,Male
OTHMAN,1994,34,0,34,0.0,100.0,Male
LORENZ,1994,4,0,4,0.0,100.0,Male
CALVIN,1994,38,0,38,0.0,100.0,Male
EVENS,1994,9,0,9,0.0,100.0,Male
RENATO,1994,5,0,5,0.0,100.0,Male
HEINRICK,1994,3,0,3,0.0,100.0,Male
MOHAMED-SALAH,1994,4,0,4,0.0,100.0,Male
TIMOUR,1994,9,0,9,0.0,100.0,Male
EBU,1994,3,0,3,0.0,100.0,Male
RIADH,1994,6,0,6,0.0,100.0,Male
NEHEMIE,1994,469,250,219,53.30490405117271,46.695095948827294,Unisex
KENDY,1994,502,84,418,16.733067729083665,83.26693227091634,Unisex
IHSANE,1994,689,439,250,63.7155297532656,36.2844702467344,Unisex
DARA,1994,349,151,198,43.26647564469914,56.73352435530086,Unisex
BRANDY,1994,283,198,85,69.96466431095406,30.03533568904594,Unisex
JASMIN,1994,917,170,747,18.538713195201744,81.46128680479825,Unisex
DENIZ,1994,1954,675,1279,34.54452405322416,65.45547594677585,Unisex
NIKITA,1994,1692,1106,586,65.36643026004728,34.63356973995272,Unisex
HEIDY,1994,271,201,70,74.16974169741697,25.830258302583022,Unisex
TAYLOR,1994,1722,499,1223,28.977932636469223,71.02206736353078,Unisex
ANAEL,1994,2957,1241,1716,41.96821102468719,58.031788975312814,Unisex
LENAIC,1994,1610,423,1187,26.27329192546584,73.72670807453416,Unisex
_PRENOMS_RARES,1994,1760252,908578,851674,51.616359475802334,48.38364052419767,Unisex
MENDY,1994,1198,737,461,61.51919866444074,38.48080133555926,Unisex
STEVIE,1994,579,111,468,19.170984455958543,80.82901554404145,Unisex
WISSAM,1994,2491,451,2040,18.105178643115213,81.89482135688479,Unisex
DILAN,1994,1452,360,1092,24.793388429752067,75.20661157024794,Unisex
CLARENCE,1994,2943,924,2019,31.39653414882773,68.60346585117227,Unisex
CHARLIE,1994,30211,15480,14731,51.23961470987389,48.76038529012611,Unisex
LYSANDRE,1994,1858,363,1495,19.53713670613563,80.46286329386437,Unisex
SASHA,1994,18319,7736,10583,42.22937933293302,57.77062066706697,Unisex
TENNESSEE,1994,361,232,129,64.26592797783933,35.73407202216066,Unisex
OUISSAM,1994,216,68,148,31.48148148148148,68.51851851851852,Unisex
SYDNEY,1994,2101,1236,865,58.829128986197055,41.17087101380295,Unisex
ISA,1994,730,291,439,39.86301369863013,60.136986301369866,Unisex
MARIE-LAURE,1995,95,95,0,100.0,0.0,Female
MARIE-JACQUELINE,1995,3,3,0,100.0,0.0,Female
SHIRLEY,1995,155,155,0,100.0,0.0,Female
ANICEE,1995,3,3,0,100.0,0.0,Female
LIVIANA,1995,4,4,0,100.0,0.0,Female
BADIALLO,1995,3,3,0,100.0,0.0,Female
KAREN,1995,264,264,0,100.0,0.0,Female
NAYLA,1995,6,6,0,100.0,0.0,Female
NAOEL,1995,3,3,0,100.0,0.0,Female
GABRIELLE,1995,439,439,0,100.0,0.0,Female
LOREENA,1995,7,7,0,100.0,0.0,Female
ESTELLE,1995,2127,2127,0,100.0,0.0,Female
KAWTHAR,1995,9,9,0,100.0,0.0,Female
LYNA,1995,27,27,0,100.0,0.0,Female
KHADIJA,1995,97,97,0,100.0,0.0,Female
HOMBELINE,1995,5,5,0,100.0,0.0,Female
MEGANE,1995,2253,2253,0,100.0,0.0,Female
NIVINE,1995,4,4,0,100.0,0.0,Female
TYPHENE,1995,6,6,0,100.0,0.0,Female
VINCIANE,1995,42,42,0,100.0,0.0,Female
LILLA,1995,4,4,0,100.0,0.0,Female
LENORA,1995,5,5,0,100.0,0.0,Female
MINDY,1995,5,5,0,100.0,0.0,Female
WEENA,1995,3,3,0,100.0,0.0,Female
TIPHAINE,1995,18935,18636,299,98.42091365196724,1.5790863480327435,Female
KENDAL,1995,3,0,3,0.0,100.0,Male
URBAIN,1995,4,0,4,0.0,100.0,Male
IMRANE,1995,14,0,14,0.0,100.0,Male
AIMERIC,1995,33,0,33,0.0,100.0,Male
BADREDDINE,1995,5,0,5,0.0,100.0,Male
JAUFREY,1995,3,0,3,0.0,100.0,Male
JEAN-FABIEN,1995,3,0,3,0.0,100.0,Male
JOFREY,1995,6,0,6,0.0,100.0,Male
HOUSSEM,1995,13,0,13,0.0,100.0,Male
BENYAMIN,1995,3,0,3,0.0,100.0,Male
JOÉ,1995,11,0,11,0.0,100.0,Male
MEDERICK,1995,21,0,21,0.0,100.0,Male
SCOTTY,1995,27,0,27,0.0,100.0,Male
EWAN,1995,15,0,15,0.0,100.0,Male
MEIR,1995,7,0,7,0.0,100.0,Male
JORDI,1995,18,0,18,0.0,100.0,Male
STIVEN,1995,12,0,12,0.0,100.0,Male
ABDULLAH,1995,28,0,28,0.0,100.0,Male
KEWIN,1995,8,0,8,0.0,100.0,Male
YOAN,1995,506,0,506,0.0,100.0,Male
POL,1995,33,0,33,0.0,100.0,Male
LEWIS,1995,23,0,23,0.0,100.0,Male
ANESS,1995,5,0,5,0.0,100.0,Male
LOÏC,1995,2454,0,2454,0.0,100.0,Male
JEAN-DIDIER,1995,6,0,6,0.0,100.0,Male
NIL,1995,1500,451,1049,30.06666666666667,69.93333333333334,Unisex
WISSAM,1995,2491,451,2040,18.105178643115213,81.89482135688479,Unisex
JOHANY,1995,273,57,216,20.87912087912088,79.12087912087912,Unisex
GABY,1995,4741,2448,2293,51.63467622864375,48.36532377135626,Unisex
LY,1995,327,215,112,65.74923547400611,34.25076452599388,Unisex
MALEK,1995,3570,1060,2510,29.69187675070028,70.30812324929971,Unisex
HILAL,1995,1545,1011,534,65.4368932038835,34.56310679611651,Unisex
NIKITA,1995,1692,1106,586,65.36643026004728,34.63356973995272,Unisex
SHANE,1995,479,136,343,28.39248434237996,71.60751565762004,Unisex
JANIS,1995,1364,884,480,64.80938416422288,35.19061583577713,Unisex
HOANG,1995,383,125,258,32.637075718015666,67.36292428198433,Unisex
DILAN,1995,1452,360,1092,24.793388429752067,75.20661157024794,Unisex
NAHID,1995,264,128,136,48.48484848484848,51.51515151515152,Unisex
KIM,1995,6518,5270,1248,80.85302239950906,19.146977600490946,Unisex
EDEN,1995,33510,11200,22310,33.422858848105044,66.57714115189496,Unisex
SWANN,1995,8143,2279,5864,27.98722829424045,72.01277170575955,Unisex
LOUISON,1995,11456,6222,5234,54.31215083798882,45.687849162011176,Unisex
MADY,1995,2286,1197,1089,52.362204724409445,47.63779527559055,Unisex
ISLAM,1995,1463,253,1210,17.293233082706767,82.70676691729322,Unisex
ANAEL,1995,2957,1241,1716,41.96821102468719,58.031788975312814,Unisex
SASHA,1995,18319,7736,10583,42.22937933293302,57.77062066706697,Unisex
DANY,1995,26027,7836,18191,30.10719637299728,69.89280362700273,Unisex
JESSY,1995,17091,3993,13098,23.363173600140424,76.63682639985957,Unisex
ARIEL,1995,2401,428,1973,17.8259058725531,82.17409412744689,Unisex
YAEL,1995,6161,3036,3125,49.27771465671157,50.72228534328843,Unisex
SYNDELLE,1996,4,4,0,100.0,0.0,Female
NADIA,1996,289,289,0,100.0,0.0,Female
ALIENOR,1996,78,78,0,100.0,0.0,Female
SALOMEE,1996,20,20,0,100.0,0.0,Female
KAOUTHAR,1996,13,13,0,100.0,0.0,Female
ADRIANA,1996,40,40,0,100.0,0.0,Female
MICHAELA,1996,17,17,0,100.0,0.0,Female
AHLAME,1996,8,8,0,100.0,0.0,Female
MYLEE,1996,3,3,0,100.0,0.0,Female
LOREENA,1996,7,7,0,100.0,0.0,Female
TAÏNA,1996,6,6,0,100.0,0.0,Female
ZELDA,1996,14,14,0,100.0,0.0,Female
EA,1996,3,3,0,100.0,0.0,Female
NAIKA,1996,5,5,0,100.0,0.0,Female
NAWELL,1996,8,8,0,100.0,0.0,Female
LOUANN,1996,3,3,0,100.0,0.0,Female
LOU-ANNE,1996,40,40,0,100.0,0.0,Female
FELICIA,1996,54,54,0,100.0,0.0,Female
SERENAY,1996,3,3,0,100.0,0.0,Female
ANGÉLINA,1996,47,47,0,100.0,0.0,Female
ISADORA,1996,12,12,0,100.0,0.0,Female
ALYSSA,1996,96,96,0,100.0,0.0,Female
INESSE,1996,16,16,0,100.0,0.0,Female
NAIDA,1996,8,8,0,100.0,0.0,Female
OIHANA,1996,18,18,0,100.0,0.0,Female
BEYTULLAH,1996,3,0,3,0.0,100.0,Male
YOANN,1996,890,0,890,0.0,100.0,Male
CHAI,1996,6,0,6,0.0,100.0,Male
SAFWAN,1996,7,0,7,0.0,100.0,Male
HALIT,1996,7,0,7,0.0,100.0,Male
KERIAN,1996,25,0,25,0.0,100.0,Male
LOUIS-PAUL,1996,9,0,9,0.0,100.0,Male
HEDDY,1996,14,0,14,0.0,100.0,Male
MALIC,1996,3,0,3,0.0,100.0,Male
RIYAD,1996,35,0,35,0.0,100.0,Male
MARVEEN,1996,16,0,16,0.0,100.0,Male
JAOUED,1996,3,0,3,0.0,100.0,Male
ABOUBAKR,1996,3,0,3,0.0,100.0,Male
MADANI,1996,5,0,5,0.0,100.0,Male
HEDDI,1996,7,0,7,0.0,100.0,Male
OSSAMA,1996,26,0,26,0.0,100.0,Male
SAIDOU,1996,9,0,9,0.0,100.0,Male
ANTHONIO,1996,3,0,3,0.0,100.0,Male
MAREK,1996,13,0,13,0.0,100.0,Male
TINO,1996,16,0,16,0.0,100.0,Male
SEVERIN,1996,15,0,15,0.0,100.0,Male
JEAN-SAMUEL,1996,4,0,4,0.0,100.0,Male
YVES,1996,99,0,99,0.0,100.0,Male
YOUN,1996,7,0,7,0.0,100.0,Male
ASSIM,1996,3,0,3,0.0,100.0,Male
MELAINE,1996,1656,1288,368,77.77777777777779,22.22222222222222,Unisex
JODY,1996,896,622,274,69.41964285714286,30.580357142857142,Unisex
DILAN,1996,1452,360,1092,24.793388429752067,75.20661157024794,Unisex
THANH,1996,630,259,371,41.11111111111111,58.88888888888889,Unisex
MALORY,1996,2305,1892,413,82.08242950108459,17.9175704989154,Unisex
JORDANE,1996,4682,1785,2897,38.12473302007689,61.875266979923104,Unisex
WISSAM,1996,2491,451,2040,18.105178643115213,81.89482135688479,Unisex
TENNESSEE,1996,361,232,129,64.26592797783933,35.73407202216066,Unisex
CHRISTY,1996,584,396,188,67.8082191780822,32.19178082191781,Unisex
CLARENCE,1996,2943,924,2019,31.39653414882773,68.60346585117227,Unisex
ISLAM,1996,1463,253,1210,17.293233082706767,82.70676691729322,Unisex
MALLORY,1996,2883,2151,732,74.60978147762746,25.390218522372525,Unisex
JILLIAN,1996,307,100,207,32.57328990228013,67.42671009771986,Unisex
NEHEMIE,1996,469,250,219,53.30490405117271,46.695095948827294,Unisex
IHSANE,1996,689,439,250,63.7155297532656,36.2844702467344,Unisex
KILIANE,1996,361,106,255,29.362880886426595,70.6371191135734,Unisex
HYACINTHE,1996,4679,1173,3506,25.069459286172258,74.93054071382774,Unisex
HILAL,1996,1545,1011,534,65.4368932038835,34.56310679611651,Unisex
WALLIS,1996,197,118,79,59.89847715736041,40.10152284263959,Unisex
MINH,1996,738,185,553,25.067750677506773,74.93224932249322,Unisex
JESSY,1996,17091,3993,13098,23.363173600140424,76.63682639985957,Unisex
MORGANN,1996,1229,459,770,37.34743694060212,62.65256305939788,Unisex
JASMIN,1996,917,170,747,18.538713195201744,81.46128680479825,Unisex
ANAEL,1996,2957,1241,1716,41.96821102468719,58.031788975312814,Unisex
MENDY,1996,1198,737,461,61.51919866444074,38.48080133555926,Unisex
SÉRAPHINE,1997,3,3,0,100.0,0.0,Female
SCHERAZADE,1997,4,4,0,100.0,0.0,Female
GUILA,1997,6,6,0,100.0,0.0,Female
DOREEN,1997,14,14,0,100.0,0.0,Female
GABRIELLE,1997,496,496,0,100.0,0.0,Female
FLOSSIE,1997,3,3,0,100.0,0.0,Female
TYPHAINE,1997,173,173,0,100.0,0.0,Female
JESSIE,1997,6164,5581,583,90.5418559377028,9.45814406229721,Female
ALIXE,1997,11,11,0,100.0,0.0,Female
HAJIRA,1997,3,3,0,100.0,0.0,Female
EMI,1997,4,4,0,100.0,0.0,Female
SEDEF,1997,3,3,0,100.0,0.0,Female
MEGANNE,1997,8,8,0,100.0,0.0,Female
AVRIL,1997,6,6,0,100.0,0.0,Female
DÉLIA,1997,7,7,0,100.0,0.0,Female
FLORE-ANNE,1997,3,3,0,100.0,0.0,Female
LUCYLE,1997,13,13,0,100.0,0.0,Female
MAIALEN,1997,13,13,0,100.0,0.0,Female
KATHIA,1997,7,7,0,100.0,0.0,Female
MARIA,1997,152,152,0,100.0,0.0,Female
CATHIE,1997,14,14,0,100.0,0.0,Female
SAHAR,1997,8,8,0,100.0,0.0,Female
LILLY,1997,9,9,0,100.0,0.0,Female
ENORA,1997,257,257,0,100.0,0.0,Female
WAHIBA,1997,10,10,0,100.0,0.0,Female
KYLE,1997,10,0,10,0.0,100.0,Male
ERIC,1997,334,0,334,0.0,100.0,Male
MOÏSE,1997,15,0,15,0.0,100.0,Male
KHEPHREN,1997,4,0,4,0.0,100.0,Male
ELON,1997,3,0,3,0.0,100.0,Male
ALEXI,1997,56,0,56,0.0,100.0,Male
ALAE,1997,3,0,3,0.0,100.0,Male
MATTHÉO,1997,12,0,12,0.0,100.0,Male
YARON,1997,5,0,5,0.0,100.0,Male
BRYANN,1997,11,0,11,0.0,100.0,Male
KOCEILA,1997,3,0,3,0.0,100.0,Male
ZAHER,1997,3,0,3,0.0,100.0,Male
JASON,1997,1060,0,1060,0.0,100.0,Male
JAMI,1997,4,0,4,0.0,100.0,Male
WULFRAN,1997,3,0,3,0.0,100.0,Male
NAMORY,1997,3,0,3,0.0,100.0,Male
EL,1997,3494,326,3168,9.33028048082427,90.66971951917571,Male
ENIS,1997,4,0,4,0.0,100.0,Male
EMERYCK,1997,4,0,4,0.0,100.0,Male
ORIAN,1997,8,0,8,0.0,100.0,Male
NOHAM,1997,26,0,26,0.0,100.0,Male
FABRICIO,1997,3,0,3,0.0,100.0,Male
KENDJY,1997,3,0,3,0.0,100.0,Male
NACER-EDDINE,1997,3,0,3,0.0,100.0,Male
YONI,1997,29,0,29,0.0,100.0,Male
YAËL,1997,3502,1564,1938,44.66019417475729,55.33980582524271,Unisex
ADAMA,1997,3805,1078,2727,28.3311432325887,71.6688567674113,Unisex
MORGANN,1997,1229,459,770,37.34743694060212,62.65256305939788,Unisex
LORI,1997,430,327,103,76.04651162790698,23.953488372093023,Unisex
YAEL,1997,6161,3036,3125,49.27771465671157,50.72228534328843,Unisex
JANIS,1997,1364,884,480,64.80938416422288,35.19061583577713,Unisex
ANAEL,1997,2957,1241,1716,41.96821102468719,58.031788975312814,Unisex
FARA,1997,251,169,82,67.33067729083665,32.669322709163346,Unisex
CHRISTY,1997,584,396,188,67.8082191780822,32.19178082191781,Unisex
SADIO,1997,1523,895,628,58.76559422193039,41.2344057780696,Unisex
SWANN,1997,8143,2279,5864,27.98722829424045,72.01277170575955,Unisex
EDEN,1997,33510,11200,22310,33.422858848105044,66.57714115189496,Unisex
AMARA,1997,1568,601,967,38.329081632653065,61.670918367346935,Unisex
MADIGAN,1997,78,35,43,44.87179487179488,55.12820512820513,Unisex
LOÏS,1997,11236,3416,7820,30.40227839088644,69.59772160911356,Unisex
KAREL,1997,1060,233,827,21.9811320754717,78.01886792452831,Unisex
CAMILLE,1997,287709,207732,79977,72.20212089298562,27.79787910701437,Unisex
LORY,1997,1231,941,290,76.44191714053615,23.55808285946385,Unisex
KENZY,1997,1392,384,1008,27.58620689655172,72.41379310344827,Unisex
LÉNAÏC,1997,409,93,316,22.73838630806846,77.26161369193154,Unisex
NIKITA,1997,1692,1106,586,65.36643026004728,34.63356973995272,Unisex
JODY,1997,896,622,274,69.41964285714286,30.580357142857142,Unisex
JILLIAN,1997,307,100,207,32.57328990228013,67.42671009771986,Unisex
GILLIAN,1997,947,327,620,34.53009503695882,65.46990496304119,Unisex
NOHA,1997,3543,766,2777,21.620095963872423,78.37990403612758,Unisex
ALIA,1998,19,19,0,100.0,0.0,Female
RITA,1998,34,34,0,100.0,0.0,Female
TACKO,1998,5,5,0,100.0,0.0,Female
ERICKA,1998,27,27,0,100.0,0.0,Female
GAËLLE,1998,239,239,0,100.0,0.0,Female
AUDRÉE,1998,4,4,0,100.0,0.0,Female
DESIREE,1998,8,8,0,100.0,0.0,Female
GLADYS,1998,151,151,0,100.0,0.0,Female
CANDIDE,1998,6,6,0,100.0,0.0,Female
MENELLE,1998,3,3,0,100.0,0.0,Female
ILKNUR,1998,7,7,0,100.0,0.0,Female
FLAURINE,1998,3,3,0,100.0,0.0,Female
EVIE,1998,14,14,0,100.0,0.0,Female
HANIN,1998,3,3,0,100.0,0.0,Female
KATRINA,1998,7,7,0,100.0,0.0,Female
BÉATRICE,1998,107,107,0,100.0,0.0,Female
CHERAZADE,1998,10,10,0,100.0,0.0,Female
CHRISSIE,1998,3,3,0,100.0,0.0,Female
MAIKA,1998,9,9,0,100.0,0.0,Female
MILVA,1998,3,3,0,100.0,0.0,Female
MILICA,1998,4,4,0,100.0,0.0,Female
MAËNA,1998,3,3,0,100.0,0.0,Female
JENNIE,1998,16,16,0,100.0,0.0,Female
MARILOU,1998,71,71,0,100.0,0.0,Female
FLORETTE,1998,9,9,0,100.0,0.0,Female
MAO,1998,4,0,4,0.0,100.0,Male
SMAÏN,1998,6,0,6,0.0,100.0,Male
ABDEL-KARIM,1998,14,0,14,0.0,100.0,Male
EDGARD,1998,16,0,16,0.0,100.0,Male
DELIL,1998,3,0,3,0.0,100.0,Male
CELESTIN,1998,50,0,50,0.0,100.0,Male
BAZIL,1998,4,0,4,0.0,100.0,Male
ELYES,1998,61,0,61,0.0,100.0,Male
ROHANN,1998,3,0,3,0.0,100.0,Male
JABER,1998,4,0,4,0.0,100.0,Male
BASIL,1998,25,0,25,0.0,100.0,Male
BERKAN,1998,7,0,7,0.0,100.0,Male
DAMIAN,1998,15,0,15,0.0,100.0,Male
ANDRÉ,1998,164,0,164,0.0,100.0,Male
SIDI,1998,20,0,20,0.0,100.0,Male
JEAN-BASTIEN,1998,4,0,4,0.0,100.0,Male
TIEPHAINE,1998,4,0,4,0.0,100.0,Male
ISMET,1998,3,0,3,0.0,100.0,Male
MAHMOUD,1998,13,0,13,0.0,100.0,Male
SÉBASTIAN,1998,4,0,4,0.0,100.0,Male
HAZIM,1998,3,0,3,0.0,100.0,Male
AMIN,1998,77,0,77,0.0,100.0,Male
WILLY,1998,123,0,123,0.0,100.0,Male
MARC-ETIENNE,1998,3,0,3,0.0,100.0,Male
REDAH,1998,3,0,3,0.0,100.0,Male
_PRENOMS_RARES,1998,1760252,908578,851674,51.616359475802334,48.38364052419767,Unisex
LORY,1998,1231,941,290,76.44191714053615,23.55808285946385,Unisex
MORGANN,1998,1229,459,770,37.34743694060212,62.65256305939788,Unisex
SADIO,1998,1523,895,628,58.76559422193039,41.2344057780696,Unisex
KELIG,1998,415,123,292,29.63855421686747,70.36144578313252,Unisex
MAORI,1998,132,26,106,19.69696969696969,80.3030303030303,Unisex
MALEK,1998,3570,1060,2510,29.69187675070028,70.30812324929971,Unisex
NOA,1998,38708,6263,32445,16.18011780510489,83.81988219489511,Unisex
SHANE,1998,479,136,343,28.39248434237996,71.60751565762004,Unisex
JODY,1998,896,622,274,69.41964285714286,30.580357142857142,Unisex
GILLIAN,1998,947,327,620,34.53009503695882,65.46990496304119,Unisex
JANIS,1998,1364,884,480,64.80938416422288,35.19061583577713,Unisex
KIM,1998,6518,5270,1248,80.85302239950906,19.146977600490946,Unisex
CLAUDY,1998,2240,835,1405,37.27678571428572,62.72321428571429,Unisex
MELAINE,1998,1656,1288,368,77.77777777777779,22.22222222222222,Unisex
JANICK,1998,4109,2203,1906,53.61401800924799,46.38598199075201,Unisex
GABY,1998,4741,2448,2293,51.63467622864375,48.36532377135626,Unisex
YVANE,1998,775,520,255,67.0967741935484,32.903225806451616,Unisex
MALLORY,1998,2883,2151,732,74.60978147762746,25.390218522372525,Unisex
SWANN,1998,8143,2279,5864,27.98722829424045,72.01277170575955,Unisex
SASHA,1998,18319,7736,10583,42.22937933293302,57.77062066706697,Unisex
CAMILLE,1998,287709,207732,79977,72.20212089298562,27.79787910701437,Unisex
CLARENCE,1998,2943,924,2019,31.39653414882773,68.60346585117227,Unisex
KRISTEN,1998,939,532,407,56.656017039403615,43.34398296059638,Unisex
ANGY,1998,571,264,307,46.234676007005255,53.76532399299475,Unisex
EMERAUDE,1999,13,13,0,100.0,0.0,Female
CIARA,1999,3,3,0,100.0,0.0,Female
LALY,1999,35,35,0,100.0,0.0,Female
LUCE,1999,31,31,0,100.0,0.0,Female
ANNE-LORRAINE,1999,3,3,0,100.0,0.0,Female
PHYLICIA,1999,3,3,0,100.0,0.0,Female
EMILIENNE,1999,6,6,0,100.0,0.0,Female
MERYL,1999,2926,2586,340,88.38004101161997,11.61995898838004,Female
MELYSSA,1999,60,60,0,100.0,0.0,Female
ZARA,1999,13,13,0,100.0,0.0,Female
SAME,1999,3,3,0,100.0,0.0,Female
PENDA,1999,10,10,0,100.0,0.0,Female
NOURANE,1999,5,5,0,100.0,0.0,Female
AXELLE,1999,1263,1263,0,100.0,0.0,Female
CYPRIANE,1999,3,3,0,100.0,0.0,Female
GAELE,1999,3,3,0,100.0,0.0,Female
MYA,1999,9,9,0,100.0,0.0,Female
ACELYA,1999,10,10,0,100.0,0.0,Female
SHEHERAZAD,1999,4,4,0,100.0,0.0,Female
TANA,1999,3,3,0,100.0,0.0,Female
MARIE-EUGÉNIE,1999,7,7,0,100.0,0.0,Female
STEPHIE,1999,15,15,0,100.0,0.0,Female
ELMA,1999,14,14,0,100.0,0.0,Female
MANOLYA,1999,5,5,0,100.0,0.0,Female
SCHERLEY,1999,3,3,0,100.0,0.0,Female
TERRY,1999,3692,340,3352,9.209100758396534,90.79089924160346,Male
YORDAN,1999,4,0,4,0.0,100.0,Male
KRISS,1999,5,0,5,0.0,100.0,Male
ANTHOINE,1999,4,0,4,0.0,100.0,Male
TOBIE,1999,3,0,3,0.0,100.0,Male
FERNANDO,1999,12,0,12,0.0,100.0,Male
ADDA,1999,3,0,3,0.0,100.0,Male
AUGUSTIN,1999,469,0,469,0.0,100.0,Male
LORRAIN,1999,4,0,4,0.0,100.0,Male
MANSON,1999,3,0,3,0.0,100.0,Male
LOUIS-PHILIPPE,1999,4,0,4,0.0,100.0,Male
PIERCE,1999,4,0,4,0.0,100.0,Male
FAUSTIN,1999,35,0,35,0.0,100.0,Male
JEAN-YVES,1999,9,0,9,0.0,100.0,Male
NANS,1999,50,0,50,0.0,100.0,Male
TANER,1999,5,0,5,0.0,100.0,Male
MOUAD,1999,13,0,13,0.0,100.0,Male
NASCIMO,1999,3,0,3,0.0,100.0,Male
ANUSAN,1999,4,0,4,0.0,100.0,Male
SOPHYAN,1999,3,0,3,0.0,100.0,Male
JOHN-PAUL,1999,4,0,4,0.0,100.0,Male
KOUAKOU,1999,3,0,3,0.0,100.0,Male
PIERRE-NICOLAS,1999,21,0,21,0.0,100.0,Male
ABDELMALIK,1999,11,0,11,0.0,100.0,Male
HONORE,1999,19,0,19,0.0,100.0,Male
HYACINTHE,1999,4679,1173,3506,25.069459286172258,74.93054071382774,Unisex
_PRENOMS_RARES,1999,1760252,908578,851674,51.616359475802334,48.38364052419767,Unisex
KELIANE,1999,395,208,187,52.65822784810127,47.34177215189874,Unisex
AXELL,1999,165,71,94,43.03030303030303,56.96969696969697,Unisex
LOÏS,1999,11236,3416,7820,30.40227839088644,69.59772160911356,Unisex
NIL,1999,1500,451,1049,30.06666666666667,69.93333333333334,Unisex
JANIS,1999,1364,884,480,64.80938416422288,35.19061583577713,Unisex
WISSAM,1999,2491,451,2040,18.105178643115213,81.89482135688479,Unisex
SUNNY,1999,823,128,695,15.552855407047389,84.44714459295261,Unisex
ALAA,1999,978,812,166,83.02658486707567,16.973415132924334,Unisex
ORPHEE,1999,466,267,199,57.2961373390558,42.70386266094421,Unisex
SOLANE,1999,370,234,136,63.24324324324324,36.75675675675676,Unisex
DENIZ,1999,1954,675,1279,34.54452405322416,65.45547594677585,Unisex
KELIG,1999,415,123,292,29.63855421686747,70.36144578313252,Unisex
SASHA,1999,18319,7736,10583,42.22937933293302,57.77062066706697,Unisex
ARIEL,1999,2401,428,1973,17.8259058725531,82.17409412744689,Unisex
DILAN,1999,1452,360,1092,24.793388429752067,75.20661157024794,Unisex
SADIO,1999,1523,895,628,58.76559422193039,41.2344057780696,Unisex
YANNE,1999,420,204,216,48.57142857142857,51.42857142857142,Unisex
BERYL,1999,762,607,155,79.65879265091863,20.341207349081365,Unisex
EDEN,1999,33510,11200,22310,33.422858848105044,66.57714115189496,Unisex
MENDY,1999,1198,737,461,61.51919866444074,38.48080133555926,Unisex
KANDE,1999,209,98,111,46.889952153110045,53.11004784688996,Unisex
MILANE,1999,634,298,336,47.003154574132495,52.99684542586751,Unisex
NIKITA,1999,1692,1106,586,65.36643026004728,34.63356973995272,Unisex
BENEDICTE,2000,134,134,0,100.0,0.0,Female
HADIL,2000,4,4,0,100.0,0.0,Female
DILAY,2000,4,4,0,100.0,0.0,Female
KELLY,2000,740,740,0,100.0,0.0,Female
OYHANA,2000,3,3,0,100.0,0.0,Female
LOUBNA,2000,103,103,0,100.0,0.0,Female
KAROLANE,2000,4,4,0,100.0,0.0,Female
DÉBORAH,2000,7,7,0,100.0,0.0,Female
ISMAELLE,2000,3,3,0,100.0,0.0,Female
ELMA,2000,17,17,0,100.0,0.0,Female
NOHEILA,2000,4,4,0,100.0,0.0,Female
CELIA,2000,3,3,0,100.0,0.0,Female
YMENE,2000,4,4,0,100.0,0.0,Female
CLAUDINE,2000,19,19,0,100.0,0.0,Female
EMERENCE,2000,7,7,0,100.0,0.0,Female
CLAIRE,2000,1630,1630,0,100.0,0.0,Female
MARIE-CHARLOTTE,2000,56,56,0,100.0,0.0,Female
GINETTE,2000,3,3,0,100.0,0.0,Female
MARIAMOU,2000,3,3,0,100.0,0.0,Female
MARIE-ELOISE,2000,3,3,0,100.0,0.0,Female
COSETTE,2000,3,3,0,100.0,0.0,Female
ALENA,2000,17,17,0,100.0,0.0,Female
COLINE,2000,1001,1001,0,100.0,0.0,Female
ORANE,2000,3049,3024,25,99.18005903574942,0.819940964250574,Female
LLONA,2000,7,7,0,100.0,0.0,Female
HOUDAIFA,2000,3,0,3,0.0,100.0,Male
RIYAN,2000,6,0,6,0.0,100.0,Male
RADWAN,2000,7,0,7,0.0,100.0,Male
GUEWEN,2000,17,0,17,0.0,100.0,Male
IVAN,2000,115,0,115,0.0,100.0,Male
HOSNI,2000,5,0,5,0.0,100.0,Male
ANTTON,2000,21,0,21,0.0,100.0,Male
WANIS,2000,7,0,7,0.0,100.0,Male
CHARLES-ERIC,2000,3,0,3,0.0,100.0,Male
ANISE,2000,3,0,3,0.0,100.0,Male
ALANE,2000,13,0,13,0.0,100.0,Male
SOULAIMAN,2000,4,0,4,0.0,100.0,Male
GUYLLAUME,2000,4,0,4,0.0,100.0,Male
HADI,2000,9,0,9,0.0,100.0,Male
TENNESSEE,2000,6,0,6,0.0,100.0,Male
AL,2000,6,0,6,0.0,100.0,Male
JEAN-MANUEL,2000,3,0,3,0.0,100.0,Male
NATANAEL,2000,12,0,12,0.0,100.0,Male
XABI,2000,22,0,22,0.0,100.0,Male
STEWART,2000,3,0,3,0.0,100.0,Male
SHAHIN,2000,3,0,3,0.0,100.0,Male
ELIAS,2000,361,0,361,0.0,100.0,Male
CEDRIC,2000,846,0,846,0.0,100.0,Male
ADIL,2000,107,0,107,0.0,100.0,Male
ULRIC,2000,13,0,13,0.0,100.0,Male
LOÏS,2000,11236,3416,7820,30.40227839088644,69.59772160911356,Unisex
SUNNY,2000,823,128,695,15.552855407047389,84.44714459295261,Unisex
SASHA,2000,18319,7736,10583,42.22937933293302,57.77062066706697,Unisex
JIHAD,2000,692,175,517,25.289017341040463,74.71098265895954,Unisex
THEMIS,2000,404,342,62,84.65346534653465,15.346534653465346,Unisex
CHAN,2000,209,93,116,44.49760765550239,55.50239234449761,Unisex
KILIANE,2000,361,106,255,29.362880886426595,70.6371191135734,Unisex
MENDY,2000,1198,737,461,61.51919866444074,38.48080133555926,Unisex
TASLIM,2000,276,207,69,75.0,25.0,Unisex
ILIANE,2000,869,168,701,19.332566168009205,80.66743383199079,Unisex
MAELANN,2000,428,260,168,60.74766355140186,39.25233644859813,Unisex
YAËL,2000,3502,1564,1938,44.66019417475729,55.33980582524271,Unisex
RAYHANE,2000,303,119,184,39.27392739273928,60.726072607260726,Unisex
GABRIELE,2000,993,563,430,56.6968781470292,43.3031218529708,Unisex
TERY,2000,144,30,114,20.833333333333336,79.16666666666666,Unisex
NIKITA,2000,1692,1106,586,65.36643026004728,34.63356973995272,Unisex
ALIX,2000,37305,28371,8934,76.05146763168477,23.94853236831524,Unisex
LEE,2000,538,203,335,37.732342007434944,62.26765799256505,Unisex
ANGY,2000,571,264,307,46.234676007005255,53.76532399299475,Unisex
NOUHA,2000,689,401,288,58.20029027576198,41.79970972423803,Unisex
SASCHA,2000,525,132,393,25.142857142857142,74.85714285714286,Unisex
DANY,2000,26027,7836,18191,30.10719637299728,69.89280362700273,Unisex
JODY,2000,896,622,274,69.41964285714286,30.580357142857142,Unisex
NOHA,2000,3543,766,2777,21.620095963872423,78.37990403612758,Unisex
LIOR,2000,1001,172,829,17.182817182817185,82.81718281718283,Unisex
MARIE-ANGÈLE,2001,3,3,0,100.0,0.0,Female
MAYERA,2001,3,3,0,100.0,0.0,Female
AUXANNE,2001,6,6,0,100.0,0.0,Female
BALKIS,2001,6,6,0,100.0,0.0,Female
CASSI,2001,4,4,0,100.0,0.0,Female
LAURIANNE,2001,99,99,0,100.0,0.0,Female
INDYA,2001,4,4,0,100.0,0.0,Female
SHERIDANE,2001,4,4,0,100.0,0.0,Female
CAMILYA,2001,5,5,0,100.0,0.0,Female
MARIG,2001,3,3,0,100.0,0.0,Female
SHAINES,2001,10,10,0,100.0,0.0,Female
ANDJELA,2001,3,3,0,100.0,0.0,Female
ELIF,2001,79,79,0,100.0,0.0,Female
MARIE-ALICIA,2001,3,3,0,100.0,0.0,Female
HADIDJA,2001,3,3,0,100.0,0.0,Female
TESSIA,2001,7,7,0,100.0,0.0,Female
NIHADE,2001,3,3,0,100.0,0.0,Female
ROSIE,2001,29,29,0,100.0,0.0,Female
SHANEL,2001,9,9,0,100.0,0.0,Female
MAELA,2001,106,106,0,100.0,0.0,Female
ANNE-AEL,2001,3,3,0,100.0,0.0,Female
KANDICE,2001,4,4,0,100.0,0.0,Female
MALYA,2001,3,3,0,100.0,0.0,Female
LOU-ANA,2001,5,5,0,100.0,0.0,Female
DORRA,2001,4,4,0,100.0,0.0,Female
ABOU-BAKR,2001,3,0,3,0.0,100.0,Male
DJEZON,2001,11,0,11,0.0,100.0,Male
ZACK,2001,9,0,9,0.0,100.0,Male
ZAKI,2001,8,0,8,0.0,100.0,Male
SYLVAN,2001,4,0,4,0.0,100.0,Male
DAAN,2001,3,0,3,0.0,100.0,Male
DJOUDI,2001,3,0,3,0.0,100.0,Male
CLYDE,2001,10,0,10,0.0,100.0,Male
LOUIS-PIERRE,2001,4,0,4,0.0,100.0,Male
HAMSA,2001,3,0,3,0.0,100.0,Male
ABDELMALIK,2001,10,0,10,0.0,100.0,Male
ELOUAN,2001,243,0,243,0.0,100.0,Male
NACERDINE,2001,3,0,3,0.0,100.0,Male
PRESLEY,2001,3,0,3,0.0,100.0,Male
EDSON,2001,11,0,11,0.0,100.0,Male
MATTHIS,2001,183,0,183,0.0,100.0,Male
VIKEN,2001,6,0,6,0.0,100.0,Male
PIERRE-AXEL,2001,3,0,3,0.0,100.0,Male
ELIAM,2001,7,0,7,0.0,100.0,Male
GERY,2001,3,0,3,0.0,100.0,Male
TIMOTEI,2001,7,0,7,0.0,100.0,Male
POL,2001,40,0,40,0.0,100.0,Male
HIPPOLYTE,2001,167,0,167,0.0,100.0,Male
MAXENDRE,2001,5,0,5,0.0,100.0,Male
DAVON,2001,3,0,3,0.0,100.0,Male
KIMY,2001,602,501,101,83.22259136212624,16.77740863787375,Unisex
SAPHIR,2001,587,109,478,18.56899488926746,81.43100511073254,Unisex
GABRIELE,2001,993,563,430,56.6968781470292,43.3031218529708,Unisex
MELAINE,2001,1656,1288,368,77.77777777777779,22.22222222222222,Unisex
JILLIAN,2001,307,100,207,32.57328990228013,67.42671009771986,Unisex
KILIANE,2001,361,106,255,29.362880886426595,70.6371191135734,Unisex
KAMILLE,2001,386,295,91,76.42487046632125,23.57512953367876,Unisex
YAHEL,2001,175,70,105,40.0,60.0,Unisex
EVANE,2001,809,612,197,75.64894932014833,24.351050679851667,Unisex
KAREL,2001,1060,233,827,21.9811320754717,78.01886792452831,Unisex
DOMINIQUE,2001,409989,168027,241962,40.98329467375954,59.01670532624046,Unisex
KELIANE,2001,395,208,187,52.65822784810127,47.34177215189874,Unisex
CAMILLE,2001,287709,207732,79977,72.20212089298562,27.79787910701437,Unisex
DENIZ,2001,1954,675,1279,34.54452405322416,65.45547594677585,Unisex
KAELIG,2001,475,80,395,16.842105263157894,83.15789473684211,Unisex
KILLIANE,2001,171,71,100,41.52046783625731,58.47953216374269,Unisex
JODY,2001,896,622,274,69.41964285714286,30.580357142857142,Unisex
LOANN,2001,4020,941,3079,23.40796019900497,76.59203980099502,Unisex
NOLANE,2001,881,241,640,27.35527809307605,72.64472190692395,Unisex
MILANE,2001,634,298,336,47.003154574132495,52.99684542586751,Unisex
NEL,2001,345,62,283,17.971014492753625,82.02898550724638,Unisex
NIMA,2001,369,165,204,44.71544715447154,55.28455284552846,Unisex
DIYA,2001,260,194,66,74.61538461538461,25.384615384615383,Unisex
DILAN,2001,1452,360,1092,24.793388429752067,75.20661157024794,Unisex
LIOR,2001,1001,172,829,17.182817182817185,82.81718281718283,Unisex
MARIATOU,2002,5,5,0,100.0,0.0,Female
AISSATOU,2002,59,59,0,100.0,0.0,Female
MARISSA,2002,24,24,0,100.0,0.0,Female
NY,2002,3,3,0,100.0,0.0,Female
MELISANDE,2002,24,24,0,100.0,0.0,Female
TAHITIA,2002,5,5,0,100.0,0.0,Female
THEOLINE,2002,5,5,0,100.0,0.0,Female
IMENE,2002,168,168,0,100.0,0.0,Female
WISSALE,2002,9,9,0,100.0,0.0,Female
ROSE,2002,111110,110808,302,99.72819728197284,0.2718027180271802,Female
ORNA,2002,3,3,0,100.0,0.0,Female
EMILIE-ROSE,2002,6,6,0,100.0,0.0,Female
MEGHAN,2002,18,18,0,100.0,0.0,Female
SOFYA,2002,6,6,0,100.0,0.0,Female
SABRINA,2002,566,566,0,100.0,0.0,Female
TIPHENE,2002,5,5,0,100.0,0.0,Female
LAIZA,2002,4,4,0,100.0,0.0,Female
DRUCILLA,2002,5,5,0,100.0,0.0,Female
LOHANNE,2002,4,4,0,100.0,0.0,Female
ERVA,2002,7,7,0,100.0,0.0,Female
KELLY-ANNE,2002,4,4,0,100.0,0.0,Female
LILE,2002,4,4,0,100.0,0.0,Female
HELEN,2002,7,7,0,100.0,0.0,Female
ESSIA,2002,4,4,0,100.0,0.0,Female
ALLIA,2002,9,9,0,100.0,0.0,Female
SOLANN,2002,5,0,5,0.0,100.0,Male
KIREG,2002,4,0,4,0.0,100.0,Male
FLOYD,2002,4,0,4,0.0,100.0,Male
SOUFIAN,2002,17,0,17,0.0,100.0,Male
LUDRICK,2002,6,0,6,0.0,100.0,Male
PHI,2002,3,0,3,0.0,100.0,Male
ANTHOINE,2002,3,0,3,0.0,100.0,Male
AYKUT,2002,6,0,6,0.0,100.0,Male
CONSTANTIN,2002,69,0,69,0.0,100.0,Male
LOUCAS,2002,62,0,62,0.0,100.0,Male
AZEDDINE,2002,3,0,3,0.0,100.0,Male
ISACK,2002,4,0,4,0.0,100.0,Male
YAMIN,2002,24,0,24,0.0,100.0,Male
TALAL,2002,7,0,7,0.0,100.0,Male
QUOC,2002,5,0,5,0.0,100.0,Male
TAL,2002,4,0,4,0.0,100.0,Male
AKRAM,2002,47,0,47,0.0,100.0,Male
WILLIAMS,2002,24,0,24,0.0,100.0,Male
PACOME,2002,51,0,51,0.0,100.0,Male
MEROUAN,2002,5,0,5,0.0,100.0,Male
HALIL-IBRAHIM,2002,4,0,4,0.0,100.0,Male
SALAHDINE,2002,9,0,9,0.0,100.0,Male
ALRIC,2002,7,0,7,0.0,100.0,Male
MOHAMED-LAMINE,2002,19,0,19,0.0,100.0,Male
ALEXY,2002,4689,85,4604,1.8127532522925995,98.1872467477074,Male
LEE,2002,538,203,335,37.732342007434944,62.26765799256505,Unisex
MILANE,2002,634,298,336,47.003154574132495,52.99684542586751,Unisex
MALLORY,2002,2883,2151,732,74.60978147762746,25.390218522372525,Unisex
ILIANE,2002,869,168,701,19.332566168009205,80.66743383199079,Unisex
LIOR,2002,1001,172,829,17.182817182817185,82.81718281718283,Unisex
JESSY,2002,17091,3993,13098,23.363173600140424,76.63682639985957,Unisex
NIKI,2002,193,115,78,59.58549222797927,40.41450777202073,Unisex
ALAA,2002,978,812,166,83.02658486707567,16.973415132924334,Unisex
INDY,2002,310,111,199,35.80645161290323,64.19354838709678,Unisex
PLAMEDI,2002,91,60,31,65.93406593406593,34.065934065934066,Unisex
NOUHA,2002,689,401,288,58.20029027576198,41.79970972423803,Unisex
GABY,2002,4741,2448,2293,51.63467622864375,48.36532377135626,Unisex
LILO,2002,815,482,333,59.14110429447853,40.85889570552147,Unisex
LYSSANDRE,2002,574,157,417,27.35191637630662,72.64808362369338,Unisex
SINA,2002,338,162,176,47.92899408284024,52.071005917159766,Unisex
WISSEM,2002,3049,682,2367,22.36798950475566,77.63201049524434,Unisex
SASHA,2002,18319,7736,10583,42.22937933293302,57.77062066706697,Unisex
SATYA,2002,470,149,321,31.70212765957447,68.29787234042554,Unisex
NEHEMIE,2002,469,250,219,53.30490405117271,46.695095948827294,Unisex
ANGY,2002,571,264,307,46.234676007005255,53.76532399299475,Unisex
JOHANE,2002,818,633,185,77.3838630806846,22.6161369193154,Unisex
KENZY,2002,1392,384,1008,27.58620689655172,72.41379310344827,Unisex
DILAN,2002,1452,360,1092,24.793388429752067,75.20661157024794,Unisex
KERANE,2002,127,45,82,35.43307086614173,64.56692913385827,Unisex
KRYSTEN,2002,160,125,35,78.125,21.875,Unisex
SAKINA,2003,74,74,0,100.0,0.0,Female
DJENEBOU,2003,8,8,0,100.0,0.0,Female
CHAINEZE,2003,21,21,0,100.0,0.0,Female
ODETTE,2003,4,4,0,100.0,0.0,Female
MATHILDA,2003,152,152,0,100.0,0.0,Female
HAKIMA,2003,5,5,0,100.0,0.0,Female
NOAME,2003,5,5,0,100.0,0.0,Female
LAURIANA,2003,20,20,0,100.0,0.0,Female
CHRISTIE,2003,12,12,0,100.0,0.0,Female
VEGA,2003,3,3,0,100.0,0.0,Female
LOMEE,2003,3,3,0,100.0,0.0,Female
MEGG,2003,3,3,0,100.0,0.0,Female
MIRELLA,2003,11,11,0,100.0,0.0,Female
MAELLIS,2003,10,10,0,100.0,0.0,Female
NAHOMIE,2003,4,4,0,100.0,0.0,Female
TILIA,2003,9,9,0,100.0,0.0,Female
SEMA,2003,20,20,0,100.0,0.0,Female
MERYAME,2003,6,6,0,100.0,0.0,Female
TAMARA,2003,154,154,0,100.0,0.0,Female
MOHEA,2003,5,5,0,100.0,0.0,Female
CORENTINE,2003,11,11,0,100.0,0.0,Female
JIHANE,2003,84,84,0,100.0,0.0,Female
CINDY,2003,366,366,0,100.0,0.0,Female
AIKO,2003,3,3,0,100.0,0.0,Female
CANDICE,2003,637,637,0,100.0,0.0,Female
YERIM,2003,5,0,5,0.0,100.0,Male
MENDEL,2003,11,0,11,0.0,100.0,Male
TYBALT,2003,8,0,8,0.0,100.0,Male
JEAN-DAVID,2003,12,0,12,0.0,100.0,Male
ABDELHALIM,2003,6,0,6,0.0,100.0,Male
SHAHID,2003,5,0,5,0.0,100.0,Male
RIDWANE,2003,5,0,5,0.0,100.0,Male
HARISH,2003,5,0,5,0.0,100.0,Male
ARVIN,2003,4,0,4,0.0,100.0,Male
JEHANN,2003,3,0,3,0.0,100.0,Male
ELY,2003,14,0,14,0.0,100.0,Male
ABDELSAMAD,2003,5,0,5,0.0,100.0,Male
KENDRIC,2003,4,0,4,0.0,100.0,Male
TOBIAS,2003,40,0,40,0.0,100.0,Male
NAEL,2003,11269,196,11073,1.7392847635105155,98.26071523648947,Male
ONDER,2003,3,0,3,0.0,100.0,Male
ALDWIN,2003,3,0,3,0.0,100.0,Male
STEWART,2003,4,0,4,0.0,100.0,Male
CONRAD,2003,8,0,8,0.0,100.0,Male
JEAN-COME,2003,3,0,3,0.0,100.0,Male
DIBOAN,2003,4,0,4,0.0,100.0,Male
KYRIO,2003,3,0,3,0.0,100.0,Male
FAHEL,2003,3,0,3,0.0,100.0,Male
ALEXANDRE,2003,304225,230,303995,0.0756019393540964,99.9243980606459,Male
SINCLAIR,2003,12,0,12,0.0,100.0,Male
IMANI,2003,568,467,101,82.21830985915493,17.781690140845072,Unisex
LEE,2003,538,203,335,37.732342007434944,62.26765799256505,Unisex
KEZIAH,2003,1699,467,1232,27.48675691583284,72.51324308416716,Unisex
WALLIS,2003,197,118,79,59.89847715736041,40.10152284263959,Unisex
MILANE,2003,634,298,336,47.003154574132495,52.99684542586751,Unisex
KELIG,2003,415,123,292,29.63855421686747,70.36144578313252,Unisex
TAIS,2003,764,647,117,84.68586387434554,15.314136125654452,Unisex
ELIAH,2003,291,150,141,51.546391752577314,48.45360824742268,Unisex
AMARA,2003,1568,601,967,38.329081632653065,61.670918367346935,Unisex
DOMINIQUE,2003,409989,168027,241962,40.98329467375954,59.01670532624046,Unisex
MANOA,2003,2510,554,1956,22.07171314741036,77.92828685258965,Unisex
LOGANE,2003,619,495,124,79.96768982229402,20.032310177705977,Unisex
ALAA,2003,978,812,166,83.02658486707567,16.973415132924334,Unisex
ANGY,2003,571,264,307,46.234676007005255,53.76532399299475,Unisex
HANINE,2003,371,310,61,83.55795148247978,16.442048517520217,Unisex
MAELANN,2003,428,260,168,60.74766355140186,39.25233644859813,Unisex
TERI,2003,129,90,39,69.76744186046511,30.23255813953488,Unisex
THEMIS,2003,404,342,62,84.65346534653465,15.346534653465346,Unisex
LORY,2003,1231,941,290,76.44191714053615,23.55808285946385,Unisex
LYSANDRE,2003,1858,363,1495,19.53713670613563,80.46286329386437,Unisex
BRANDY,2003,283,198,85,69.96466431095406,30.03533568904594,Unisex
KERANE,2003,127,45,82,35.43307086614173,64.56692913385827,Unisex
MEL,2003,553,129,424,23.32730560578662,76.67269439421338,Unisex
THIEFAINE,2003,257,50,207,19.45525291828794,80.54474708171206,Unisex
ISA,2003,730,291,439,39.86301369863013,60.136986301369866,Unisex
NAZLICAN,2004,3,3,0,100.0,0.0,Female
MIRYAM,2004,18,18,0,100.0,0.0,Female
ALEYNA-NUR,2004,3,3,0,100.0,0.0,Female
EZGI,2004,11,11,0,100.0,0.0,Female
CHARLOTTE,2004,2263,2263,0,100.0,0.0,Female
KATHELINE,2004,3,3,0,100.0,0.0,Female
BLESSING,2004,6,6,0,100.0,0.0,Female
CHERYL,2004,20,20,0,100.0,0.0,Female
KHADIDIATOU,2004,12,12,0,100.0,0.0,Female
NISRIN,2004,7,7,0,100.0,0.0,Female
NORANE,2004,9,9,0,100.0,0.0,Female
SARAH-LISA,2004,3,3,0,100.0,0.0,Female
STESSY,2004,87,87,0,100.0,0.0,Female
MARIE-CAMILLE,2004,7,7,0,100.0,0.0,Female
SEVERINE,2004,38,38,0,100.0,0.0,Female
NAHID,2004,5,5,0,100.0,0.0,Female
CAMELIA,2004,3,3,0,100.0,0.0,Female
KORYDWEN,2004,6,6,0,100.0,0.0,Female
ANNE-ELISABETH,2004,3,3,0,100.0,0.0,Female
LALI,2004,17,17,0,100.0,0.0,Female
MAGOU,2004,7,7,0,100.0,0.0,Female
RADHIA,2004,4,4,0,100.0,0.0,Female
CANSU,2004,12,12,0,100.0,0.0,Female
KADIDJA,2004,8,8,0,100.0,0.0,Female
AMANDINE,2004,1633,1633,0,100.0,0.0,Female
ELOAN,2004,21,0,21,0.0,100.0,Male
MATHIS,2004,5710,0,5710,0.0,100.0,Male
EDIS,2004,7,0,7,0.0,100.0,Male
YORI,2004,3,0,3,0.0,100.0,Male
MAURIN,2004,4,0,4,0.0,100.0,Male
MAX,2004,40120,205,39915,0.5109670987038883,99.48903290129611,Male
CILLIAN,2004,4,0,4,0.0,100.0,Male
DIESON,2004,3,0,3,0.0,100.0,Male
SIDAR,2004,7,0,7,0.0,100.0,Male
MELIO,2004,4,0,4,0.0,100.0,Male
LYESS,2004,5,0,5,0.0,100.0,Male
MARLON,2004,73,0,73,0.0,100.0,Male
WESSIM,2004,3,0,3,0.0,100.0,Male
BASSEL,2004,5,0,5,0.0,100.0,Male
ANDER,2004,4,0,4,0.0,100.0,Male
KELIANN,2004,5,0,5,0.0,100.0,Male
ISSIAKA,2004,6,0,6,0.0,100.0,Male
RAUL,2004,7,0,7,0.0,100.0,Male
YLLIAN,2004,4,0,4,0.0,100.0,Male
MOHAND,2004,8,0,8,0.0,100.0,Male
OUSSENI,2004,3,0,3,0.0,100.0,Male
HASAN,2004,58,0,58,0.0,100.0,Male
FRÉDÉRIC,2004,184,0,184,0.0,100.0,Male
SIDY,2004,13,0,13,0.0,100.0,Male
MOHSEN,2004,3,0,3,0.0,100.0,Male
KAREL,2004,1060,233,827,21.9811320754717,78.01886792452831,Unisex
JOHANE,2004,818,633,185,77.3838630806846,22.6161369193154,Unisex
KINSLEY,2004,776,212,564,27.31958762886598,72.68041237113401,Unisex
CALLISTE,2004,292,114,178,39.04109589041096,60.95890410958904,Unisex
PARIS,2004,671,363,308,54.09836065573771,45.90163934426229,Unisex
NATTY,2004,369,228,141,61.78861788617886,38.21138211382114,Unisex
GWENN,2004,1848,1201,647,64.98917748917748,35.01082251082251,Unisex
IHSANE,2004,689,439,250,63.7155297532656,36.2844702467344,Unisex
MELAINE,2004,1656,1288,368,77.77777777777779,22.22222222222222,Unisex
THIEFAINE,2004,257,50,207,19.45525291828794,80.54474708171206,Unisex
SATYA,2004,470,149,321,31.70212765957447,68.29787234042554,Unisex
ELIAH,2004,291,150,141,51.546391752577314,48.45360824742268,Unisex
CAMILLE,2004,287709,207732,79977,72.20212089298562,27.79787910701437,Unisex
ISLEM,2004,2699,701,1998,25.972582437939977,74.02741756206002,Unisex
JILLIAN,2004,307,100,207,32.57328990228013,67.42671009771986,Unisex
LOUISON,2004,11456,6222,5234,54.31215083798882,45.687849162011176,Unisex
LISANDRE,2004,453,151,302,33.33333333333333,66.66666666666666,Unisex
JOANY,2004,343,91,252,26.53061224489796,73.46938775510205,Unisex
MENDY,2004,1198,737,461,61.51919866444074,38.48080133555926,Unisex
LEONCE,2004,9290,2041,7249,21.96986006458557,78.03013993541443,Unisex
MALORY,2004,2305,1892,413,82.08242950108459,17.9175704989154,Unisex
YAEL,2004,6161,3036,3125,49.27771465671157,50.72228534328843,Unisex
_PRENOMS_RARES,2004,1760252,908578,851674,51.616359475802334,48.38364052419767,Unisex
OREL,2004,150,33,117,22.0,78.0,Unisex
JAEL,2004,456,292,164,64.03508771929825,35.96491228070175,Unisex
HORTENSE,2005,169,169,0,100.0,0.0,Female
CHRYSTALE,2005,6,6,0,100.0,0.0,Female
BIANCA,2005,59,59,0,100.0,0.0,Female
CHRISTINE,2005,54,54,0,100.0,0.0,Female
ALYSSA,2005,591,591,0,100.0,0.0,Female
LEYLA,2005,58,58,0,100.0,0.0,Female
HULYA,2005,8,8,0,100.0,0.0,Female
EMYE,2005,3,3,0,100.0,0.0,Female
YVANA,2005,24,24,0,100.0,0.0,Female
ELSA,2005,1221,1221,0,100.0,0.0,Female
WIKTORIA,2005,8,8,0,100.0,0.0,Female
MYRIEM,2005,29,29,0,100.0,0.0,Female
NAIA,2005,46,46,0,100.0,0.0,Female
ISIS,2005,77,77,0,100.0,0.0,Female
TSIPORA,2005,7,7,0,100.0,0.0,Female
NELYA,2005,23,23,0,100.0,0.0,Female
NIRINA,2005,5,5,0,100.0,0.0,Female
GIULIANA,2005,21,21,0,100.0,0.0,Female
YSEE,2005,45,45,0,100.0,0.0,Female
HADIL,2005,9,9,0,100.0,0.0,Female
LAURENA,2005,66,66,0,100.0,0.0,Female
IONNA,2005,4,4,0,100.0,0.0,Female
LEVINA,2005,5,5,0,100.0,0.0,Female
CHJARA,2005,19,19,0,100.0,0.0,Female
BRIGITTE,2005,9,9,0,100.0,0.0,Female
WILSON,2005,83,0,83,0.0,100.0,Male
ABDOUL,2005,25,0,25,0.0,100.0,Male
PIO,2005,4,0,4,0.0,100.0,Male
ZACHARIA,2005,35,0,35,0.0,100.0,Male
ABDEL-JALIL,2005,4,0,4,0.0,100.0,Male
METEHAN,2005,11,0,11,0.0,100.0,Male
SETHY,2005,5,0,5,0.0,100.0,Male
FARHANE,2005,3,0,3,0.0,100.0,Male
WASSIME,2005,18,0,18,0.0,100.0,Male
EWANE,2005,3,0,3,0.0,100.0,Male
ALBERT,2005,60,0,60,0.0,100.0,Male
KERWAN,2005,19,0,19,0.0,100.0,Male
AMELIEN,2005,21,0,21,0.0,100.0,Male
MARCK,2005,3,0,3,0.0,100.0,Male
DAYAN,2005,37,0,37,0.0,100.0,Male
JOAN,2005,8178,1115,7063,13.634140376620202,86.3658596233798,Male
FAICAL,2005,4,0,4,0.0,100.0,Male
ALHASSANA,2005,3,0,3,0.0,100.0,Male
HAROUNE,2005,3,0,3,0.0,100.0,Male
MATTIS,2005,188,0,188,0.0,100.0,Male
MIKHAIL,2005,7,0,7,0.0,100.0,Male
KYLE,2005,31,0,31,0.0,100.0,Male
DILHAN,2005,17,0,17,0.0,100.0,Male
ANTHELME,2005,6,0,6,0.0,100.0,Male
KELYANN,2005,24,0,24,0.0,100.0,Male
MANOA,2005,2510,554,1956,22.07171314741036,77.92828685258965,Unisex
LOÏS,2005,11236,3416,7820,30.40227839088644,69.59772160911356,Unisex
ELY,2005,1634,623,1011,38.12729498164015,61.87270501835985,Unisex
MEL,2005,553,129,424,23.32730560578662,76.67269439421338,Unisex
NOUHA,2005,689,401,288,58.20029027576198,41.79970972423803,Unisex
SHANE,2005,479,136,343,28.39248434237996,71.60751565762004,Unisex
SALIA,2005,325,246,79,75.6923076923077,24.307692307692307,Unisex
ALAA,2005,978,812,166,83.02658486707567,16.973415132924334,Unisex
ORLANN,2005,136,67,69,49.26470588235294,50.73529411764706,Unisex
WILLOW,2005,928,738,190,79.52586206896551,20.474137931034484,Unisex
HILAL,2005,1545,1011,534,65.4368932038835,34.56310679611651,Unisex
BROOKLYN,2005,401,244,157,60.84788029925187,39.15211970074813,Unisex
KILIANE,2005,361,106,255,29.362880886426595,70.6371191135734,Unisex
SASCHA,2005,525,132,393,25.142857142857142,74.85714285714286,Unisex
CHANCE,2005,165,51,114,30.909090909090907,69.0909090909091,Unisex
SINAI,2005,437,355,82,81.23569794050344,18.76430205949657,Unisex
KELYANE,2005,300,134,166,44.66666666666666,55.333333333333336,Unisex
GLOIRE,2005,285,107,178,37.54385964912281,62.4561403508772,Unisex
MALORY,2005,2305,1892,413,82.08242950108459,17.9175704989154,Unisex
KELYS,2005,137,105,32,76.64233576642336,23.35766423357664,Unisex
ISLEM,2005,2699,701,1998,25.972582437939977,74.02741756206002,Unisex
ELIAH,2005,291,150,141,51.546391752577314,48.45360824742268,Unisex
DYLANE,2005,398,98,300,24.623115577889447,75.37688442211056,Unisex
IMANI,2005,568,467,101,82.21830985915493,17.781690140845072,Unisex
CALLISTE,2005,292,114,178,39.04109589041096,60.95890410958904,Unisex
LEXA,2006,3,3,0,100.0,0.0,Female
KIERA,2006,14,14,0,100.0,0.0,Female
HAVVA,2006,8,8,0,100.0,0.0,Female
ANOA,2006,3,3,0,100.0,0.0,Female
AISSATA,2006,77,77,0,100.0,0.0,Female
LUDMILA,2006,36,36,0,100.0,0.0,Female
ABIGAIL,2006,72,72,0,100.0,0.0,Female
MINYAR,2006,5,5,0,100.0,0.0,Female
OLFA,2006,4,4,0,100.0,0.0,Female
SULE,2006,3,3,0,100.0,0.0,Female
KALIYA,2006,3,3,0,100.0,0.0,Female
SHADEN,2006,4,4,0,100.0,0.0,Female
MARIATA,2006,4,4,0,100.0,0.0,Female
NADIA,2006,141,141,0,100.0,0.0,Female
APOLINE,2006,31,31,0,100.0,0.0,Female
KYM,2006,10,10,0,100.0,0.0,Female
ANDRÉA,2006,52847,46098,6749,87.22917100308437,12.770828996915624,Female
FLORIA,2006,5,5,0,100.0,0.0,Female
CANAN,2006,5,5,0,100.0,0.0,Female
GAMZE,2006,29,29,0,100.0,0.0,Female
ANNELISE,2006,11,11,0,100.0,0.0,Female
FARIDA,2006,14,14,0,100.0,0.0,Female
MALYSSA,2006,3,3,0,100.0,0.0,Female
MARIE-ELISABETH,2006,5,5,0,100.0,0.0,Female
TIPHENE,2006,4,4,0,100.0,0.0,Female
CLAREL,2006,3,0,3,0.0,100.0,Male
MAZEN,2006,9,0,9,0.0,100.0,Male
FAEL,2006,16,0,16,0.0,100.0,Male
ATILA,2006,4,0,4,0.0,100.0,Male
YVAN,2006,115,0,115,0.0,100.0,Male
EMILIEN,2006,559,0,559,0.0,100.0,Male
JACOPO,2006,3,0,3,0.0,100.0,Male
GOKHAN,2006,11,0,11,0.0,100.0,Male
BOCAR,2006,6,0,6,0.0,100.0,Male
BENEDICT,2006,3,0,3,0.0,100.0,Male
KENZI,2006,35,0,35,0.0,100.0,Male
KAMRON,2006,14,0,14,0.0,100.0,Male
DOUGA,2006,4,0,4,0.0,100.0,Male
AMMAR,2006,13,0,13,0.0,100.0,Male
TERI,2006,3,0,3,0.0,100.0,Male
PAULIN,2006,94,0,94,0.0,100.0,Male
NASSIME,2006,25,0,25,0.0,100.0,Male
ILAI,2006,3,0,3,0.0,100.0,Male
QUILLIAN,2006,3,0,3,0.0,100.0,Male
CELAL,2006,7,0,7,0.0,100.0,Male
ERNEST,2006,55,0,55,0.0,100.0,Male
CYRIAQUE,2006,30,0,30,0.0,100.0,Male
AIMENE,2006,5,0,5,0.0,100.0,Male
EBU,2006,4,0,4,0.0,100.0,Male
GODEFROY,2006,5,0,5,0.0,100.0,Male
NY,2006,140,55,85,39.285714285714285,60.71428571428571,Unisex
EMAN,2006,102,58,44,56.86274509803921,43.13725490196079,Unisex
INDY,2006,310,111,199,35.80645161290323,64.19354838709678,Unisex
LILO,2006,815,482,333,59.14110429447853,40.85889570552147,Unisex
ANGY,2006,571,264,307,46.234676007005255,53.76532399299475,Unisex
CEYLAN,2006,353,234,119,66.28895184135978,33.711048158640224,Unisex
ISLAME,2006,92,61,31,66.30434782608695,33.69565217391305,Unisex
_PRENOMS_RARES,2006,1760252,908578,851674,51.616359475802334,48.38364052419767,Unisex
KIMY,2006,602,501,101,83.22259136212624,16.77740863787375,Unisex
ARIEL,2006,2401,428,1973,17.8259058725531,82.17409412744689,Unisex
ALYX,2006,268,184,84,68.65671641791045,31.343283582089555,Unisex
ZIYA,2006,188,80,108,42.5531914893617,57.44680851063831,Unisex
MANOA,2006,2510,554,1956,22.07171314741036,77.92828685258965,Unisex
DENIZ,2006,1954,675,1279,34.54452405322416,65.45547594677585,Unisex
WISSEM,2006,3049,682,2367,22.36798950475566,77.63201049524434,Unisex
KANDE,2006,209,98,111,46.889952153110045,53.11004784688996,Unisex
ELOUANE,2006,429,339,90,79.02097902097903,20.97902097902098,Unisex
LISSANDRE,2006,345,74,271,21.44927536231884,78.55072463768116,Unisex
BERYL,2006,762,607,155,79.65879265091863,20.341207349081365,Unisex
EKIN,2006,168,32,136,19.047619047619047,80.95238095238095,Unisex
MANOHA,2006,201,62,139,30.845771144278604,69.15422885572139,Unisex
TAL,2006,369,294,75,79.67479674796748,20.32520325203252,Unisex
KIM,2006,6518,5270,1248,80.85302239950906,19.146977600490946,Unisex
MOANA,2006,1034,769,265,74.37137330754352,25.62862669245648,Unisex
ADAMA,2006,3805,1078,2727,28.3311432325887,71.6688567674113,Unisex
KELYAH,2007,5,5,0,100.0,0.0,Female
ARMONY,2007,5,5,0,100.0,0.0,Female
SAYNA,2007,4,4,0,100.0,0.0,Female
LILY-JEANNE,2007,4,4,0,100.0,0.0,Female
LAETITIA,2007,271,271,0,100.0,0.0,Female
CÉLINE,2007,273,273,0,100.0,0.0,Female
JENNYFER,2007,31,31,0,100.0,0.0,Female
SIENNA,2007,54,54,0,100.0,0.0,Female
SHEREL,2007,4,4,0,100.0,0.0,Female
VICTORINE,2007,112,112,0,100.0,0.0,Female
GLADYS,2007,124,124,0,100.0,0.0,Female
IZIA,2007,10,10,0,100.0,0.0,Female
AURIANNE,2007,14,14,0,100.0,0.0,Female
CLARELLE,2007,3,3,0,100.0,0.0,Female
MIRA,2007,20,20,0,100.0,0.0,Female
ALDINA,2007,3,3,0,100.0,0.0,Female
ROBERTA,2007,3,3,0,100.0,0.0,Female
LUCILE,2007,523,523,0,100.0,0.0,Female
SHAINA,2007,327,327,0,100.0,0.0,Female
PHILIPPINE,2007,124,124,0,100.0,0.0,Female
ALBANE,2007,329,329,0,100.0,0.0,Female
CEYLIN,2007,26,26,0,100.0,0.0,Female
SALAMATA,2007,4,4,0,100.0,0.0,Female
KEYLIS,2007,3,3,0,100.0,0.0,Female
LAURENE,2007,73,73,0,100.0,0.0,Female
ANATOL,2007,3,0,3,0.0,100.0,Male
HUGO,2007,4601,0,4601,0.0,100.0,Male
SEAN,2007,167,0,167,0.0,100.0,Male
RHAYAN,2007,4,0,4,0.0,100.0,Male
HILLEL,2007,15,0,15,0.0,100.0,Male
MAHIDINE,2007,3,0,3,0.0,100.0,Male
MATTHIEW,2007,3,0,3,0.0,100.0,Male
HATIME,2007,3,0,3,0.0,100.0,Male
RAYYANE,2007,4,0,4,0.0,100.0,Male
CRYS,2007,3,0,3,0.0,100.0,Male
FEODOR,2007,3,0,3,0.0,100.0,Male
DAOUDA,2007,31,0,31,0.0,100.0,Male
SEVKET,2007,4,0,4,0.0,100.0,Male
ANZO,2007,10,0,10,0.0,100.0,Male
AVRAHAM,2007,6,0,6,0.0,100.0,Male
YOHANE,2007,3,0,3,0.0,100.0,Male
VALON,2007,4,0,4,0.0,100.0,Male
ABDEL-RAHMANE,2007,6,0,6,0.0,100.0,Male
ABOU,2007,22,0,22,0.0,100.0,Male
IVANE,2007,8,0,8,0.0,100.0,Male
DAVEN,2007,10,0,10,0.0,100.0,Male
YVON,2007,15,0,15,0.0,100.0,Male
ESTEBEN,2007,3,0,3,0.0,100.0,Male
CLAUDE,2007,468398,56643,411755,12.09292097745934,87.90707902254066,Male
DILHAN,2007,14,0,14,0.0,100.0,Male
MEWENN,2007,281,96,185,34.16370106761566,65.83629893238434,Unisex
WALLIS,2007,197,118,79,59.89847715736041,40.10152284263959,Unisex
SHALOM,2007,167,56,111,33.532934131736525,66.46706586826348,Unisex
KEZIAH,2007,1699,467,1232,27.48675691583284,72.51324308416716,Unisex
IKRAM,2007,2750,2311,439,84.03636363636363,15.963636363636365,Unisex
KAYA,2007,411,337,74,81.99513381995133,18.004866180048662,Unisex
WISSEM,2007,3049,682,2367,22.36798950475566,77.63201049524434,Unisex
BLESSING,2007,427,344,83,80.56206088992974,19.437939110070257,Unisex
SASHA,2007,18319,7736,10583,42.22937933293302,57.77062066706697,Unisex
ELY,2007,1634,623,1011,38.12729498164015,61.87270501835985,Unisex
JIHAN,2007,349,266,83,76.21776504297995,23.78223495702006,Unisex
AWEN,2007,1169,253,916,21.642429426860566,78.35757057313944,Unisex
SYDNEY,2007,2101,1236,865,58.829128986197055,41.17087101380295,Unisex
SHEMS,2007,382,129,253,33.7696335078534,66.2303664921466,Unisex
TAIS,2007,764,647,117,84.68586387434554,15.314136125654452,Unisex
NAE,2007,142,94,48,66.19718309859155,33.80281690140845,Unisex
MELWYN,2007,102,26,76,25.49019607843137,74.50980392156863,Unisex
MAELIG,2007,554,238,316,42.96028880866426,57.03971119133574,Unisex
TASLIM,2007,276,207,69,75.0,25.0,Unisex
KANDE,2007,209,98,111,46.889952153110045,53.11004784688996,Unisex
SWANNY,2007,534,310,224,58.05243445692884,41.94756554307117,Unisex
LOUENN,2007,673,187,486,27.786032689450224,72.21396731054978,Unisex
LYSSANDRE,2007,574,157,417,27.35191637630662,72.64808362369338,Unisex
LOÏS,2007,11236,3416,7820,30.40227839088644,69.59772160911356,Unisex
IZEM,2007,127,33,94,25.984251968503933,74.01574803149606,Unisex
JOHANNE,2008,50,50,0,100.0,0.0,Female
MARIEME,2008,13,13,0,100.0,0.0,Female
RAYA,2008,9,9,0,100.0,0.0,Female
SLOWANE,2008,4,4,0,100.0,0.0,Female
RHANIA,2008,3,3,0,100.0,0.0,Female
AMELINE,2008,62,62,0,100.0,0.0,Female
MEYA,2008,5,5,0,100.0,0.0,Female
DJOULIA,2008,10,10,0,100.0,0.0,Female
BRUNELLE,2008,5,5,0,100.0,0.0,Female
ASSMA,2008,20,20,0,100.0,0.0,Female
KRYSTALE,2008,7,7,0,100.0,0.0,Female
URSULA,2008,3,3,0,100.0,0.0,Female
TECLA,2008,3,3,0,100.0,0.0,Female
ORLANA,2008,4,4,0,100.0,0.0,Female
ELNA,2008,3,3,0,100.0,0.0,Female
TAHIANA,2008,3,3,0,100.0,0.0,Female
CHANNEL,2008,8,8,0,100.0,0.0,Female
NATTIE,2008,5,5,0,100.0,0.0,Female
LILYANA,2008,6,6,0,100.0,0.0,Female
ESIN,2008,11,11,0,100.0,0.0,Female
CAITLYN,2008,3,3,0,100.0,0.0,Female
NAYANA,2008,4,4,0,100.0,0.0,Female
BRUNELLA,2008,12,12,0,100.0,0.0,Female
MELANE,2008,7,7,0,100.0,0.0,Female
SAHANA,2008,7,7,0,100.0,0.0,Female
MOUNTAGA,2008,4,0,4,0.0,100.0,Male
ILYESS,2008,105,0,105,0.0,100.0,Male
BAKARI,2008,6,0,6,0.0,100.0,Male
MOUMINE,2008,4,0,4,0.0,100.0,Male
VITHUSHAN,2008,3,0,3,0.0,100.0,Male
LOWAN,2008,23,0,23,0.0,100.0,Male
ERIDAN,2008,3,0,3,0.0,100.0,Male
ABDELWAHAB,2008,6,0,6,0.0,100.0,Male
RIWAL,2008,14,0,14,0.0,100.0,Male
LEVYN,2008,3,0,3,0.0,100.0,Male
BASTYAN,2008,3,0,3,0.0,100.0,Male
AMELIEN,2008,12,0,12,0.0,100.0,Male
PAUL-LOUIS,2008,16,0,16,0.0,100.0,Male
EWENN,2008,2167,61,2106,2.814951545916013,97.18504845408398,Male
KIMANY,2008,10,0,10,0.0,100.0,Male
PIERRE-ETIENNE,2008,5,0,5,0.0,100.0,Male
TIMMY,2008,28,0,28,0.0,100.0,Male
MANAEL,2008,9,0,9,0.0,100.0,Male
KRISH,2008,5,0,5,0.0,100.0,Male
ENGUERRAN,2008,13,0,13,0.0,100.0,Male
CAMRON,2008,41,0,41,0.0,100.0,Male
LOUNYS,2008,8,0,8,0.0,100.0,Male
EMMANUEL,2008,386,0,386,0.0,100.0,Male
MARCOS,2008,3,0,3,0.0,100.0,Male
CHEICKNE,2008,7,0,7,0.0,100.0,Male
WISSEM,2008,3049,682,2367,22.36798950475566,77.63201049524434,Unisex
CALLISTE,2008,292,114,178,39.04109589041096,60.95890410958904,Unisex
AEL,2008,564,106,458,18.79432624113475,81.20567375886525,Unisex
MARLEY,2008,5347,1064,4283,19.899008789975685,80.1009912100243,Unisex
SINAI,2008,437,355,82,81.23569794050344,18.76430205949657,Unisex
INDY,2008,310,111,199,35.80645161290323,64.19354838709678,Unisex
SHILOH,2008,179,109,70,60.89385474860335,39.10614525139665,Unisex
HOANI,2008,271,50,221,18.45018450184502,81.54981549815497,Unisex
CALISTE,2008,141,51,90,36.17021276595745,63.82978723404256,Unisex
MILANE,2008,634,298,336,47.003154574132495,52.99684542586751,Unisex
LOUCIANE,2008,55,22,33,40.0,60.0,Unisex
ANGY,2008,571,264,307,46.234676007005255,53.76532399299475,Unisex
MALEK,2008,3570,1060,2510,29.69187675070028,70.30812324929971,Unisex
SHEMS,2008,382,129,253,33.7696335078534,66.2303664921466,Unisex
NESTA,2008,786,234,552,29.77099236641221,70.22900763358778,Unisex
AELIG,2008,289,128,161,44.29065743944637,55.70934256055363,Unisex
SASHA,2008,18319,7736,10583,42.22937933293302,57.77062066706697,Unisex
JESSY,2008,17091,3993,13098,23.363173600140424,76.63682639985957,Unisex
LOUISON,2008,11456,6222,5234,54.31215083798882,45.687849162011176,Unisex
NOUHA,2008,689,401,288,58.20029027576198,41.79970972423803,Unisex
CHEMS,2008,514,112,402,21.78988326848249,78.21011673151752,Unisex
YAKINE,2008,610,342,268,56.0655737704918,43.9344262295082,Unisex
SAFI,2008,393,129,264,32.82442748091603,67.17557251908397,Unisex
DOMINIQUE,2008,409989,168027,241962,40.98329467375954,59.01670532624046,Unisex
IKRAM,2008,2750,2311,439,84.03636363636363,15.963636363636365,Unisex
ALIMA,2009,10,10,0,100.0,0.0,Female
CLEO,2009,3382,2997,385,88.61620342992312,11.383796570076878,Female
SENDA,2009,4,4,0,100.0,0.0,Female
NYIMA,2009,3,3,0,100.0,0.0,Female
JAHNAELLE,2009,5,5,0,100.0,0.0,Female
DJENEBA,2009,34,34,0,100.0,0.0,Female
SILOE,2009,70,70,0,100.0,0.0,Female
ENGIE,2009,5,5,0,100.0,0.0,Female
STEPHY,2009,3,3,0,100.0,0.0,Female
SUDENUR,2009,3,3,0,100.0,0.0,Female
ISEULT,2009,11,11,0,100.0,0.0,Female
KADIJA,2009,12,12,0,100.0,0.0,Female
SOLENNA,2009,4,4,0,100.0,0.0,Female
OZANNE,2009,3,3,0,100.0,0.0,Female
NISSA,2009,12,12,0,100.0,0.0,Female
LYNCEE,2009,3,3,0,100.0,0.0,Female
LAURIE-ANNE,2009,3,3,0,100.0,0.0,Female
JENNAH,2009,16,16,0,100.0,0.0,Female
HAJER,2009,18,18,0,100.0,0.0,Female
MARYSSA,2009,18,18,0,100.0,0.0,Female
LOUVE,2009,16,16,0,100.0,0.0,Female
EVANNA,2009,10,10,0,100.0,0.0,Female
MAROI,2009,3,3,0,100.0,0.0,Female
NURSENA,2009,3,3,0,100.0,0.0,Female
MAYLLIE,2009,4,4,0,100.0,0.0,Female
ZACHARYA,2009,6,0,6,0.0,100.0,Male
NAYM,2009,4,0,4,0.0,100.0,Male
LORIAN,2009,6,0,6,0.0,100.0,Male
DORYAN,2009,68,0,68,0.0,100.0,Male
JEMY,2009,4,0,4,0.0,100.0,Male
AHMED-YACINE,2009,8,0,8,0.0,100.0,Male
CYRIAK,2009,3,0,3,0.0,100.0,Male
RAYYANE,2009,5,0,5,0.0,100.0,Male
MOHAMET,2009,6,0,6,0.0,100.0,Male
HARON,2009,38,0,38,0.0,100.0,Male
HAMADY,2009,6,0,6,0.0,100.0,Male
KOLIA,2009,5,0,5,0.0,100.0,Male
ZACCARY,2009,3,0,3,0.0,100.0,Male
SLIMANE,2009,35,0,35,0.0,100.0,Male
LYEM,2009,3,0,3,0.0,100.0,Male
GOCHEN,2009,5,0,5,0.0,100.0,Male
HARALD,2009,5,0,5,0.0,100.0,Male
ELMEHDI,2009,3,0,3,0.0,100.0,Male
MOMAR,2009,3,0,3,0.0,100.0,Male
EDUARDO,2009,13,0,13,0.0,100.0,Male
SEKOUBA,2009,3,0,3,0.0,100.0,Male
TEMOE,2009,6,0,6,0.0,100.0,Male
YAHEL,2009,7,0,7,0.0,100.0,Male
ADAM,2009,76497,128,76369,0.1673268232741153,99.83267317672588,Male
KAMIL,2009,133,0,133,0.0,100.0,Male
KAYA,2009,411,337,74,81.99513381995133,18.004866180048662,Unisex
LY,2009,327,215,112,65.74923547400611,34.25076452599388,Unisex
TAL,2009,369,294,75,79.67479674796748,20.32520325203252,Unisex
PARIS,2009,671,363,308,54.09836065573771,45.90163934426229,Unisex
CANDIDE,2009,1019,686,333,67.32090284592738,32.67909715407262,Unisex
NATTY,2009,369,228,141,61.78861788617886,38.21138211382114,Unisex
AZARIA,2009,120,74,46,61.66666666666667,38.333333333333336,Unisex
MALORY,2009,2305,1892,413,82.08242950108459,17.9175704989154,Unisex
ANGY,2009,571,264,307,46.234676007005255,53.76532399299475,Unisex
JEWEL,2009,136,72,64,52.94117647058824,47.05882352941176,Unisex
JOUD,2009,1447,329,1118,22.73669661368348,77.26330338631652,Unisex
JIHAD,2009,692,175,517,25.289017341040463,74.71098265895954,Unisex
LEONI,2009,132,107,25,81.06060606060606,18.939393939393938,Unisex
ISLEM,2009,2699,701,1998,25.972582437939977,74.02741756206002,Unisex
HYACINTHE,2009,4679,1173,3506,25.069459286172258,74.93054071382774,Unisex
CASEY,2009,566,144,422,25.4416961130742,74.55830388692578,Unisex
LIOR,2009,1001,172,829,17.182817182817185,82.81718281718283,Unisex
NOUHA,2009,689,401,288,58.20029027576198,41.79970972423803,Unisex
KENSY,2009,163,95,68,58.282208588957054,41.71779141104295,Unisex
SIRE,2009,102,58,44,56.86274509803921,43.13725490196079,Unisex
CLARENCE,2009,2943,924,2019,31.39653414882773,68.60346585117227,Unisex
MILANE,2009,634,298,336,47.003154574132495,52.99684542586751,Unisex
ZAYANE,2009,254,132,122,51.96850393700787,48.031496062992126,Unisex
KIMI,2009,536,202,334,37.6865671641791,62.31343283582089,Unisex
ZANA,2009,246,179,67,72.76422764227642,27.235772357723576,Unisex
MENEL,2010,7,7,0,100.0,0.0,Female
KAYLA,2010,162,162,0,100.0,0.0,Female
LYNNA,2010,40,40,0,100.0,0.0,Female
BLUE,2010,4,4,0,100.0,0.0,Female
SOKAYNA,2010,3,3,0,100.0,0.0,Female
OKSANA,2010,23,23,0,100.0,0.0,Female
FRANCINA,2010,3,3,0,100.0,0.0,Female
ANTOINETTE,2010,19,19,0,100.0,0.0,Female
LAILA,2010,65,65,0,100.0,0.0,Female
SHANAEL,2010,14,14,0,100.0,0.0,Female
ABBIE,2010,5,5,0,100.0,0.0,Female
TRECY,2010,9,9,0,100.0,0.0,Female
ZAHIRA,2010,10,10,0,100.0,0.0,Female
ELIORA,2010,16,16,0,100.0,0.0,Female
KERIDWEN,2010,3,3,0,100.0,0.0,Female
DAYA,2010,9,9,0,100.0,0.0,Female
GIANA,2010,4,4,0,100.0,0.0,Female
THÉANA,2010,3,3,0,100.0,0.0,Female
JAHIDA,2010,3,3,0,100.0,0.0,Female
HYLIANA,2010,5,5,0,100.0,0.0,Female
MILISSA,2010,4,4,0,100.0,0.0,Female
THAMARA,2010,3,3,0,100.0,0.0,Female
FILY,2010,8,8,0,100.0,0.0,Female
CHERIFA,2010,18,18,0,100.0,0.0,Female
ELAIS,2010,9,9,0,100.0,0.0,Female
WALLACE,2010,7,0,7,0.0,100.0,Male
BOAZ,2010,3,0,3,0.0,100.0,Male
LUCK,2010,9,0,9,0.0,100.0,Male
RYU,2010,4,0,4,0.0,100.0,Male
KATIB,2010,3,0,3,0.0,100.0,Male
TILYANN,2010,3,0,3,0.0,100.0,Male
PHAREL,2010,13,0,13,0.0,100.0,Male
UMEYR,2010,4,0,4,0.0,100.0,Male
RAMZI,2010,17,0,17,0.0,100.0,Male
JUN,2010,13,0,13,0.0,100.0,Male
NICK,2010,4,0,4,0.0,100.0,Male
EMRIC,2010,9,0,9,0.0,100.0,Male
ZIAN,2010,32,0,32,0.0,100.0,Male
KAYLANN,2010,4,0,4,0.0,100.0,Male
CASSIM,2010,4,0,4,0.0,100.0,Male
JOAQUIM,2010,78,0,78,0.0,100.0,Male
TYREESE,2010,3,0,3,0.0,100.0,Male
DONOVAN,2010,201,0,201,0.0,100.0,Male
OSMAN,2010,45,0,45,0.0,100.0,Male
JACQUES-ANTOINE,2010,3,0,3,0.0,100.0,Male
PHARELL,2010,52,0,52,0.0,100.0,Male
RADWAN,2010,6,0,6,0.0,100.0,Male
VAN,2010,5,0,5,0.0,100.0,Male
ATHANAEL,2010,5,0,5,0.0,100.0,Male
CONAN,2010,4,0,4,0.0,100.0,Male
KAREL,2010,1060,233,827,21.9811320754717,78.01886792452831,Unisex
AÏSSA,2010,1505,405,1100,26.91029900332225,73.08970099667775,Unisex
NOHA,2010,3543,766,2777,21.620095963872423,78.37990403612758,Unisex
ELOANN,2010,525,105,420,20.0,80.0,Unisex
BERYL,2010,762,607,155,79.65879265091863,20.341207349081365,Unisex
CLARENCE,2010,2943,924,2019,31.39653414882773,68.60346585117227,Unisex
DALI,2010,329,84,245,25.53191489361702,74.46808510638297,Unisex
IZAYA,2010,148,61,87,41.21621621621622,58.78378378378378,Unisex
MANAEL,2010,149,23,126,15.436241610738255,84.56375838926175,Unisex
ASSIL,2010,1985,1365,620,68.76574307304786,31.234256926952146,Unisex
HARENA,2010,154,114,40,74.02597402597402,25.97402597402597,Unisex
ILIA,2010,283,143,140,50.53003533568905,49.46996466431096,Unisex
LOIS,2010,681,216,465,31.71806167400881,68.28193832599119,Unisex
TAHIS,2010,250,137,113,54.8,45.2,Unisex
KINANE,2010,270,52,218,19.25925925925926,80.74074074074075,Unisex
DALY,2010,178,105,73,58.98876404494382,41.01123595505618,Unisex
CHEMS,2010,514,112,402,21.78988326848249,78.21011673151752,Unisex
AELIG,2010,289,128,161,44.29065743944637,55.70934256055363,Unisex
LILO,2010,815,482,333,59.14110429447853,40.85889570552147,Unisex
CHARLIE,2010,30211,15480,14731,51.23961470987389,48.76038529012611,Unisex
ADAMA,2010,3805,1078,2727,28.3311432325887,71.6688567674113,Unisex
JODY,2010,896,622,274,69.41964285714286,30.580357142857142,Unisex
ISLEM,2010,2699,701,1998,25.972582437939977,74.02741756206002,Unisex
CHAMS,2010,444,209,235,47.07207207207208,52.92792792792793,Unisex
CALISTE,2010,141,51,90,36.17021276595745,63.82978723404256,Unisex
ANNE-LYSE,2011,8,8,0,100.0,0.0,Female
ENEKA,2011,6,6,0,100.0,0.0,Female
AMELYNE,2011,4,4,0,100.0,0.0,Female
MAÉLYSSE,2011,7,7,0,100.0,0.0,Female
SHAILY,2011,7,7,0,100.0,0.0,Female
MARIELLA,2011,16,16,0,100.0,0.0,Female
SINAYA,2011,4,4,0,100.0,0.0,Female
ÉMY,2011,26,26,0,100.0,0.0,Female
LORÉLYNE,2011,5,5,0,100.0,0.0,Female
ODESSA,2011,11,11,0,100.0,0.0,Female
ALEXINE,2011,28,28,0,100.0,0.0,Female
LALY,2011,472,472,0,100.0,0.0,Female
BINETA,2011,5,5,0,100.0,0.0,Female
ANASTASIA,2011,134,134,0,100.0,0.0,Female
NASTIA,2011,7,7,0,100.0,0.0,Female
NISRINE,2011,87,87,0,100.0,0.0,Female
SARAI,2011,3,3,0,100.0,0.0,Female
NERIMEN,2011,4,4,0,100.0,0.0,Female
NORHÈNE,2011,3,3,0,100.0,0.0,Female
MAE-LYS,2011,4,4,0,100.0,0.0,Female
SALIMATOU,2011,6,6,0,100.0,0.0,Female
DANIELLA,2011,32,32,0,100.0,0.0,Female
RAMONA,2011,5,5,0,100.0,0.0,Female
LYNNA,2011,41,41,0,100.0,0.0,Female
COUMBA,2011,58,58,0,100.0,0.0,Female
SWEN,2011,6,0,6,0.0,100.0,Male
HAMZA,2011,583,0,583,0.0,100.0,Male
DJAWAD,2011,18,0,18,0.0,100.0,Male
SOHANN,2011,49,0,49,0.0,100.0,Male
NIKA,2011,7,0,7,0.0,100.0,Male
KÉAN,2011,5,0,5,0.0,100.0,Male
TAHIRY,2011,5,0,5,0.0,100.0,Male
LUKAS,2011,404,0,404,0.0,100.0,Male
FLOYD,2011,3,0,3,0.0,100.0,Male
TILLIO,2011,3,0,3,0.0,100.0,Male
MUHAMMET,2011,37,0,37,0.0,100.0,Male
AMEN,2011,6,0,6,0.0,100.0,Male
MANUA,2011,6,0,6,0.0,100.0,Male
SYLVIAN,2011,5,0,5,0.0,100.0,Male
SYLVAIN,2011,71,0,71,0.0,100.0,Male
ASHRAF,2011,9,0,9,0.0,100.0,Male
GUEWEN,2011,19,0,19,0.0,100.0,Male
SMAËL,2011,3,0,3,0.0,100.0,Male
MELWAN,2011,10,0,10,0.0,100.0,Male
KAYEL,2011,3,0,3,0.0,100.0,Male
MOHAMET,2011,3,0,3,0.0,100.0,Male
FATAH,2011,3,0,3,0.0,100.0,Male
DJINO,2011,17,0,17,0.0,100.0,Male
JOANN,2011,690,77,613,11.159420289855072,88.84057971014492,Male
KAÏL,2011,7,0,7,0.0,100.0,Male
TAYSSIR,2011,371,253,118,68.19407008086253,31.805929919137466,Unisex
NAÉ,2011,590,308,282,52.20338983050847,47.79661016949153,Unisex
ILKAY,2011,179,51,128,28.49162011173184,71.50837988826815,Unisex
NATTY,2011,369,228,141,61.78861788617886,38.21138211382114,Unisex
MIKI,2011,138,90,48,65.21739130434783,34.78260869565217,Unisex
JUN,2011,337,73,264,21.66172106824926,78.33827893175074,Unisex
ANGY,2011,571,264,307,46.234676007005255,53.76532399299475,Unisex
AYO,2011,128,96,32,75.0,25.0,Unisex
KENDY,2011,502,84,418,16.733067729083665,83.26693227091634,Unisex
MANAEL,2011,149,23,126,15.436241610738255,84.56375838926175,Unisex
MALORY,2011,2305,1892,413,82.08242950108459,17.9175704989154,Unisex
KÉLIANE,2011,64,41,23,64.0625,35.9375,Unisex
HANINE,2011,371,310,61,83.55795148247978,16.442048517520217,Unisex
GABY,2011,4741,2448,2293,51.63467622864375,48.36532377135626,Unisex
KIMI,2011,536,202,334,37.6865671641791,62.31343283582089,Unisex
GWENN,2011,1848,1201,647,64.98917748917748,35.01082251082251,Unisex
ORPHÉE,2011,293,121,172,41.29692832764505,58.70307167235495,Unisex
CHARLIE,2011,30211,15480,14731,51.23961470987389,48.76038529012611,Unisex
KELYS,2011,137,105,32,76.64233576642336,23.35766423357664,Unisex
SULTAN,2011,775,518,257,66.83870967741935,33.16129032258065,Unisex
EVANE,2011,809,612,197,75.64894932014833,24.351050679851667,Unisex
MENDY,2011,1198,737,461,61.51919866444074,38.48080133555926,Unisex
HOANG,2011,383,125,258,32.637075718015666,67.36292428198433,Unisex
MATEA,2011,296,247,49,83.44594594594594,16.554054054054053,Unisex
ÉDEN,2011,2423,529,1894,21.83243912505159,78.16756087494842,Unisex
LYZÉA,2012,19,19,0,100.0,0.0,Female
AITANA,2012,10,10,0,100.0,0.0,Female
MANEA,2012,10,10,0,100.0,0.0,Female
MARIELLE,2012,17,17,0,100.0,0.0,Female
LYSIANE,2012,7,7,0,100.0,0.0,Female
GUESSY,2012,3,3,0,100.0,0.0,Female
LOUÉNA,2012,8,8,0,100.0,0.0,Female
KYLIA,2012,23,23,0,100.0,0.0,Female
MAËLYAH,2012,3,3,0,100.0,0.0,Female
ELYNNA,2012,6,6,0,100.0,0.0,Female
KELYANA,2012,11,11,0,100.0,0.0,Female
SELSEBIL,2012,9,9,0,100.0,0.0,Female
BAKHTA,2012,3,3,0,100.0,0.0,Female
NILYA,2012,3,3,0,100.0,0.0,Female
MELLY,2012,8,8,0,100.0,0.0,Female
JAÏLYS,2012,3,3,0,100.0,0.0,Female
SALWA,2012,40,40,0,100.0,0.0,Female
EYLUL,2012,11,11,0,100.0,0.0,Female
KACY,2012,17,17,0,100.0,0.0,Female
ROMINA,2012,4,4,0,100.0,0.0,Female
NESSIA,2012,6,6,0,100.0,0.0,Female
CATALIYA,2012,5,5,0,100.0,0.0,Female
SALAMATA,2012,13,13,0,100.0,0.0,Female
TÉVY,2012,3,3,0,100.0,0.0,Female
DONYA,2012,10,10,0,100.0,0.0,Female
MYKE,2012,9,0,9,0.0,100.0,Male
YLIANN,2012,11,0,11,0.0,100.0,Male
JEAN-THOMAS,2012,3,0,3,0.0,100.0,Male
KELLYAN,2012,23,0,23,0.0,100.0,Male
TOMMASO,2012,7,0,7,0.0,100.0,Male
ALEANDRO,2012,4,0,4,0.0,100.0,Male
HAÏM,2012,4,0,4,0.0,100.0,Male
STEVEN,2012,129,0,129,0.0,100.0,Male
GONÇALO,2012,13,0,13,0.0,100.0,Male
ALEXEI,2012,3,0,3,0.0,100.0,Male
LOUËN,2012,3,0,3,0.0,100.0,Male
KEANE,2012,4,0,4,0.0,100.0,Male
MAELAN,2012,26,0,26,0.0,100.0,Male
MATEÏ,2012,6,0,6,0.0,100.0,Male
AZDINE,2012,9,0,9,0.0,100.0,Male
DEMIR,2012,6,0,6,0.0,100.0,Male
MOULAY,2012,12,0,12,0.0,100.0,Male
LOKMAN,2012,16,0,16,0.0,100.0,Male
ZÉPHIR,2012,10,0,10,0.0,100.0,Male
WESTLEY,2012,4,0,4,0.0,100.0,Male
FODE,2012,5,0,5,0.0,100.0,Male
YAHAYA,2012,7,0,7,0.0,100.0,Male
KAHIS,2012,3,0,3,0.0,100.0,Male
ANTZO,2012,4,0,4,0.0,100.0,Male
ROCHDI,2012,3,0,3,0.0,100.0,Male
KENDY,2012,502,84,418,16.733067729083665,83.26693227091634,Unisex
EDENN,2012,318,153,165,48.11320754716981,51.886792452830186,Unisex
XUAN,2012,274,134,140,48.9051094890511,51.09489051094891,Unisex
KAMILLE,2012,386,295,91,76.42487046632125,23.57512953367876,Unisex
ANAËL,2012,1563,505,1058,32.30966090850927,67.69033909149073,Unisex
ISLAME,2012,92,61,31,66.30434782608695,33.69565217391305,Unisex
THAYS,2012,372,264,108,70.96774193548387,29.03225806451613,Unisex
LOIS,2012,681,216,465,31.71806167400881,68.28193832599119,Unisex
JANYS,2012,132,67,65,50.75757575757576,49.24242424242424,Unisex
JOÉ,2012,358,75,283,20.949720670391063,79.05027932960894,Unisex
KÉZIAH,2012,463,188,275,40.60475161987041,59.3952483801296,Unisex
MAÏLAN,2012,185,49,136,26.486486486486488,73.51351351351352,Unisex
AWEN,2012,1169,253,916,21.642429426860566,78.35757057313944,Unisex
CHEMS,2012,514,112,402,21.78988326848249,78.21011673151752,Unisex
ELIAH,2012,291,150,141,51.546391752577314,48.45360824742268,Unisex
CHARLIE,2012,30211,15480,14731,51.23961470987389,48.76038529012611,Unisex
ANDGEL,2012,298,50,248,16.778523489932887,83.22147651006712,Unisex
KIMY,2012,602,501,101,83.22259136212624,16.77740863787375,Unisex
KAYA,2012,411,337,74,81.99513381995133,18.004866180048662,Unisex
CLARENCE,2012,2943,924,2019,31.39653414882773,68.60346585117227,Unisex
ENOA,2012,348,170,178,48.85057471264368,51.14942528735632,Unisex
EVANE,2012,809,612,197,75.64894932014833,24.351050679851667,Unisex
KAYLIS,2012,106,74,32,69.81132075471697,30.18867924528302,Unisex
TAYSSIR,2012,371,253,118,68.19407008086253,31.805929919137466,Unisex
LOUENN,2012,673,187,486,27.786032689450224,72.21396731054978,Unisex
SYBEL,2013,3,3,0,100.0,0.0,Female
OMEYMA,2013,3,3,0,100.0,0.0,Female
LEÏLY,2013,11,11,0,100.0,0.0,Female
MEISSANE,2013,7,7,0,100.0,0.0,Female
DJOULIANA,2013,3,3,0,100.0,0.0,Female
ISÉA,2013,5,5,0,100.0,0.0,Female
TYPHENN,2013,3,3,0,100.0,0.0,Female
ENOLLA,2013,6,6,0,100.0,0.0,Female
ESILA,2013,41,41,0,100.0,0.0,Female
SÏANA,2013,9,9,0,100.0,0.0,Female
NAËLLYS,2013,3,3,0,100.0,0.0,Female
KAÏLYNE,2013,3,3,0,100.0,0.0,Female
OLIWIA,2013,5,5,0,100.0,0.0,Female
MÉLLINA,2013,33,33,0,100.0,0.0,Female
SHAYNICE,2013,7,7,0,100.0,0.0,Female
MAHÉVA,2013,4,4,0,100.0,0.0,Female
CHRISTABEL,2013,3,3,0,100.0,0.0,Female
MAHAWA,2013,9,9,0,100.0,0.0,Female
ACHWAK,2013,4,4,0,100.0,0.0,Female
SOLYNE,2013,44,44,0,100.0,0.0,Female
LYS,2013,31,31,0,100.0,0.0,Female
LEÏANA,2013,3,3,0,100.0,0.0,Female
DAISY,2013,31,31,0,100.0,0.0,Female
CÉLIANE,2013,24,24,0,100.0,0.0,Female
LALIYA,2013,9,9,0,100.0,0.0,Female
GARAN,2013,3,0,3,0.0,100.0,Male
TYNÉO,2013,5,0,5,0.0,100.0,Male
CHAÏD,2013,3,0,3,0.0,100.0,Male
KAMIL,2013,182,0,182,0.0,100.0,Male
RADOUANE,2013,4,0,4,0.0,100.0,Male
ÉNOAH,2013,3,0,3,0.0,100.0,Male
LAURENTIU,2013,6,0,6,0.0,100.0,Male
CLÉANDRE,2013,5,0,5,0.0,100.0,Male
FERAS,2013,3,0,3,0.0,100.0,Male
VIANNEY,2013,53,0,53,0.0,100.0,Male
BOUBAKAR,2013,6,0,6,0.0,100.0,Male
COLLIN,2013,4,0,4,0.0,100.0,Male
ATAKAN,2013,4,0,4,0.0,100.0,Male
EDMOND,2013,11,0,11,0.0,100.0,Male
MOUSSA,2013,309,0,309,0.0,100.0,Male
ARDA,2013,54,0,54,0.0,100.0,Male
AMYAS,2013,4,0,4,0.0,100.0,Male
NATALE,2013,5,0,5,0.0,100.0,Male
ABDELSALAM,2013,3,0,3,0.0,100.0,Male
HUGUES,2013,31,0,31,0.0,100.0,Male
FELIPE,2013,8,0,8,0.0,100.0,Male
THADDÉE,2013,11,0,11,0.0,100.0,Male
GAULTHIER,2013,5,0,5,0.0,100.0,Male
GIANLUCA,2013,6,0,6,0.0,100.0,Male
PHARELL,2013,115,0,115,0.0,100.0,Male
SAWYER,2013,187,50,137,26.737967914438503,73.2620320855615,Unisex
SINA,2013,338,162,176,47.92899408284024,52.071005917159766,Unisex
LYSSANDRE,2013,574,157,417,27.35191637630662,72.64808362369338,Unisex
SIAM,2013,526,352,174,66.92015209125475,33.07984790874524,Unisex
WISSEM,2013,3049,682,2367,22.36798950475566,77.63201049524434,Unisex
LAMAR,2013,132,107,25,81.06060606060606,18.939393939393938,Unisex
JAYMIE,2013,109,35,74,32.11009174311927,67.88990825688074,Unisex
SIDNEY,2013,2484,951,1533,38.28502415458937,61.71497584541063,Unisex
JASMIN,2013,917,170,747,18.538713195201744,81.46128680479825,Unisex
HARPER,2013,338,255,83,75.44378698224851,24.55621301775148,Unisex
HAÏLEY,2013,315,209,106,66.34920634920634,33.65079365079365,Unisex
SHILOH,2013,179,109,70,60.89385474860335,39.10614525139665,Unisex
EVANE,2013,809,612,197,75.64894932014833,24.351050679851667,Unisex
ANGY,2013,571,264,307,46.234676007005255,53.76532399299475,Unisex
LISSANDRE,2013,345,74,271,21.44927536231884,78.55072463768116,Unisex
ACIL,2013,238,99,139,41.596638655462186,58.40336134453782,Unisex
FÉLICE,2013,62,32,30,51.61290322580645,48.38709677419355,Unisex
ADAMA,2013,3805,1078,2727,28.3311432325887,71.6688567674113,Unisex
ÉDEN,2013,2423,529,1894,21.83243912505159,78.16756087494842,Unisex
MANOA,2013,2510,554,1956,22.07171314741036,77.92828685258965,Unisex
NATTY,2013,369,228,141,61.78861788617886,38.21138211382114,Unisex
MEWENN,2013,281,96,185,34.16370106761566,65.83629893238434,Unisex
KERRY,2013,306,91,215,29.73856209150327,70.26143790849673,Unisex
MAËLIG,2013,128,46,82,35.9375,64.0625,Unisex
ELY,2013,1634,623,1011,38.12729498164015,61.87270501835985,Unisex
NILLA,2014,3,3,0,100.0,0.0,Female
AUBELINE,2014,9,9,0,100.0,0.0,Female
YOUNA,2014,120,120,0,100.0,0.0,Female
ROQAYA,2014,4,4,0,100.0,0.0,Female
CATALÏA,2014,3,3,0,100.0,0.0,Female
KYRA,2014,32,32,0,100.0,0.0,Female
FÉRIEL,2014,23,23,0,100.0,0.0,Female
IZUMI,2014,3,3,0,100.0,0.0,Female
SOFIA,2014,1333,1333,0,100.0,0.0,Female
THÉA,2014,288,288,0,100.0,0.0,Female
LIVIA,2014,795,795,0,100.0,0.0,Female
CAROLYNE,2014,3,3,0,100.0,0.0,Female
LARA,2014,358,358,0,100.0,0.0,Female
NIVINE,2014,6,6,0,100.0,0.0,Female
ESMÉE,2014,39,39,0,100.0,0.0,Female
MAÏSSA,2014,495,495,0,100.0,0.0,Female
OMAYRA,2014,3,3,0,100.0,0.0,Female
OLIVE,2014,22,22,0,100.0,0.0,Female
AILEEN,2014,11,11,0,100.0,0.0,Female
NIKKY,2014,3,3,0,100.0,0.0,Female
SAHANA,2014,4,4,0,100.0,0.0,Female
RAWANE,2014,334,303,31,90.71856287425148,9.281437125748502,Female
LAVIN,2014,7,7,0,100.0,0.0,Female
JULIANE,2014,34,34,0,100.0,0.0,Female
SUEDA,2014,4,4,0,100.0,0.0,Female
JOLAN,2014,54,0,54,0.0,100.0,Male
SOYAN,2014,4,0,4,0.0,100.0,Male
ESTEBÀN,2014,4,0,4,0.0,100.0,Male
ÉRIC,2014,12,0,12,0.0,100.0,Male
TYLANN,2014,9,0,9,0.0,100.0,Male
FABIANO,2014,4,0,4,0.0,100.0,Male
AMMAR,2014,21,0,21,0.0,100.0,Male
THADÉE,2014,3,0,3,0.0,100.0,Male
AURELE,2014,21,0,21,0.0,100.0,Male
CLYDE,2014,12,0,12,0.0,100.0,Male
ARYAN,2014,5,0,5,0.0,100.0,Male
CIPRIAN,2014,3,0,3,0.0,100.0,Male
ADRIÀN,2014,3,0,3,0.0,100.0,Male
MATEI,2014,37,0,37,0.0,100.0,Male
GUILIAN,2014,5,0,5,0.0,100.0,Male
QUSAY,2014,4,0,4,0.0,100.0,Male
ARONE,2014,11,0,11,0.0,100.0,Male
RADU,2014,8,0,8,0.0,100.0,Male
KEMAL,2014,7,0,7,0.0,100.0,Male
TÉLYO,2014,4,0,4,0.0,100.0,Male
GREGOIRE,2014,49,0,49,0.0,100.0,Male
MAIXENT,2014,7,0,7,0.0,100.0,Male
ÉLI,2014,20,0,20,0.0,100.0,Male
MEHMED,2014,5,0,5,0.0,100.0,Male
ANDRO,2014,4,0,4,0.0,100.0,Male
SAYANE,2014,189,68,121,35.978835978835974,64.02116402116403,Unisex
ORPHÉE,2014,293,121,172,41.29692832764505,58.70307167235495,Unisex
NAÉ,2014,590,308,282,52.20338983050847,47.79661016949153,Unisex
HILAL,2014,1545,1011,534,65.4368932038835,34.56310679611651,Unisex
CLARENCE,2014,2943,924,2019,31.39653414882773,68.60346585117227,Unisex
IHSANE,2014,689,439,250,63.7155297532656,36.2844702467344,Unisex
ELVAN,2014,378,220,158,58.2010582010582,41.7989417989418,Unisex
GABRIELE,2014,993,563,430,56.6968781470292,43.3031218529708,Unisex
SIDNEY,2014,2484,951,1533,38.28502415458937,61.71497584541063,Unisex
KEZIAH,2014,1699,467,1232,27.48675691583284,72.51324308416716,Unisex
NOLAH,2014,145,110,35,75.86206896551724,24.13793103448276,Unisex
GABY,2014,4741,2448,2293,51.63467622864375,48.36532377135626,Unisex
IHSSANE,2014,424,352,72,83.01886792452831,16.9811320754717,Unisex
JUNO,2014,238,163,75,68.4873949579832,31.512605042016805,Unisex
YAKINE,2014,610,342,268,56.0655737704918,43.9344262295082,Unisex
PRAISE,2014,150,88,62,58.66666666666666,41.333333333333336,Unisex
MISHA,2014,365,128,237,35.06849315068493,64.93150684931507,Unisex
IKRAM,2014,2750,2311,439,84.03636363636363,15.963636363636365,Unisex
WINNER,2014,261,57,204,21.83908045977012,78.16091954022988,Unisex
TAÏS,2014,979,689,290,70.3779366700715,29.6220633299285,Unisex
JESSY,2014,17091,3993,13098,23.363173600140424,76.63682639985957,Unisex
ZOLA,2014,956,804,152,84.10041841004184,15.899581589958158,Unisex
MALOÉ,2014,1021,734,287,71.89030362389815,28.109696376101866,Unisex
KIMI,2014,536,202,334,37.6865671641791,62.31343283582089,Unisex
LAYAN,2014,992,344,648,34.67741935483871,65.32258064516128,Unisex
HATOUMA,2015,29,29,0,100.0,0.0,Female
MICHÈLE,2015,8,8,0,100.0,0.0,Female
LEVANA,2015,8,8,0,100.0,0.0,Female
ADRIENNE,2015,7,7,0,100.0,0.0,Female
HADJA,2015,31,31,0,100.0,0.0,Female
EYLEEN,2015,11,11,0,100.0,0.0,Female
JAIMIE,2015,5,5,0,100.0,0.0,Female
TESSNIME,2015,3,3,0,100.0,0.0,Female
ZERYA,2015,6,6,0,100.0,0.0,Female
FIRDAOUSSE,2015,5,5,0,100.0,0.0,Female
NAELYA,2015,12,12,0,100.0,0.0,Female
SOLINA,2015,7,7,0,100.0,0.0,Female
ELARA,2015,3,3,0,100.0,0.0,Female
NASRA,2015,35,35,0,100.0,0.0,Female
MAËLYNA,2015,7,7,0,100.0,0.0,Female
MÉLISANDRE,2015,3,3,0,100.0,0.0,Female
NAËLIA,2015,7,7,0,100.0,0.0,Female
ELOÏSE,2015,703,703,0,100.0,0.0,Female
TANJA,2015,3,3,0,100.0,0.0,Female
ANNIA,2015,6,6,0,100.0,0.0,Female
KYARAH,2015,12,12,0,100.0,0.0,Female
MAGDA,2015,7,7,0,100.0,0.0,Female
OCEANNE,2015,5,5,0,100.0,0.0,Female
LIVA,2015,9,9,0,100.0,0.0,Female
LORYNE,2015,12,12,0,100.0,0.0,Female
MARLO,2015,9,0,9,0.0,100.0,Male
ERIS,2015,9,0,9,0.0,100.0,Male
ABDEL-WAKIL,2015,3,0,3,0.0,100.0,Male
LYANN,2015,8,0,8,0.0,100.0,Male
MONDHER,2015,3,0,3,0.0,100.0,Male
MOMEN,2015,4,0,4,0.0,100.0,Male
ESPOIR,2015,4,0,4,0.0,100.0,Male
EL-KARIM,2015,3,0,3,0.0,100.0,Male
IBRAHIMA,2015,113,0,113,0.0,100.0,Male
TIMOTÉO,2015,3,0,3,0.0,100.0,Male
EMRÉ,2015,4,0,4,0.0,100.0,Male
MAËLYO,2015,5,0,5,0.0,100.0,Male
KARAMOKO,2015,3,0,3,0.0,100.0,Male
LOËN,2015,17,0,17,0.0,100.0,Male
MEDDY,2015,9,0,9,0.0,100.0,Male
ABDE,2015,3,0,3,0.0,100.0,Male
MATHÉÏS,2015,28,0,28,0.0,100.0,Male
BATTISTE,2015,4,0,4,0.0,100.0,Male
JIMMY,2015,161,0,161,0.0,100.0,Male
JESON,2015,6,0,6,0.0,100.0,Male
STAN,2015,199,0,199,0.0,100.0,Male
ABDEL-JALIL,2015,6,0,6,0.0,100.0,Male
SÉRGIO,2015,3,0,3,0.0,100.0,Male
ELLIOT,2015,351,0,351,0.0,100.0,Male
TIZIO,2015,7,0,7,0.0,100.0,Male
ZIYA,2015,188,80,108,42.5531914893617,57.44680851063831,Unisex
YAËL,2015,3502,1564,1938,44.66019417475729,55.33980582524271,Unisex
SASHA,2015,18319,7736,10583,42.22937933293302,57.77062066706697,Unisex
GABY,2015,4741,2448,2293,51.63467622864375,48.36532377135626,Unisex
TAYLOR,2015,1722,499,1223,28.977932636469223,71.02206736353078,Unisex
KAMILLE,2015,386,295,91,76.42487046632125,23.57512953367876,Unisex
ARIEL,2015,2401,428,1973,17.8259058725531,82.17409412744689,Unisex
EZEL,2015,520,144,376,27.692307692307693,72.3076923076923,Unisex
NOHA,2015,3543,766,2777,21.620095963872423,78.37990403612758,Unisex
LOÏS,2015,11236,3416,7820,30.40227839088644,69.59772160911356,Unisex
NOLAH,2015,145,110,35,75.86206896551724,24.13793103448276,Unisex
HARPER,2015,338,255,83,75.44378698224851,24.55621301775148,Unisex
SWANN,2015,8143,2279,5864,27.98722829424045,72.01277170575955,Unisex
IKHLAS,2015,238,157,81,65.96638655462185,34.03361344537815,Unisex
SONAM,2015,132,42,90,31.818181818181817,68.18181818181817,Unisex
WILLOW,2015,928,738,190,79.52586206896551,20.474137931034484,Unisex
ADAMA,2015,3805,1078,2727,28.3311432325887,71.6688567674113,Unisex
KAYLIS,2015,106,74,32,69.81132075471697,30.18867924528302,Unisex
EXAUCÉ,2015,120,21,99,17.5,82.5,Unisex
ISLEYM,2015,455,379,76,83.2967032967033,16.7032967032967,Unisex
REYHAN,2015,370,280,90,75.67567567567568,24.324324324324326,Unisex
SOANE,2015,1340,953,387,71.11940298507463,28.88059701492537,Unisex
CALIXTE,2015,3347,540,2807,16.13385121003884,83.86614878996116,Unisex
ELISHA,2015,425,285,140,67.05882352941175,32.94117647058823,Unisex
SATYA,2015,470,149,321,31.70212765957447,68.29787234042554,Unisex
SERENA,2016,195,195,0,100.0,0.0,Female
ALIAH,2016,16,16,0,100.0,0.0,Female
DAYENA,2016,27,27,0,100.0,0.0,Female
DORCAS,2016,7,7,0,100.0,0.0,Female
SHIRLEY,2016,22,22,0,100.0,0.0,Female
AZILIZ,2016,21,21,0,100.0,0.0,Female
ENEA,2016,1012,906,106,89.52569169960475,10.474308300395258,Female
ANI,2016,21,21,0,100.0,0.0,Female
NEVIA,2016,3,3,0,100.0,0.0,Female
SHADEY,2016,9,9,0,100.0,0.0,Female
MÉLINA,2016,800,800,0,100.0,0.0,Female
MAÏSHA,2016,10,10,0,100.0,0.0,Female
SOLYNE,2016,50,50,0,100.0,0.0,Female
ANNE-FLORE,2016,3,3,0,100.0,0.0,Female
INASSE,2016,5,5,0,100.0,0.0,Female
AIZAH,2016,4,4,0,100.0,0.0,Female
PIA,2016,110,110,0,100.0,0.0,Female
NOUSROI,2016,3,3,0,100.0,0.0,Female
TAWBA,2016,15,15,0,100.0,0.0,Female
THEA,2016,173,173,0,100.0,0.0,Female
SHAYNES,2016,4,4,0,100.0,0.0,Female
PRINCESS,2016,5,5,0,100.0,0.0,Female
SAMAR,2016,17,17,0,100.0,0.0,Female
LAURYN,2016,25,25,0,100.0,0.0,Female
MALAURY,2016,15,15,0,100.0,0.0,Female
NABY,2016,5,0,5,0.0,100.0,Male
YOUNESS,2016,94,0,94,0.0,100.0,Male
ADYAN,2016,4,0,4,0.0,100.0,Male
BLAKE,2016,3,0,3,0.0,100.0,Male
ISAO,2016,31,0,31,0.0,100.0,Male
DOVBER,2016,3,0,3,0.0,100.0,Male
NEYMAR,2016,10,0,10,0.0,100.0,Male
SOHEÏL,2016,3,0,3,0.0,100.0,Male
HASSANE,2016,13,0,13,0.0,100.0,Male
RODRIGO,2016,76,0,76,0.0,100.0,Male
ABDARRAHMAN,2016,4,0,4,0.0,100.0,Male
MESSON,2016,23,0,23,0.0,100.0,Male
JOUNAYD,2016,27,0,27,0.0,100.0,Male
AZAËL,2016,8,0,8,0.0,100.0,Male
RUBENN,2016,3,0,3,0.0,100.0,Male
ROCHDI,2016,7,0,7,0.0,100.0,Male
AÏLAN,2016,6,0,6,0.0,100.0,Male
NAHUM,2016,3,0,3,0.0,100.0,Male
ARMANI,2016,4,0,4,0.0,100.0,Male
JOS,2016,5,0,5,0.0,100.0,Male
YAÏR,2016,4,0,4,0.0,100.0,Male
AMAIUR,2016,7,0,7,0.0,100.0,Male
DJANEL,2016,6,0,6,0.0,100.0,Male
FOUSSENI,2016,7,0,7,0.0,100.0,Male
WARRICK,2016,7,0,7,0.0,100.0,Male
JESSY,2016,17091,3993,13098,23.363173600140424,76.63682639985957,Unisex
ISLAM,2016,1463,253,1210,17.293233082706767,82.70676691729322,Unisex
ÉDEN,2016,2423,529,1894,21.83243912505159,78.16756087494842,Unisex
GAYA,2016,434,165,269,38.0184331797235,61.9815668202765,Unisex
ANDREA,2016,7488,1918,5570,25.61431623931624,74.38568376068376,Unisex
IMANI,2016,568,467,101,82.21830985915493,17.781690140845072,Unisex
MARLAY,2016,126,68,58,53.96825396825397,46.03174603174603,Unisex
SIDNEY,2016,2484,951,1533,38.28502415458937,61.71497584541063,Unisex
ENOA,2016,348,170,178,48.85057471264368,51.14942528735632,Unisex
ORACLE,2016,92,39,53,42.391304347826086,57.60869565217392,Unisex
ANH,2016,394,164,230,41.62436548223351,58.37563451776649,Unisex
CAMERONE,2016,283,163,120,57.59717314487632,42.40282685512368,Unisex
LOUCIANE,2016,55,22,33,40.0,60.0,Unisex
WISSAM,2016,2491,451,2040,18.105178643115213,81.89482135688479,Unisex
NIL,2016,1500,451,1049,30.06666666666667,69.93333333333334,Unisex
GLOIRE,2016,285,107,178,37.54385964912281,62.4561403508772,Unisex
PRAISE,2016,150,88,62,58.66666666666666,41.333333333333336,Unisex
LEE,2016,538,203,335,37.732342007434944,62.26765799256505,Unisex
ASSIL,2016,1985,1365,620,68.76574307304786,31.234256926952146,Unisex
HAÏLEY,2016,315,209,106,66.34920634920634,33.65079365079365,Unisex
ROBYN,2016,309,167,142,54.0453074433657,45.9546925566343,Unisex
SYDNEY,2016,2101,1236,865,58.829128986197055,41.17087101380295,Unisex
MALONNE,2016,116,36,80,31.03448275862069,68.96551724137932,Unisex
LOUISON,2016,11456,6222,5234,54.31215083798882,45.687849162011176,Unisex
KÉZIAH,2016,463,188,275,40.60475161987041,59.3952483801296,Unisex
DALYNE,2017,3,3,0,100.0,0.0,Female
EMEL,2017,7,7,0,100.0,0.0,Female
CAMILYA,2017,7,7,0,100.0,0.0,Female
ASSYAH,2017,15,15,0,100.0,0.0,Female
SHELCY,2017,3,3,0,100.0,0.0,Female
ERNESTINE,2017,37,37,0,100.0,0.0,Female
OUMEYMA,2017,11,11,0,100.0,0.0,Female
DJENNY,2017,6,6,0,100.0,0.0,Female
ILLY,2017,4,4,0,100.0,0.0,Female
MÉLYNN,2017,6,6,0,100.0,0.0,Female
JADE,2017,101757,101476,281,99.72385192173512,0.2761480782648859,Female
HALEY,2017,43,43,0,100.0,0.0,Female
ELOÏNE,2017,8,8,0,100.0,0.0,Female
YOHANNA,2017,7,7,0,100.0,0.0,Female
HAYNA,2017,5,5,0,100.0,0.0,Female
SÏA,2017,3,3,0,100.0,0.0,Female
MAÉE,2017,6,6,0,100.0,0.0,Female
AYUMI,2017,5,5,0,100.0,0.0,Female
ABIGAEL,2017,28,28,0,100.0,0.0,Female
HENDA,2017,18,18,0,100.0,0.0,Female
STEPHANIA,2017,5,5,0,100.0,0.0,Female
MÉLIANA,2017,16,16,0,100.0,0.0,Female
AËLA,2017,35,35,0,100.0,0.0,Female
NYA,2017,8,8,0,100.0,0.0,Female
KIRA,2017,32,32,0,100.0,0.0,Female
IMAD,2017,78,0,78,0.0,100.0,Male
YLIÈS,2017,24,0,24,0.0,100.0,Male
CAÏN,2017,4,0,4,0.0,100.0,Male
DAO,2017,6,0,6,0.0,100.0,Male
HAMZA,2017,611,0,611,0.0,100.0,Male
HADÈS,2017,7,0,7,0.0,100.0,Male
SERIGNE-FALLOU,2017,3,0,3,0.0,100.0,Male
ESTEBANE,2017,5,0,5,0.0,100.0,Male
CHAÏN,2017,4,0,4,0.0,100.0,Male
JONA,2017,10,0,10,0.0,100.0,Male
YERO,2017,3,0,3,0.0,100.0,Male
RAYENE,2017,5,0,5,0.0,100.0,Male
MAHAMAT,2017,6,0,6,0.0,100.0,Male
REHAN,2017,17,0,17,0.0,100.0,Male
ARIANO,2017,3,0,3,0.0,100.0,Male
SMAEL,2017,3,0,3,0.0,100.0,Male
MOHAND,2017,20,0,20,0.0,100.0,Male
NACER,2017,13,0,13,0.0,100.0,Male
AZIZ,2017,42,0,42,0.0,100.0,Male
KENJI,2017,20,0,20,0.0,100.0,Male
ILES,2017,4,0,4,0.0,100.0,Male
NAYLANN,2017,3,0,3,0.0,100.0,Male
MARCELINO,2017,14,0,14,0.0,100.0,Male
ELONE,2017,5,0,5,0.0,100.0,Male
ASAEL,2017,3,0,3,0.0,100.0,Male
_PRENOMS_RARES,2017,1760252,908578,851674,51.616359475802334,48.38364052419767,Unisex
DESTINY,2017,424,211,213,49.764150943396224,50.235849056603776,Unisex
DAYANE,2017,391,83,308,21.22762148337596,78.77237851662404,Unisex
NAÉ,2017,590,308,282,52.20338983050847,47.79661016949153,Unisex
NÉHÉMIE,2017,358,251,107,70.11173184357543,29.88826815642458,Unisex
JIA,2017,106,70,36,66.0377358490566,33.9622641509434,Unisex
MALONNE,2017,116,36,80,31.03448275862069,68.96551724137932,Unisex
EDEN,2017,33510,11200,22310,33.422858848105044,66.57714115189496,Unisex
LÉONCE,2017,548,123,425,22.445255474452555,77.55474452554745,Unisex
LEV,2017,157,56,101,35.6687898089172,64.3312101910828,Unisex
RILEY,2017,1192,325,867,27.265100671140942,72.73489932885906,Unisex
KEZIAH,2017,1699,467,1232,27.48675691583284,72.51324308416716,Unisex
CHARLIE,2017,30211,15480,14731,51.23961470987389,48.76038529012611,Unisex
SUNNY,2017,823,128,695,15.552855407047389,84.44714459295261,Unisex
DYLANE,2017,398,98,300,24.623115577889447,75.37688442211056,Unisex
ADAMA,2017,3805,1078,2727,28.3311432325887,71.6688567674113,Unisex
MORGANN,2017,1229,459,770,37.34743694060212,62.65256305939788,Unisex
AMANE,2017,373,221,152,59.24932975871313,40.75067024128686,Unisex
AVERY,2017,77,35,42,45.45454545454545,54.54545454545454,Unisex
SYDNEY,2017,2101,1236,865,58.829128986197055,41.17087101380295,Unisex
NIL,2017,1500,451,1049,30.06666666666667,69.93333333333334,Unisex
SWANN,2017,8143,2279,5864,27.98722829424045,72.01277170575955,Unisex
ISLEYM,2017,455,379,76,83.2967032967033,16.7032967032967,Unisex
JODY,2017,896,622,274,69.41964285714286,30.580357142857142,Unisex
IKRAM,2017,2750,2311,439,84.03636363636363,15.963636363636365,Unisex
ÉLÉANORE,2018,74,74,0,100.0,0.0,Female
IVANKA,2018,4,4,0,100.0,0.0,Female
INNAYAH,2018,4,4,0,100.0,0.0,Female
SANJA,2018,4,4,0,100.0,0.0,Female
ENAYA,2018,29,29,0,100.0,0.0,Female
LAYEN,2018,3,3,0,100.0,0.0,Female
KÉLYAH,2018,12,12,0,100.0,0.0,Female
ANNAYAH,2018,3,3,0,100.0,0.0,Female
AILEY,2018,4,4,0,100.0,0.0,Female
MARGOT,2018,1192,1192,0,100.0,0.0,Female
SIRIN,2018,6,6,0,100.0,0.0,Female
NÉHA,2018,6,6,0,100.0,0.0,Female
MARIÉTOU,2018,11,11,0,100.0,0.0,Female
LINSAY,2018,8,8,0,100.0,0.0,Female
ELOANE,2018,2705,2684,21,99.22365988909428,0.7763401109057301,Female
BELINDA,2018,6,6,0,100.0,0.0,Female
MAY-LI,2018,8,8,0,100.0,0.0,Female
ISAORA,2018,3,3,0,100.0,0.0,Female
KEREN,2018,1304,1263,41,96.8558282208589,3.144171779141104,Female
CLOE,2018,4,4,0,100.0,0.0,Female
LEONORE,2018,4,4,0,100.0,0.0,Female
FOULEMATA,2018,3,3,0,100.0,0.0,Female
LÉOCADIE,2018,9,9,0,100.0,0.0,Female
HANNAË,2018,6,6,0,100.0,0.0,Female
ANGÉLINE,2018,35,35,0,100.0,0.0,Female
ERIK,2018,19,0,19,0.0,100.0,Male
MAMADOU-LAMINE,2018,3,0,3,0.0,100.0,Male
ANTONYN,2018,7,0,7,0.0,100.0,Male
RIYAD,2018,128,0,128,0.0,100.0,Male
OUNEYS,2018,4,0,4,0.0,100.0,Male
FARRELL,2018,9,0,9,0.0,100.0,Male
EZEQUIEL,2018,21,0,21,0.0,100.0,Male
HODEI,2018,6,0,6,0.0,100.0,Male
MELVEEN,2018,3,0,3,0.0,100.0,Male
ERWAN,2018,403,0,403,0.0,100.0,Male
MATIS,2018,108,0,108,0.0,100.0,Male
ABAS,2018,4,0,4,0.0,100.0,Male
DION,2018,5,0,5,0.0,100.0,Male
KASSIAN,2018,5,0,5,0.0,100.0,Male
JOHAKIM,2018,7,0,7,0.0,100.0,Male
OTHNIEL,2018,11,0,11,0.0,100.0,Male
SILLY,2018,4,0,4,0.0,100.0,Male
SOLTAN,2018,4,0,4,0.0,100.0,Male
DEAN,2018,47,0,47,0.0,100.0,Male
HUSSEIN,2018,37,0,37,0.0,100.0,Male
STÉPHAN,2018,4,0,4,0.0,100.0,Male
LORICK,2018,17,0,17,0.0,100.0,Male
MYLES,2018,4,0,4,0.0,100.0,Male
TRÉSOR,2018,3,0,3,0.0,100.0,Male
YANIV,2018,5,0,5,0.0,100.0,Male
ELVIN,2018,816,215,601,26.34803921568628,73.65196078431373,Unisex
SWANNY,2018,534,310,224,58.05243445692884,41.94756554307117,Unisex
SPENCER,2018,293,48,245,16.38225255972696,83.61774744027304,Unisex
KIM,2018,6518,5270,1248,80.85302239950906,19.146977600490946,Unisex
ACYL,2018,78,20,58,25.64102564102564,74.35897435897436,Unisex
GENESIS,2018,110,90,20,81.81818181818183,18.181818181818183,Unisex
TAHIS,2018,250,137,113,54.8,45.2,Unisex
MOANA,2018,1034,769,265,74.37137330754352,25.62862669245648,Unisex
MAË,2018,1071,430,641,40.14939309056956,59.85060690943044,Unisex
FARA,2018,251,169,82,67.33067729083665,32.669322709163346,Unisex
NIKITA,2018,1692,1106,586,65.36643026004728,34.63356973995272,Unisex
AYANE,2018,623,119,504,19.101123595505616,80.89887640449437,Unisex
LEV,2018,157,56,101,35.6687898089172,64.3312101910828,Unisex
IKHLAS,2018,238,157,81,65.96638655462185,34.03361344537815,Unisex
ELOUANE,2018,429,339,90,79.02097902097903,20.97902097902098,Unisex
WINNER,2018,261,57,204,21.83908045977012,78.16091954022988,Unisex
SOL,2018,170,85,85,50.0,50.0,Unisex
SIAM,2018,526,352,174,66.92015209125475,33.07984790874524,Unisex
YAKINE,2018,610,342,268,56.0655737704918,43.9344262295082,Unisex
TAYLOR,2018,1722,499,1223,28.977932636469223,71.02206736353078,Unisex
ELIAH,2018,291,150,141,51.546391752577314,48.45360824742268,Unisex
ISAÉ,2018,115,81,34,70.43478260869566,29.565217391304348,Unisex
WILLOW,2018,928,738,190,79.52586206896551,20.474137931034484,Unisex
IKRAM,2018,2750,2311,439,84.03636363636363,15.963636363636365,Unisex
BLESSING,2018,427,344,83,80.56206088992974,19.437939110070257,Unisex
ADALIND,2019,6,6,0,100.0,0.0,Female
NESSYA,2019,12,12,0,100.0,0.0,Female
ZALIA,2019,6,6,0,100.0,0.0,Female
JEANNETTE,2019,13,13,0,100.0,0.0,Female
IOANA,2019,28,28,0,100.0,0.0,Female
MIHYA,2019,3,3,0,100.0,0.0,Female
GENA,2019,3,3,0,100.0,0.0,Female
CHELSY,2019,70,70,0,100.0,0.0,Female
MARINA,2019,100,100,0,100.0,0.0,Female
LYZA,2019,7,7,0,100.0,0.0,Female
CALLISTA,2019,4,4,0,100.0,0.0,Female
CASSANDRE,2019,357,357,0,100.0,0.0,Female
DJENEBA,2019,33,33,0,100.0,0.0,Female
ANDRÉANE,2019,5,5,0,100.0,0.0,Female
SCARLET,2019,3,3,0,100.0,0.0,Female
ABIGAÏL,2019,53,53,0,100.0,0.0,Female
MAINA,2019,6,6,0,100.0,0.0,Female
LOUCYA,2019,5,5,0,100.0,0.0,Female
TILELLI,2019,3,3,0,100.0,0.0,Female
LYNA-ROSE,2019,3,3,0,100.0,0.0,Female
MADENN,2019,28,28,0,100.0,0.0,Female
PHILAE,2019,7,7,0,100.0,0.0,Female
MEDELLIN,2019,3,3,0,100.0,0.0,Female
AXÈLE,2019,4,4,0,100.0,0.0,Female
NEÏLYA,2019,6,6,0,100.0,0.0,Female
FRANKLIN,2019,3,0,3,0.0,100.0,Male
EDHEN,2019,25,0,25,0.0,100.0,Male
TAYRON,2019,128,0,128,0.0,100.0,Male
MARC-EMMANUEL,2019,3,0,3,0.0,100.0,Male
PETTAN,2019,3,0,3,0.0,100.0,Male
MARCEL,2019,467,0,467,0.0,100.0,Male
CAMY,2019,4,0,4,0.0,100.0,Male
GEBRIL,2019,4,0,4,0.0,100.0,Male
DYCKLAN,2019,5,0,5,0.0,100.0,Male
YURI,2019,42,0,42,0.0,100.0,Male
GIANNY,2019,22,0,22,0.0,100.0,Male
MAHAMET,2019,5,0,5,0.0,100.0,Male
NAHIL,2019,548,0,548,0.0,100.0,Male
THÉODOR,2019,3,0,3,0.0,100.0,Male
THIERRY,2019,14,0,14,0.0,100.0,Male
MARCELLINO,2019,5,0,5,0.0,100.0,Male
CURTIS,2019,54,0,54,0.0,100.0,Male
AMADO,2019,4,0,4,0.0,100.0,Male
PACÔME,2019,106,0,106,0.0,100.0,Male
SOANN,2019,125,0,125,0.0,100.0,Male
YAMADOU,2019,3,0,3,0.0,100.0,Male
KILIAN,2019,61,0,61,0.0,100.0,Male
ELWAN,2019,34,0,34,0.0,100.0,Male
MALON,2019,15,0,15,0.0,100.0,Male
KEYHAN,2019,5,0,5,0.0,100.0,Male
ELY,2019,1634,623,1011,38.12729498164015,61.87270501835985,Unisex
LIWEN,2019,150,71,79,47.333333333333336,52.66666666666666,Unisex
SINAÏ,2019,399,308,91,77.19298245614034,22.807017543859647,Unisex
MANOHA,2019,201,62,139,30.845771144278604,69.15422885572139,Unisex
CHEMS,2019,514,112,402,21.78988326848249,78.21011673151752,Unisex
AÏLEY,2019,58,30,28,51.72413793103448,48.27586206896552,Unisex
ALYX,2019,268,184,84,68.65671641791045,31.343283582089555,Unisex
LAYAN,2019,992,344,648,34.67741935483871,65.32258064516128,Unisex
SAPHIR,2019,587,109,478,18.56899488926746,81.43100511073254,Unisex
THAYS,2019,372,264,108,70.96774193548387,29.03225806451613,Unisex
YI,2019,137,63,74,45.98540145985402,54.01459854014598,Unisex
MIRACLE,2019,236,148,88,62.71186440677966,37.28813559322034,Unisex
ELIKIA,2019,255,160,95,62.74509803921568,37.25490196078432,Unisex
DILAN,2019,1452,360,1092,24.793388429752067,75.20661157024794,Unisex
LEE,2019,538,203,335,37.732342007434944,62.26765799256505,Unisex
KABA,2019,229,87,142,37.99126637554585,62.00873362445415,Unisex
DIAMOND,2019,146,44,102,30.136986301369863,69.86301369863014,Unisex
YAQINE,2019,114,54,60,47.368421052631575,52.63157894736842,Unisex
LILO,2019,815,482,333,59.14110429447853,40.85889570552147,Unisex
DAKOTA,2019,200,167,33,83.5,16.5,Unisex
SUNNY,2019,823,128,695,15.552855407047389,84.44714459295261,Unisex
HARPER,2019,338,255,83,75.44378698224851,24.55621301775148,Unisex
IHSANE,2019,689,439,250,63.7155297532656,36.2844702467344,Unisex
TAYSSIR,2019,371,253,118,68.19407008086253,31.805929919137466,Unisex
SIDNEY,2019,2484,951,1533,38.28502415458937,61.71497584541063,Unisex
LHYA,2020,3,3,0,100.0,0.0,Female
KYANA,2020,25,25,0,100.0,0.0,Female
ALYSA,2020,3,3,0,100.0,0.0,Female
GOLDA,2020,6,6,0,100.0,0.0,Female
NADINE,2020,51,51,0,100.0,0.0,Female
KADY,2020,25,25,0,100.0,0.0,Female
AËLLE,2020,4,4,0,100.0,0.0,Female
CARINA,2020,6,6,0,100.0,0.0,Female
EMI,2020,32,32,0,100.0,0.0,Female
MAÏRAM,2020,3,3,0,100.0,0.0,Female
NAOUMI,2020,10,10,0,100.0,0.0,Female
LEINA,2020,8,8,0,100.0,0.0,Female
JIULIA,2020,4,4,0,100.0,0.0,Female
NESSY,2020,16,16,0,100.0,0.0,Female
SYLLIA,2020,3,3,0,100.0,0.0,Female
CLOTILDE,2020,82,82,0,100.0,0.0,Female
OCEANE,2020,13,13,0,100.0,0.0,Female
ROSINE,2020,5,5,0,100.0,0.0,Female
NAJMA,2020,13,13,0,100.0,0.0,Female
MARCIA,2020,13,13,0,100.0,0.0,Female
ELYZA,2020,3,3,0,100.0,0.0,Female
NUMIDIA,2020,13,13,0,100.0,0.0,Female
EMEL,2020,13,13,0,100.0,0.0,Female
LEHANA,2020,3,3,0,100.0,0.0,Female
RAYHANA,2020,66,66,0,100.0,0.0,Female
CHARLES-EDOUARD,2020,3,0,3,0.0,100.0,Male
GUILHERME,2020,16,0,16,0.0,100.0,Male
RADJAN,2020,6,0,6,0.0,100.0,Male
EDVIN,2020,5,0,5,0.0,100.0,Male
ARES,2020,7,0,7,0.0,100.0,Male
RENZO,2020,5,0,5,0.0,100.0,Male
ARI,2020,28,0,28,0.0,100.0,Male
DJAFAR,2020,4,0,4,0.0,100.0,Male
AYLANE,2020,41,0,41,0.0,100.0,Male
NATANE,2020,5,0,5,0.0,100.0,Male
YSSAM,2020,3,0,3,0.0,100.0,Male
ADRIANN,2020,6,0,6,0.0,100.0,Male
ASLANE,2020,5,0,5,0.0,100.0,Male
EWANN,2020,12,0,12,0.0,100.0,Male
FAÏZ,2020,11,0,11,0.0,100.0,Male
OMAR,2020,316,0,316,0.0,100.0,Male
ABDOLLAH,2020,4,0,4,0.0,100.0,Male
HASHIM,2020,3,0,3,0.0,100.0,Male
SAMPIERU,2020,5,0,5,0.0,100.0,Male
KERAN,2020,10,0,10,0.0,100.0,Male
MAÏWAN,2020,3,0,3,0.0,100.0,Male
ELLIOT,2020,305,0,305,0.0,100.0,Male
MOUHAMMED,2020,20,0,20,0.0,100.0,Male
SÉBASTIEN,2020,78,0,78,0.0,100.0,Male
IUSTIN,2020,4,0,4,0.0,100.0,Male
LAYAN,2020,992,344,648,34.67741935483871,65.32258064516128,Unisex
RAHIL,2020,233,173,60,74.2489270386266,25.75107296137339,Unisex
NÉHÉMIE,2020,358,251,107,70.11173184357543,29.88826815642458,Unisex
ELIYAH,2020,431,358,73,83.06264501160094,16.937354988399072,Unisex
AZUR,2020,199,59,140,29.64824120603015,70.35175879396985,Unisex
DARCY,2020,213,131,82,61.502347417840376,38.49765258215962,Unisex
RIYANE,2020,143,26,117,18.181818181818183,81.81818181818183,Unisex
MAËLANN,2020,411,148,263,36.009732360097324,63.99026763990268,Unisex
SUNNY,2020,823,128,695,15.552855407047389,84.44714459295261,Unisex
LIO,2020,362,292,70,80.66298342541437,19.33701657458564,Unisex
LYWENN,2020,170,137,33,80.58823529411765,19.411764705882355,Unisex
TAHYS,2020,739,286,453,38.700947225981054,61.29905277401895,Unisex
ADONAÏ,2020,145,44,101,30.344827586206897,69.6551724137931,Unisex
LISSANDRE,2020,345,74,271,21.44927536231884,78.55072463768116,Unisex
MARLEY,2020,5347,1064,4283,19.899008789975685,80.1009912100243,Unisex
CALIXTE,2020,3347,540,2807,16.13385121003884,83.86614878996116,Unisex
AÏSSA,2020,1505,405,1100,26.91029900332225,73.08970099667775,Unisex
SPENCER,2020,293,48,245,16.38225255972696,83.61774744027304,Unisex
AWEN,2020,1169,253,916,21.642429426860566,78.35757057313944,Unisex
SASHA,2020,18319,7736,10583,42.22937933293302,57.77062066706697,Unisex
AINA,2020,736,618,118,83.96739130434783,16.032608695652172,Unisex
AÏKO,2020,191,134,57,70.15706806282722,29.84293193717277,Unisex
DALI,2020,329,84,245,25.53191489361702,74.46808510638297,Unisex
ASSYL,2020,196,123,73,62.755102040816325,37.24489795918368,Unisex
EDENN,2020,318,153,165,48.11320754716981,51.886792452830186,Unisex
CHELSEY,2021,7,7,0,100.0,0.0,Female
ISRA,2021,184,184,0,100.0,0.0,Female
CHERISH,2021,3,3,0,100.0,0.0,Female
LOUCYA,2021,6,6,0,100.0,0.0,Female
MARYA,2021,67,67,0,100.0,0.0,Female
LAURIANA,2021,10,10,0,100.0,0.0,Female
MAËLYN,2021,8,8,0,100.0,0.0,Female
ANIA,2021,136,136,0,100.0,0.0,Female
MAELYS,2021,46,46,0,100.0,0.0,Female
SILVIA,2021,9,9,0,100.0,0.0,Female
ANAROSE,2021,3,3,0,100.0,0.0,Female
SOUNDOUSSE,2021,5,5,0,100.0,0.0,Female
OSWA,2021,9,9,0,100.0,0.0,Female
LILWENN,2021,79,79,0,100.0,0.0,Female
MAGUETTE,2021,8,8,0,100.0,0.0,Female
NASSMA,2021,5,5,0,100.0,0.0,Female
THYA,2021,30,30,0,100.0,0.0,Female
NAOUMI,2021,8,8,0,100.0,0.0,Female
KAILA,2021,7,7,0,100.0,0.0,Female
LYNA,2021,927,927,0,100.0,0.0,Female
MAWA,2021,31,31,0,100.0,0.0,Female
CALLIOPÉ,2021,12,12,0,100.0,0.0,Female
HEDAYA,2021,4,4,0,100.0,0.0,Female
ZUZANNA,2021,4,4,0,100.0,0.0,Female
THÉIA,2021,6,6,0,100.0,0.0,Female
ASHVIN,2021,5,0,5,0.0,100.0,Male
GUILHÈM,2021,3,0,3,0.0,100.0,Male
YLIES,2021,24,0,24,0.0,100.0,Male
NAHID,2021,8,0,8,0.0,100.0,Male
EYVAN,2021,8,0,8,0.0,100.0,Male
FATEH,2021,5,0,5,0.0,100.0,Male
NADIM,2021,13,0,13,0.0,100.0,Male
MOUNDIR,2021,4,0,4,0.0,100.0,Male
BOSCO,2021,44,0,44,0.0,100.0,Male
SLOANN,2021,10,0,10,0.0,100.0,Male
OUAYS,2021,6,0,6,0.0,100.0,Male
AURÈLE,2021,180,0,180,0.0,100.0,Male
DAYYAN,2021,4,0,4,0.0,100.0,Male
ENZYO,2021,3,0,3,0.0,100.0,Male
MATTY,2021,14,0,14,0.0,100.0,Male
GALAAD,2021,14,0,14,0.0,100.0,Male
STANN,2021,10,0,10,0.0,100.0,Male
LEROY,2021,10,0,10,0.0,100.0,Male
FERHAT,2021,7,0,7,0.0,100.0,Male
OWEYS,2021,10,0,10,0.0,100.0,Male
ANTONIO,2021,88,0,88,0.0,100.0,Male
ZAÏNOUDINE,2021,4,0,4,0.0,100.0,Male
ZÉLIO,2021,11,0,11,0.0,100.0,Male
LALO,2021,9,0,9,0.0,100.0,Male
ALPHA-OUMAR,2021,7,0,7,0.0,100.0,Male
MADY,2021,2286,1197,1089,52.362204724409445,47.63779527559055,Unisex
LEE,2021,538,203,335,37.732342007434944,62.26765799256505,Unisex
MIRACLE,2021,236,148,88,62.71186440677966,37.28813559322034,Unisex
THAYS,2021,372,264,108,70.96774193548387,29.03225806451613,Unisex
GWEN,2021,941,419,522,44.52709883103082,55.47290116896918,Unisex
MALLORY,2021,2883,2151,732,74.60978147762746,25.390218522372525,Unisex
MAÉ,2021,7467,1694,5773,22.6864872103924,77.31351278960761,Unisex
ADONAÏ,2021,145,44,101,30.344827586206897,69.6551724137931,Unisex
LYSANDRE,2021,1858,363,1495,19.53713670613563,80.46286329386437,Unisex
ABI,2021,137,114,23,83.21167883211679,16.78832116788321,Unisex
MIRADI,2021,69,33,36,47.82608695652174,52.17391304347826,Unisex
KAMAR,2021,235,187,48,79.57446808510639,20.42553191489361,Unisex
MOANA,2021,1034,769,265,74.37137330754352,25.62862669245648,Unisex
DYLANE,2021,398,98,300,24.623115577889447,75.37688442211056,Unisex
MAËLANN,2021,411,148,263,36.009732360097324,63.99026763990268,Unisex
ELISHA,2021,425,285,140,67.05882352941175,32.94117647058823,Unisex
MALOË,2021,361,256,105,70.91412742382272,29.085872576177284,Unisex
DIOR,2021,226,167,59,73.89380530973452,26.10619469026549,Unisex
CHARLIE,2021,30211,15480,14731,51.23961470987389,48.76038529012611,Unisex
MICHA,2021,257,42,215,16.342412451361866,83.65758754863813,Unisex
AÏLEY,2021,58,30,28,51.72413793103448,48.27586206896552,Unisex
NOHA,2021,3543,766,2777,21.620095963872423,78.37990403612758,Unisex
ASSYL,2021,196,123,73,62.755102040816325,37.24489795918368,Unisex
SADIO,2021,1523,895,628,58.76559422193039,41.2344057780696,Unisex
SHAYDEN,2021,89,47,42,52.80898876404494,47.19101123595505,Unisex
ANAHIT,2022,4,4,0,100.0,0.0,Female
IBTYSSEM,2022,3,3,0,100.0,0.0,Female
ZAHARA,2022,10,10,0,100.0,0.0,Female
EMMANUELLE,2022,43,43,0,100.0,0.0,Female
LOUJAYNA,2022,3,3,0,100.0,0.0,Female
ELYNAH,2022,3,3,0,100.0,0.0,Female
ANFAL,2022,23,23,0,100.0,0.0,Female
YABA,2022,3,3,0,100.0,0.0,Female
DELIA,2022,48,48,0,100.0,0.0,Female
YANAËLLE,2022,7,7,0,100.0,0.0,Female
HAYLINE,2022,4,4,0,100.0,0.0,Female
LULA,2022,8,8,0,100.0,0.0,Female
DENIA,2022,3,3,0,100.0,0.0,Female
AZZURRA,2022,24,24,0,100.0,0.0,Female
SOFIA,2022,1168,1168,0,100.0,0.0,Female
NISANUR,2022,6,6,0,100.0,0.0,Female
LORNA,2022,6,6,0,100.0,0.0,Female
JOUWAYRIYA,2022,8,8,0,100.0,0.0,Female
WILMA,2022,3,3,0,100.0,0.0,Female
AYISHA,2022,5,5,0,100.0,0.0,Female
HAWWA,2022,7,7,0,100.0,0.0,Female
VITALIE,2022,7,7,0,100.0,0.0,Female
DÉLIA,2022,73,73,0,100.0,0.0,Female
MÉLÏA,2022,13,13,0,100.0,0.0,Female
ILHAM,2022,2871,2697,174,93.93939393939394,6.0606060606060606,Female
JONAH,2022,123,0,123,0.0,100.0,Male
RAPHAEL,2022,160,0,160,0.0,100.0,Male
MADYAN,2022,9,0,9,0.0,100.0,Male
YASINE,2022,7,0,7,0.0,100.0,Male
ARÈS,2022,48,0,48,0.0,100.0,Male
LÉVY,2022,41,0,41,0.0,100.0,Male
MYLANN,2022,272,0,272,0.0,100.0,Male
MOUMINE,2022,5,0,5,0.0,100.0,Male
BENOÎT,2022,51,0,51,0.0,100.0,Male
SEYDOU,2022,52,0,52,0.0,100.0,Male
HOUDEYFA,2022,10,0,10,0.0,100.0,Male
ALÉSIO,2022,11,0,11,0.0,100.0,Male
PRYAM,2022,7,0,7,0.0,100.0,Male
YSAAC,2022,7,0,7,0.0,100.0,Male
PROSPER,2022,10,0,10,0.0,100.0,Male
KENANN,2022,11,0,11,0.0,100.0,Male
DEJAN,2022,11,0,11,0.0,100.0,Male
CHEMSDINE,2022,4,0,4,0.0,100.0,Male
MILHAN,2022,208,0,208,0.0,100.0,Male
JAYLEN,2022,20,0,20,0.0,100.0,Male
CORNEILLE,2022,3,0,3,0.0,100.0,Male
SOUHAIL,2022,25,0,25,0.0,100.0,Male
NAÏR,2022,10,0,10,0.0,100.0,Male
RAYHAN,2022,1055,38,1017,3.6018957345971563,96.39810426540284,Male
FADEL,2022,12,0,12,0.0,100.0,Male
KENDALL,2022,307,153,154,49.8371335504886,50.1628664495114,Unisex
SOANE,2022,1340,953,387,71.11940298507463,28.88059701492537,Unisex
ELVAN,2022,378,220,158,58.2010582010582,41.7989417989418,Unisex
LÉONI,2022,102,51,51,50.0,50.0,Unisex
HARLEY,2022,280,148,132,52.85714285714286,47.14285714285714,Unisex
NOA,2022,38708,6263,32445,16.18011780510489,83.81988219489511,Unisex
ROBYN,2022,309,167,142,54.0453074433657,45.9546925566343,Unisex
NIKITA,2022,1692,1106,586,65.36643026004728,34.63356973995272,Unisex
KÉZIAH,2022,463,188,275,40.60475161987041,59.3952483801296,Unisex
LIOR,2022,1001,172,829,17.182817182817185,82.81718281718283,Unisex
LIO,2022,362,292,70,80.66298342541437,19.33701657458564,Unisex
LYSSANDRE,2022,574,157,417,27.35191637630662,72.64808362369338,Unisex
KEZYAH,2022,68,28,40,41.17647058823529,58.82352941176471,Unisex
IKHLAS,2022,238,157,81,65.96638655462185,34.03361344537815,Unisex
LAYAN,2022,992,344,648,34.67741935483871,65.32258064516128,Unisex
MANEA,2022,258,198,60,76.74418604651163,23.25581395348837,Unisex
IZAYA,2022,148,61,87,41.21621621621622,58.78378378378378,Unisex
ORACLE,2022,92,39,53,42.391304347826086,57.60869565217392,Unisex
LISANDRE,2022,453,151,302,33.33333333333333,66.66666666666666,Unisex
DAYANE,2022,391,83,308,21.22762148337596,78.77237851662404,Unisex
LOÏS,2022,11236,3416,7820,30.40227839088644,69.59772160911356,Unisex
REYHAN,2022,370,280,90,75.67567567567568,24.324324324324326,Unisex
SYLLA,2022,230,111,119,48.26086956521739,51.73913043478261,Unisex
TENZIN,2022,431,176,255,40.835266821345705,59.164733178654295,Unisex
LYOR,2022,146,27,119,18.493150684931507,81.5068493150685,Unisex
