Name,Year,Total_sum,Female_count,Male_count,Female_percentage,Male_percentage,Gender
ESTELLA,1908,11,11,0,100.0,0.0,Female
RICHARDE,1908,5,5,0,100.0,0.0,Female
IVETTE,1908,6,6,0,100.0,0.0,Female
WILLIAM,1908,84,0,84,0.0,100.0,Male
LIEVIN,1908,5,0,5,0.0,100.0,Male
WALTHER,1908,15,0,15,0.0,100.0,Male
MARIE-JOSEPH,1908,2275,1830,445,80.43956043956044,19.56043956043956,Unisex
CALIXTE,1908,3347,540,2807,16.13385121003884,83.86614878996116,Unisex
IRENEE,1908,6155,1854,4301,30.121852152721363,69.87814784727864,Unisex
MICHÈLE,1909,11,11,0,100.0,0.0,Female
LOUISE,1909,6439,6439,0,100.0,0.0,Female
ELISABETHE,1909,7,7,0,100.0,0.0,Female
MEDERIC,1909,9,0,9,0.0,100.0,Male
LOUIS,1909,532690,186,532504,0.0349171187745217,99.96508288122548,Male
CYRILLE,1909,38448,1590,36858,4.135455680399501,95.8645443196005,Male
HONORAT,1909,652,270,382,41.41104294478527,58.58895705521472,Unisex
SAINTE,1909,1055,648,407,61.4218009478673,38.5781990521327,Unisex
HYACINTHE,1909,4679,1173,3506,25.069459286172258,74.93054071382774,Unisex
IVONNE,1910,48,48,0,100.0,0.0,Female
ZOEE,1910,3,3,0,100.0,0.0,Female
ESTHER,1910,142,142,0,100.0,0.0,Female
BERTY,1910,3,0,3,0.0,100.0,Male
TRISTAN,1910,3,0,3,0.0,100.0,Male
ELI,1910,3,0,3,0.0,100.0,Male
ALOISE,1910,2160,384,1776,17.77777777777778,82.22222222222221,Unisex
_PRENOMS_RARES,1910,1760252,908578,851674,51.616359475802334,48.38364052419767,Unisex
SULPICE,1910,508,182,326,35.826771653543304,64.1732283464567,Unisex
FIDELINE,1911,14,14,0,100.0,0.0,Female
JOCELYNE,1911,3,3,0,100.0,0.0,Female
MARIE-CLOTILDE,1911,3,3,0,100.0,0.0,Female
EVAN,1911,3,0,3,0.0,100.0,Male
CHRISTIN,1911,5,0,5,0.0,100.0,Male
GUALBERT,1911,7,0,7,0.0,100.0,Male
AMOUR,1911,782,287,495,36.70076726342711,63.29923273657288,Unisex
GEORGE,1911,2417,650,1767,26.89284236657013,73.10715763342988,Unisex
SOSTHENE,1911,1059,185,874,17.469310670443818,82.53068932955618,Unisex
COLETTE,1912,366,366,0,100.0,0.0,Female
MAXIMA,1912,3,3,0,100.0,0.0,Female
IVA,1912,3,3,0,100.0,0.0,Female
CLARIUS,1912,4,0,4,0.0,100.0,Male
MAMERT,1912,4,0,4,0.0,100.0,Male
ANACLET,1912,5,0,5,0.0,100.0,Male
IRENEE,1912,6155,1854,4301,30.121852152721363,69.87814784727864,Unisex
PULCHERIE,1912,738,579,159,78.45528455284553,21.54471544715448,Unisex
CAMILLE,1912,287709,207732,79977,72.20212089298562,27.79787910701437,Unisex
ADELPHINE,1913,6,6,0,100.0,0.0,Female
ZILDA,1913,4,4,0,100.0,0.0,Female
ROMAINE,1913,39,39,0,100.0,0.0,Female
ORESTE,1913,10,0,10,0.0,100.0,Male
FENELON,1913,4,0,4,0.0,100.0,Male
VALENTIN,1913,158,0,158,0.0,100.0,Male
HONORAT,1913,652,270,382,41.41104294478527,58.58895705521472,Unisex
MAURILLE,1913,834,214,620,25.65947242206235,74.34052757793765,Unisex
PULCHERIE,1913,738,579,159,78.45528455284553,21.54471544715448,Unisex
AMALIA,1914,3,3,0,100.0,0.0,Female
LIDY,1914,4,4,0,100.0,0.0,Female
MARIE-FRANÇOISE,1914,35,35,0,100.0,0.0,Female
HUBERT,1914,65967,186,65781,0.2819591613988813,99.71804083860113,Male
ARNAUD,1914,69,0,69,0.0,100.0,Male
EMIL,1914,3,0,3,0.0,100.0,Male
OCULI,1914,447,105,342,23.48993288590604,76.51006711409396,Unisex
GEORGE,1914,2417,650,1767,26.89284236657013,73.10715763342988,Unisex
IRENEE,1914,6155,1854,4301,30.121852152721363,69.87814784727864,Unisex
RAPHAELA,1915,5,5,0,100.0,0.0,Female
FLEURINE,1915,9,9,0,100.0,0.0,Female
ROMAINE,1915,15,15,0,100.0,0.0,Female
FIACRE,1915,3,0,3,0.0,100.0,Male
CHRISTOPHE,1915,63,0,63,0.0,100.0,Male
GUERIN,1915,6,0,6,0.0,100.0,Male
HONORAT,1915,652,270,382,41.41104294478527,58.58895705521472,Unisex
ALIX,1915,37305,28371,8934,76.05146763168477,23.94853236831524,Unisex
EUSTACHE,1915,1376,277,1099,20.13081395348837,79.86918604651163,Unisex
HORTENSIA,1916,7,7,0,100.0,0.0,Female
ARLETTE,1916,116,116,0,100.0,0.0,Female
ALIXE,1916,7,7,0,100.0,0.0,Female
SALOMON,1916,12,0,12,0.0,100.0,Male
DIEGO,1916,4,0,4,0.0,100.0,Male
MATHIS,1916,3,0,3,0.0,100.0,Male
_PRENOMS_RARES,1916,1760252,908578,851674,51.616359475802334,48.38364052419767,Unisex
BONIFACE,1916,1187,217,970,18.28138163437237,81.71861836562763,Unisex
EULOGE,1916,621,198,423,31.88405797101449,68.11594202898551,Unisex
CELESTINE,1917,149,149,0,100.0,0.0,Female
MOISETTE,1917,12,12,0,100.0,0.0,Female
SUZY,1917,3,3,0,100.0,0.0,Female
FLORIS,1917,7,0,7,0.0,100.0,Male
GAUTIER,1917,6,0,6,0.0,100.0,Male
THADEE,1917,3,0,3,0.0,100.0,Male
SAINTE,1917,1055,648,407,61.4218009478673,38.5781990521327,Unisex
CAMILLE,1917,287709,207732,79977,72.20212089298562,27.79787910701437,Unisex
_PRENOMS_RARES,1917,1760252,908578,851674,51.616359475802334,48.38364052419767,Unisex
HILDEGARDE,1918,40,40,0,100.0,0.0,Female
AMANTE,1918,6,6,0,100.0,0.0,Female
FELICIE,1918,133,133,0,100.0,0.0,Female
JEAN-RENÉ,1918,3,0,3,0.0,100.0,Male
RENAUD,1918,13,0,13,0.0,100.0,Male
JEAN-JOSEPH,1918,9,0,9,0.0,100.0,Male
GEORGE,1918,2417,650,1767,26.89284236657013,73.10715763342988,Unisex
CALIXTE,1918,3347,540,2807,16.13385121003884,83.86614878996116,Unisex
PLACIDE,1918,1098,214,884,19.489981785063755,80.51001821493625,Unisex
ANNIE,1919,47,47,0,100.0,0.0,Female
TOUSSINE,1919,8,8,0,100.0,0.0,Female
ALSACE,1919,5,5,0,100.0,0.0,Female
GONTRAN,1919,1535,129,1406,8.403908794788274,91.59609120521172,Male
FREDY,1919,4,0,4,0.0,100.0,Male
ROCK,1919,5,0,5,0.0,100.0,Male
EUSTACHE,1919,1376,277,1099,20.13081395348837,79.86918604651163,Unisex
LEONIDE,1919,1588,1245,343,78.40050377833752,21.599496221662463,Unisex
EUSEBE,1919,1151,212,939,18.41876629018245,81.58123370981755,Unisex
JUANA,1920,7,7,0,100.0,0.0,Female
GEORGETTE,1920,5702,5702,0,100.0,0.0,Female
ELVIRE,1920,49,49,0,100.0,0.0,Female
BERANGER,1920,3,0,3,0.0,100.0,Male
PATRICE,1920,138904,794,138110,0.5716178079824915,99.42838219201752,Male
GUSTAVE,1920,37156,171,36985,0.4602217676822047,99.5397782323178,Male
BONIFACE,1920,1187,217,970,18.28138163437237,81.71861836562763,Unisex
ALIX,1920,37305,28371,8934,76.05146763168477,23.94853236831524,Unisex
EUSTACHE,1920,1376,277,1099,20.13081395348837,79.86918604651163,Unisex
VINCENTINE,1921,6,6,0,100.0,0.0,Female
EPIPHANIE,1921,6,6,0,100.0,0.0,Female
MARCELLA,1921,16,16,0,100.0,0.0,Female
SAINT-JEAN,1921,8,0,8,0.0,100.0,Male
LUCIANO,1921,4,0,4,0.0,100.0,Male
EDWARD,1921,16,0,16,0.0,100.0,Male
CREPIN,1921,606,136,470,22.44224422442244,77.55775577557755,Unisex
SAINTE,1921,1055,648,407,61.4218009478673,38.5781990521327,Unisex
SABAS,1921,607,220,387,36.24382207578254,63.75617792421746,Unisex
ADELA,1922,3,3,0,100.0,0.0,Female
MATHEA,1922,3,3,0,100.0,0.0,Female
ATHANASIE,1922,4,4,0,100.0,0.0,Female
ISMAEL,1922,22,0,22,0.0,100.0,Male
DOMENICO,1922,4,0,4,0.0,100.0,Male
LEONARD,1922,12032,183,11849,1.5209441489361704,98.47905585106383,Male
CALIXTE,1922,3347,540,2807,16.13385121003884,83.86614878996116,Unisex
CAMILLE,1922,287709,207732,79977,72.20212089298562,27.79787910701437,Unisex
EULOGE,1922,621,198,423,31.88405797101449,68.11594202898551,Unisex
SIMONE,1923,7086,7086,0,100.0,0.0,Female
LOUISANE,1923,3,3,0,100.0,0.0,Female
RACHELLE,1923,53,53,0,100.0,0.0,Female
EDWIN,1923,6,0,6,0.0,100.0,Male
JEAN-CLAUDE,1923,39,0,39,0.0,100.0,Male
GILDAS,1923,12,0,12,0.0,100.0,Male
NONCE,1923,598,172,426,28.762541806020064,71.23745819397993,Unisex
VENANCE,1923,314,123,191,39.171974522293,60.828025477707,Unisex
ALIX,1923,37305,28371,8934,76.05146763168477,23.94853236831524,Unisex
ABELLE,1924,5,5,0,100.0,0.0,Female
LINDA,1924,8,8,0,100.0,0.0,Female
DEA,1924,3,3,0,100.0,0.0,Female
EGIDE,1924,4,0,4,0.0,100.0,Male
PRIVAT,1924,3,0,3,0.0,100.0,Male
ADAM,1924,30,0,30,0.0,100.0,Male
SAINTE,1924,1055,648,407,61.4218009478673,38.5781990521327,Unisex
ALIX,1924,37305,28371,8934,76.05146763168477,23.94853236831524,Unisex
EUSEBE,1924,1151,212,939,18.41876629018245,81.58123370981755,Unisex
LILLIA,1925,3,3,0,100.0,0.0,Female
ELIANNE,1925,42,42,0,100.0,0.0,Female
CELIANE,1925,3,3,0,100.0,0.0,Female
HECTOR,1925,54,0,54,0.0,100.0,Male
JUSTE,1925,784,108,676,13.77551020408163,86.22448979591837,Male
ENRIQUE,1925,5,0,5,0.0,100.0,Male
PLACIDE,1925,1098,214,884,19.489981785063755,80.51001821493625,Unisex
ARCADE,1925,883,249,634,28.199320498301244,71.80067950169875,Unisex
MARY,1925,6861,5830,1031,84.97303600058301,15.026963999416996,Unisex
ZORA,1926,4,4,0,100.0,0.0,Female
REINE,1926,752,752,0,100.0,0.0,Female
AMBROISINE,1926,34,34,0,100.0,0.0,Female
DANIEL,1926,1776,0,1776,0.0,100.0,Male
ODET,1926,4,0,4,0.0,100.0,Male
CARL,1926,3,0,3,0.0,100.0,Male
LEONCE,1926,9290,2041,7249,21.96986006458557,78.03013993541443,Unisex
PLACIDE,1926,1098,214,884,19.489981785063755,80.51001821493625,Unisex
CANDIDE,1926,1019,686,333,67.32090284592738,32.67909715407262,Unisex
ANGÈLE,1927,71790,71550,240,99.66569160050146,0.3343083994985374,Female
JEANINE,1927,1257,1257,0,100.0,0.0,Female
PALMYRE,1927,2291,2203,88,96.15888258402444,3.841117415975556,Female
ENNEMOND,1927,3,0,3,0.0,100.0,Male
THADDEE,1927,3,0,3,0.0,100.0,Male
ALOYSE,1927,58,0,58,0.0,100.0,Male
CAMILLE,1927,287709,207732,79977,72.20212089298562,27.79787910701437,Unisex
NICOMEDE,1927,430,193,237,44.88372093023256,55.11627906976744,Unisex
EUSTASE,1927,347,116,231,33.429394812680115,66.57060518731988,Unisex
SERAPHIE,1928,4,4,0,100.0,0.0,Female
SALOMÉ,1928,15,15,0,100.0,0.0,Female
FANNY,1928,63,63,0,100.0,0.0,Female
LADISLAS,1928,17,0,17,0.0,100.0,Male
SIDOINE,1928,5,0,5,0.0,100.0,Male
ANTHELME,1928,5,0,5,0.0,100.0,Male
ARCADE,1928,883,249,634,28.199320498301244,71.80067950169875,Unisex
CAMILLE,1928,287709,207732,79977,72.20212089298562,27.79787910701437,Unisex
OPTAT,1928,203,61,142,30.049261083743843,69.95073891625616,Unisex
RÉGINA,1929,5,5,0,100.0,0.0,Female
LIONELLE,1929,4,4,0,100.0,0.0,Female
ODYLLE,1929,10,10,0,100.0,0.0,Female
HORACE,1929,9,0,9,0.0,100.0,Male
GAËTAN,1929,52617,157,52460,0.2983826519946025,99.7016173480054,Male
ODILON,1929,7,0,7,0.0,100.0,Male
MERY,1929,515,409,106,79.41747572815534,20.58252427184466,Unisex
NICOMEDE,1929,430,193,237,44.88372093023256,55.11627906976744,Unisex
NONCE,1929,598,172,426,28.762541806020064,71.23745819397993,Unisex
EDMONDE,1930,183,183,0,100.0,0.0,Female
MICHALINA,1930,3,3,0,100.0,0.0,Female
ANNA,1930,1186,1186,0,100.0,0.0,Female
GEOFFROY,1930,8964,121,8843,1.3498438197233378,98.65015618027668,Male
LUC,1930,65427,126,65301,0.1925810445229033,99.8074189554771,Male
BELA,1930,5,0,5,0.0,100.0,Male
CRESCENT,1930,447,87,360,19.463087248322147,80.53691275167785,Unisex
QUIRIN,1930,193,38,155,19.68911917098445,80.31088082901555,Unisex
SABAS,1930,607,220,387,36.24382207578254,63.75617792421746,Unisex
FERDINANDE,1931,6,6,0,100.0,0.0,Female
LAURA,1931,13,13,0,100.0,0.0,Female
SUZANNE,1931,291073,290970,103,99.96461368797516,0.0353863120248185,Female
JOCELYN,1931,11,0,11,0.0,100.0,Male
FRANÇOIS,1931,4110,0,4110,0.0,100.0,Male
JOAQUIM,1931,13,0,13,0.0,100.0,Male
LOETARE,1931,208,95,113,45.67307692307692,54.32692307692307,Unisex
JANY,1931,3897,2256,1641,57.89068514241724,42.10931485758276,Unisex
PIE,1931,251,88,163,35.0597609561753,64.9402390438247,Unisex
ARGENTINE,1932,10,10,0,100.0,0.0,Female
NITA,1932,4,4,0,100.0,0.0,Female
ANDRESINE,1932,3,3,0,100.0,0.0,Female
CYRIAQUE,1932,2241,229,2012,10.218652387327086,89.78134761267292,Male
JAKY,1932,13,0,13,0.0,100.0,Male
EDGARD,1932,6689,70,6619,1.0464942442816565,98.95350575571834,Male
WENCESLAS,1932,877,175,702,19.95438996579248,80.04561003420753,Unisex
AVIT,1932,485,106,379,21.855670103092784,78.14432989690722,Unisex
MAURILLE,1932,834,214,620,25.65947242206235,74.34052757793765,Unisex
MARINA,1933,13,13,0,100.0,0.0,Female
FERNANDA,1933,4,4,0,100.0,0.0,Female
GRATIANNE,1933,5,5,0,100.0,0.0,Female
CORNEILLE,1933,4,0,4,0.0,100.0,Male
CLOTAIRE,1933,4231,142,4089,3.356180571968802,96.6438194280312,Male
AMAND,1933,74,0,74,0.0,100.0,Male
WENCESLAS,1933,877,175,702,19.95438996579248,80.04561003420753,Unisex
MODERAN,1933,258,58,200,22.48062015503876,77.51937984496125,Unisex
SAINTE,1933,1055,648,407,61.4218009478673,38.5781990521327,Unisex
REINE,1934,578,578,0,100.0,0.0,Female
LEOPOLDINE,1934,10,10,0,100.0,0.0,Female
FLEURINE,1934,3,3,0,100.0,0.0,Female
LUDWIK,1934,3,0,3,0.0,100.0,Male
CORNEILLE,1934,6,0,6,0.0,100.0,Male
CARLO,1934,10,0,10,0.0,100.0,Male
_PRENOMS_RARES,1934,1760252,908578,851674,51.616359475802334,48.38364052419767,Unisex
SCHOLASTIQUE,1934,1080,835,245,77.31481481481481,22.685185185185187,Unisex
SOCRATE,1934,378,96,282,25.396825396825395,74.60317460317461,Unisex
ASTRID,1935,36,36,0,100.0,0.0,Female
CONCEPTION,1935,11,11,0,100.0,0.0,Female
MARIE-CHRISTINE,1935,6,6,0,100.0,0.0,Female
JOAQUIM,1935,3,0,3,0.0,100.0,Male
CLERY,1935,3,0,3,0.0,100.0,Male
ZIGMUND,1935,3,0,3,0.0,100.0,Male
DANY,1935,26027,7836,18191,30.10719637299728,69.89280362700273,Unisex
LEONCE,1935,9290,2041,7249,21.96986006458557,78.03013993541443,Unisex
SABAS,1935,607,220,387,36.24382207578254,63.75617792421746,Unisex
ROSEMARY,1936,3,3,0,100.0,0.0,Female
MURIELLE,1936,3,3,0,100.0,0.0,Female
AMANDA,1936,5,5,0,100.0,0.0,Female
JIMMY,1936,7,0,7,0.0,100.0,Male
AMEDEE,1936,8323,621,7702,7.461251952421002,92.538748047579,Male
JOSSE,1936,4,0,4,0.0,100.0,Male
SABAS,1936,607,220,387,36.24382207578254,63.75617792421746,Unisex
MODESTE,1936,1853,656,1197,35.4020507285483,64.59794927145171,Unisex
ANDOCHE,1936,390,140,250,35.8974358974359,64.1025641025641,Unisex
AGLAE,1937,4,4,0,100.0,0.0,Female
HELYETTE,1937,13,13,0,100.0,0.0,Female
BERNADINE,1937,10,10,0,100.0,0.0,Female
AYMAR,1937,3,0,3,0.0,100.0,Male
GINES,1937,3,0,3,0.0,100.0,Male
VLADIMIR,1937,8,0,8,0.0,100.0,Male
LEONCE,1937,9290,2041,7249,21.96986006458557,78.03013993541443,Unisex
MARIE-JOSEPH,1937,2275,1830,445,80.43956043956044,19.56043956043956,Unisex
MODESTE,1937,1853,656,1197,35.4020507285483,64.59794927145171,Unisex
ANITA,1938,132,132,0,100.0,0.0,Female
DORIS,1938,27,27,0,100.0,0.0,Female
FERNANDA,1938,4,4,0,100.0,0.0,Female
RYSZARD,1938,3,0,3,0.0,100.0,Male
SERGES,1938,8,0,8,0.0,100.0,Male
JEAN-PHILIPPE,1938,11,0,11,0.0,100.0,Male
NONCE,1938,598,172,426,28.762541806020064,71.23745819397993,Unisex
MESMIN,1938,773,183,590,23.67399741267788,76.32600258732212,Unisex
NICOMEDE,1938,430,193,237,44.88372093023256,55.11627906976744,Unisex
JANNIE,1939,6,6,0,100.0,0.0,Female
ZELIA,1939,5,5,0,100.0,0.0,Female
GUYLENE,1939,4,4,0,100.0,0.0,Female
ADELIN,1939,3,0,3,0.0,100.0,Male
SEZNY,1939,3,0,3,0.0,100.0,Male
NOE,1939,13,0,13,0.0,100.0,Male
ALIX,1939,37305,28371,8934,76.05146763168477,23.94853236831524,Unisex
DOMINIQUE,1939,409989,168027,241962,40.98329467375954,59.01670532624046,Unisex
ANDOCHE,1939,390,140,250,35.8974358974359,64.1025641025641,Unisex
MANOLITA,1940,5,5,0,100.0,0.0,Female
FLAVIE,1940,15,15,0,100.0,0.0,Female
MARIE-SIMONE,1940,3,3,0,100.0,0.0,Female
LONGIN,1940,3,0,3,0.0,100.0,Male
ALDO,1940,21,0,21,0.0,100.0,Male
ABDON,1940,869,101,768,11.622554660529344,88.37744533947065,Male
CREPIN,1940,606,136,470,22.44224422442244,77.55775577557755,Unisex
JANNY,1940,1044,617,427,59.099616858237546,40.90038314176245,Unisex
PHILOGONE,1940,396,183,213,46.21212121212121,53.78787878787878,Unisex
TOUSSINE,1941,8,8,0,100.0,0.0,Female
VINCINE,1941,7,7,0,100.0,0.0,Female
LISETTE,1941,92,92,0,100.0,0.0,Female
ERWIN,1941,65,0,65,0.0,100.0,Male
PEDRO,1941,25,0,25,0.0,100.0,Male
UMBERTO,1941,7,0,7,0.0,100.0,Male
JANNY,1941,1044,617,427,59.099616858237546,40.90038314176245,Unisex
YANICK,1941,3028,482,2546,15.918097754293262,84.08190224570674,Unisex
CAMILLE,1941,287709,207732,79977,72.20212089298562,27.79787910701437,Unisex
ÉLIANE,1942,4,4,0,100.0,0.0,Female
HELGA,1942,74,74,0,100.0,0.0,Female
ROLANDE,1942,601,601,0,100.0,0.0,Female
EDWIN,1942,12,0,12,0.0,100.0,Male
LEONIEN,1942,5,0,5,0.0,100.0,Male
LOUIS-MARIE,1942,3,0,3,0.0,100.0,Male
CLAUDY,1942,2240,835,1405,37.27678571428572,62.72321428571429,Unisex
LEONCE,1942,9290,2041,7249,21.96986006458557,78.03013993541443,Unisex
MARY,1942,6861,5830,1031,84.97303600058301,15.026963999416996,Unisex
CATHERINE,1943,394929,394703,226,99.94277452402837,0.0572254759716303,Female
MANON,1943,6,6,0,100.0,0.0,Female
MIREILLE,1943,2914,2914,0,100.0,0.0,Female
HILAIRE,1943,4759,351,4408,7.375499054423199,92.6245009455768,Male
ROMÉO,1943,6,0,6,0.0,100.0,Male
RAINER,1943,14,0,14,0.0,100.0,Male
JEANNY,1943,968,718,250,74.17355371900827,25.82644628099173,Unisex
MARY,1943,6861,5830,1031,84.97303600058301,15.026963999416996,Unisex
AVIT,1943,485,106,379,21.855670103092784,78.14432989690722,Unisex
CONCEPTION,1944,9,9,0,100.0,0.0,Female
INGRID,1944,39,39,0,100.0,0.0,Female
ISABEL,1944,3,3,0,100.0,0.0,Female
WACLAW,1944,5,0,5,0.0,100.0,Male
ADAM,1944,9,0,9,0.0,100.0,Male
ZENON,1944,9,0,9,0.0,100.0,Male
YANICK,1944,3028,482,2546,15.918097754293262,84.08190224570674,Unisex
JANIK,1944,500,287,213,57.4,42.6,Unisex
EUSTACHE,1944,1376,277,1099,20.13081395348837,79.86918604651163,Unisex
SUSY,1945,3,3,0,100.0,0.0,Female
DOROTHEE,1945,15967,15713,254,98.40921901421682,1.590780985783178,Female
SOFIA,1945,4,4,0,100.0,0.0,Female
IVAN,1945,39,0,39,0.0,100.0,Male
CONSTANT,1945,61,0,61,0.0,100.0,Male
ROMUALD,1945,16,0,16,0.0,100.0,Male
ALIX,1945,37305,28371,8934,76.05146763168477,23.94853236831524,Unisex
DOMINIQUE,1945,409989,168027,241962,40.98329467375954,59.01670532624046,Unisex
JANICK,1945,4109,2203,1906,53.61401800924799,46.38598199075201,Unisex
BLUETTE,1946,3,3,0,100.0,0.0,Female
LISE,1946,164,164,0,100.0,0.0,Female
ALEXANDRINE,1946,32,32,0,100.0,0.0,Female
FREDI,1946,4,0,4,0.0,100.0,Male
BRAHIM,1946,5,0,5,0.0,100.0,Male
ALFRED,1946,480,0,480,0.0,100.0,Male
SOSTHENE,1946,1059,185,874,17.469310670443818,82.53068932955618,Unisex
SAINTE,1946,1055,648,407,61.4218009478673,38.5781990521327,Unisex
MARY,1946,6861,5830,1031,84.97303600058301,15.026963999416996,Unisex
MARYLISE,1947,42,42,0,100.0,0.0,Female
MARIE-PIERRETTE,1947,8,8,0,100.0,0.0,Female
MARIE-LIESSE,1947,3,3,0,100.0,0.0,Female
SAINT-JEAN,1947,6,0,6,0.0,100.0,Male
KRISTIAN,1947,4,0,4,0.0,100.0,Male
NELLO,1947,4,0,4,0.0,100.0,Male
ALIX,1947,37305,28371,8934,76.05146763168477,23.94853236831524,Unisex
MEDARD,1947,1076,175,901,16.263940520446095,83.7360594795539,Unisex
IRENEE,1947,6155,1854,4301,30.121852152721363,69.87814784727864,Unisex
MARIE-EDITH,1948,26,26,0,100.0,0.0,Female
ANNIQUE,1948,5,5,0,100.0,0.0,Female
CHRISTÈLE,1948,6,6,0,100.0,0.0,Female
BILLY,1948,3,0,3,0.0,100.0,Male
JEAN-EDMOND,1948,4,0,4,0.0,100.0,Male
PIERRE-JACQUES,1948,4,0,4,0.0,100.0,Male
CAMILLE,1948,287709,207732,79977,72.20212089298562,27.79787910701437,Unisex
YANIK,1948,330,50,280,15.151515151515152,84.84848484848484,Unisex
JANICK,1948,4109,2203,1906,53.61401800924799,46.38598199075201,Unisex
ANNIE-MARIE,1949,9,9,0,100.0,0.0,Female
MYRTHA,1949,6,6,0,100.0,0.0,Female
FERNANDE,1949,332,332,0,100.0,0.0,Female
JEAN-LAURENT,1949,6,0,6,0.0,100.0,Male
WLADISLAW,1949,8,0,8,0.0,100.0,Male
ODILON,1949,3,0,3,0.0,100.0,Male
HONORAT,1949,652,270,382,41.41104294478527,58.58895705521472,Unisex
_PRENOMS_RARES,1949,1760252,908578,851674,51.616359475802334,48.38364052419767,Unisex
DOMINIQUE,1949,409989,168027,241962,40.98329467375954,59.01670532624046,Unisex
ARIELLE,1950,22,22,0,100.0,0.0,Female
CELIANE,1950,6,6,0,100.0,0.0,Female
MARIE-BRIGITTE,1950,25,25,0,100.0,0.0,Female
MARC-HENRI,1950,3,0,3,0.0,100.0,Male
SULLY,1950,15,0,15,0.0,100.0,Male
JEAN-CLÉMENT,1950,8,0,8,0.0,100.0,Male
SULPICE,1950,508,182,326,35.826771653543304,64.1732283464567,Unisex
YANICK,1950,3028,482,2546,15.918097754293262,84.08190224570674,Unisex
SIMPLICE,1950,329,106,223,32.21884498480243,67.78115501519757,Unisex
MAURICETTE,1951,1124,1124,0,100.0,0.0,Female
AUDE,1951,33,33,0,100.0,0.0,Female
GERARDINE,1951,16,16,0,100.0,0.0,Female
GINES,1951,4,0,4,0.0,100.0,Male
LAHCENE,1951,3,0,3,0.0,100.0,Male
JEAN-DENYS,1951,3,0,3,0.0,100.0,Male
HYACINTHE,1951,4679,1173,3506,25.069459286172258,74.93054071382774,Unisex
CAMILLE,1951,287709,207732,79977,72.20212089298562,27.79787910701437,Unisex
SIMPLICE,1951,329,106,223,32.21884498480243,67.78115501519757,Unisex
LILI,1952,3,3,0,100.0,0.0,Female
GISELENE,1952,6,6,0,100.0,0.0,Female
EMILIENNE,1952,116,116,0,100.0,0.0,Female
SAINT,1952,10,0,10,0.0,100.0,Male
GEORGIE,1952,3,0,3,0.0,100.0,Male
CHARLIE,1952,26,0,26,0.0,100.0,Male
JANNICK,1952,2792,1545,1247,55.336676217765046,44.66332378223496,Unisex
LEONCE,1952,9290,2041,7249,21.96986006458557,78.03013993541443,Unisex
CAROL,1952,3507,2953,554,84.20302252637582,15.79697747362418,Unisex
MALICA,1953,10,10,0,100.0,0.0,Female
DAMIENE,1953,3,3,0,100.0,0.0,Female
ROSETTE,1953,89,89,0,100.0,0.0,Female
ABDALLAH,1953,17,0,17,0.0,100.0,Male
JEAN-GILLES,1953,18,0,18,0.0,100.0,Male
ERMES,1953,3,0,3,0.0,100.0,Male
DANY,1953,26027,7836,18191,30.10719637299728,69.89280362700273,Unisex
GEORGE,1953,2417,650,1767,26.89284236657013,73.10715763342988,Unisex
IRENEE,1953,6155,1854,4301,30.121852152721363,69.87814784727864,Unisex
MARIANA,1954,13,13,0,100.0,0.0,Female
ROSELISE,1954,3,3,0,100.0,0.0,Female
BETTY,1954,141,141,0,100.0,0.0,Female
SALEM,1954,11,0,11,0.0,100.0,Male
PETER,1954,26,0,26,0.0,100.0,Male
JEAN-FRANCOIS,1954,5,0,5,0.0,100.0,Male
DOMINIQUE,1954,409989,168027,241962,40.98329467375954,59.01670532624046,Unisex
EUSTACHE,1954,1376,277,1099,20.13081395348837,79.86918604651163,Unisex
NICAISE,1954,1786,1255,531,70.26875699888018,29.73124300111982,Unisex
PALMA,1955,3,3,0,100.0,0.0,Female
EMMA,1955,168777,168560,217,99.87142797893078,0.1285720210692215,Female
CHRISLAINE,1955,9,9,0,100.0,0.0,Female
ZACHARIE,1955,5450,192,5258,3.522935779816514,96.47706422018348,Male
RICKY,1955,4,0,4,0.0,100.0,Male
HERMANN,1955,18,0,18,0.0,100.0,Male
MARY,1955,6861,5830,1031,84.97303600058301,15.026963999416996,Unisex
JANICK,1955,4109,2203,1906,53.61401800924799,46.38598199075201,Unisex
MARIE-JOSEPH,1955,2275,1830,445,80.43956043956044,19.56043956043956,Unisex
OURIDA,1956,10,10,0,100.0,0.0,Female
ELISEMEE,1956,3,3,0,100.0,0.0,Female
ELINE,1956,4,4,0,100.0,0.0,Female
REYNAL,1956,4,0,4,0.0,100.0,Male
ROSEMOND,1956,4,0,4,0.0,100.0,Male
ANATOLE,1956,15,0,15,0.0,100.0,Male
JANNY,1956,1044,617,427,59.099616858237546,40.90038314176245,Unisex
_PRENOMS_RARES,1956,1760252,908578,851674,51.616359475802334,48.38364052419767,Unisex
ANONYME,1956,513,197,316,38.40155945419103,61.59844054580896,Unisex
MADDLY,1957,3,3,0,100.0,0.0,Female
BADRA,1957,4,4,0,100.0,0.0,Female
MARLAINE,1957,4,4,0,100.0,0.0,Female
GERVAIS,1957,99,0,99,0.0,100.0,Male
JESUS,1957,18,0,18,0.0,100.0,Male
TIMOLEON,1957,3,0,3,0.0,100.0,Male
JANY,1957,3897,2256,1641,57.89068514241724,42.10931485758276,Unisex
DANNY,1957,3396,610,2786,17.962308598351,82.037691401649,Unisex
ROSARIO,1957,1546,781,765,50.51746442432082,49.48253557567917,Unisex
ANGES,1958,3,3,0,100.0,0.0,Female
MARIE-CHARLES,1958,5,5,0,100.0,0.0,Female
LYSIANNE,1958,14,14,0,100.0,0.0,Female
NINO,1958,4,0,4,0.0,100.0,Male
MOISE,1958,11748,140,11608,1.191692202928158,98.80830779707183,Male
MUSTAPHA,1958,79,0,79,0.0,100.0,Male
SABAS,1958,607,220,387,36.24382207578254,63.75617792421746,Unisex
PASQUALE,1958,585,144,441,24.615384615384617,75.38461538461539,Unisex
DANY,1958,26027,7836,18191,30.10719637299728,69.89280362700273,Unisex
HAFSA,1959,3,3,0,100.0,0.0,Female
GISELA,1959,4,4,0,100.0,0.0,Female
JOELE,1959,23,23,0,100.0,0.0,Female
YVES-MARIE,1959,43,0,43,0.0,100.0,Male
CRISTOBAL,1959,4,0,4,0.0,100.0,Male
OMER,1959,38,0,38,0.0,100.0,Male
_PRENOMS_RARES,1959,1760252,908578,851674,51.616359475802334,48.38364052419767,Unisex
JANNY,1959,1044,617,427,59.099616858237546,40.90038314176245,Unisex
DANY,1959,26027,7836,18191,30.10719637299728,69.89280362700273,Unisex
THERESA,1960,30,30,0,100.0,0.0,Female
GAËLLE,1960,7,7,0,100.0,0.0,Female
SOAZIG,1960,3,3,0,100.0,0.0,Female
JOHAN,1960,16,0,16,0.0,100.0,Male
CHARLES,1960,1158,0,1158,0.0,100.0,Male
NORDI,1960,3,0,3,0.0,100.0,Male
CLAUDY,1960,2240,835,1405,37.27678571428572,62.72321428571429,Unisex
DANY,1960,26027,7836,18191,30.10719637299728,69.89280362700273,Unisex
DOMINIQUE,1960,409989,168027,241962,40.98329467375954,59.01670532624046,Unisex
APOLLINE,1961,3,3,0,100.0,0.0,Female
HALIMA,1961,31,31,0,100.0,0.0,Female
ASSIA,1961,6,6,0,100.0,0.0,Female
MARIANO,1961,29,0,29,0.0,100.0,Male
MARCELIN,1961,16,0,16,0.0,100.0,Male
JEAN-RAPHAËL,1961,4,0,4,0.0,100.0,Male
JANNY,1961,1044,617,427,59.099616858237546,40.90038314176245,Unisex
PASQUALE,1961,585,144,441,24.615384615384617,75.38461538461539,Unisex
JEANICK,1961,322,126,196,39.130434782608695,60.86956521739131,Unisex
CAROLLE,1962,24,24,0,100.0,0.0,Female
RHONDA,1962,5,5,0,100.0,0.0,Female
NOËLLA,1962,4,4,0,100.0,0.0,Female
FERID,1962,5,0,5,0.0,100.0,Male
CYRIL,1962,119,0,119,0.0,100.0,Male
ROMUALD,1962,54,0,54,0.0,100.0,Male
GEORGE,1962,2417,650,1767,26.89284236657013,73.10715763342988,Unisex
YANICK,1962,3028,482,2546,15.918097754293262,84.08190224570674,Unisex
TIBURCE,1962,1019,212,807,20.80471050049068,79.19528949950933,Unisex
HAYETTE,1963,10,10,0,100.0,0.0,Female
ELEONORA,1963,6,6,0,100.0,0.0,Female
NICOLINA,1963,3,3,0,100.0,0.0,Female
REINOLD,1963,3,0,3,0.0,100.0,Male
IGNAZIO,1963,8,0,8,0.0,100.0,Male
TODD,1963,4,0,4,0.0,100.0,Male
JANNY,1963,1044,617,427,59.099616858237546,40.90038314176245,Unisex
JANY,1963,3897,2256,1641,57.89068514241724,42.10931485758276,Unisex
JOSY,1963,1021,840,181,82.27228207639568,17.72771792360431,Unisex
GWENDOLINE,1964,6,6,0,100.0,0.0,Female
MÉLINA,1964,10,10,0,100.0,0.0,Female
LYNETTE,1964,3,3,0,100.0,0.0,Female
LYONNEL,1964,5,0,5,0.0,100.0,Male
YVAN,1964,460,0,460,0.0,100.0,Male
KARL,1964,76,0,76,0.0,100.0,Male
MARY,1964,6861,5830,1031,84.97303600058301,15.026963999416996,Unisex
CAMILLE,1964,287709,207732,79977,72.20212089298562,27.79787910701437,Unisex
NAZAIRE,1964,628,97,531,15.445859872611464,84.55414012738854,Unisex
SADIA,1965,59,59,0,100.0,0.0,Female
RAHNIA,1965,5,5,0,100.0,0.0,Female
MARIE-BERNADETTE,1965,42,42,0,100.0,0.0,Female
ALLEN,1965,3,0,3,0.0,100.0,Male
CHOUKRI,1965,4,0,4,0.0,100.0,Male
DONATIEN,1965,7,0,7,0.0,100.0,Male
JANNICK,1965,2792,1545,1247,55.336676217765046,44.66332378223496,Unisex
YANNIC,1965,671,104,567,15.499254843517138,84.50074515648286,Unisex
PASQUALE,1965,585,144,441,24.615384615384617,75.38461538461539,Unisex
MARIE-GLADYS,1966,4,4,0,100.0,0.0,Female
PHILOMENE,1966,28,28,0,100.0,0.0,Female
NICOMEDE,1966,4,4,0,100.0,0.0,Female
SAADI,1966,8,0,8,0.0,100.0,Male
HASEN,1966,3,0,3,0.0,100.0,Male
FEDERICO,1966,6,0,6,0.0,100.0,Male
CAROL,1966,3507,2953,554,84.20302252637582,15.79697747362418,Unisex
AMARA,1966,1568,601,967,38.329081632653065,61.670918367346935,Unisex
GABY,1966,4741,2448,2293,51.63467622864375,48.36532377135626,Unisex
JOSIA,1967,9,9,0,100.0,0.0,Female
SUSANA,1967,10,10,0,100.0,0.0,Female
CAPUCINE,1967,3,3,0,100.0,0.0,Female
HACHMI,1967,4,0,4,0.0,100.0,Male
YANNIC,1967,10,0,10,0.0,100.0,Male
NABIL,1967,43,0,43,0.0,100.0,Male
DANNY,1967,3396,610,2786,17.962308598351,82.037691401649,Unisex
ROSARIO,1967,1546,781,765,50.51746442432082,49.48253557567917,Unisex
CLAUDY,1967,2240,835,1405,37.27678571428572,62.72321428571429,Unisex
BARBARA,1968,543,543,0,100.0,0.0,Female
KHADRA,1968,6,6,0,100.0,0.0,Female
TATIANA,1968,16,16,0,100.0,0.0,Female
GRAZIANO,1968,4,0,4,0.0,100.0,Male
BRUCE,1968,26,0,26,0.0,100.0,Male
RONALD,1968,56,0,56,0.0,100.0,Male
ADDA,1968,397,209,188,52.64483627204031,47.3551637279597,Unisex
YANICK,1968,3028,482,2546,15.918097754293262,84.08190224570674,Unisex
CLAUDY,1968,2240,835,1405,37.27678571428572,62.72321428571429,Unisex
TESSADIT,1969,4,4,0,100.0,0.0,Female
FOUZYA,1969,3,3,0,100.0,0.0,Female
CHRISTINA,1969,146,146,0,100.0,0.0,Female
HILARIO,1969,8,0,8,0.0,100.0,Male
ANIS,1969,4,0,4,0.0,100.0,Male
YANNECK,1969,4,0,4,0.0,100.0,Male
KIM,1969,6518,5270,1248,80.85302239950906,19.146977600490946,Unisex
ARIEL,1969,2401,428,1973,17.8259058725531,82.17409412744689,Unisex
HAMIDA,1969,759,628,131,82.74044795783925,17.25955204216074,Unisex
ALBANNE,1970,4,4,0,100.0,0.0,Female
ROSINE,1970,45,45,0,100.0,0.0,Female
MARIBEL,1970,16,16,0,100.0,0.0,Female
GUIDO,1970,9,0,9,0.0,100.0,Male
NASSER,1970,131,0,131,0.0,100.0,Male
GUENOLE,1970,11,0,11,0.0,100.0,Male
GWENN,1970,1848,1201,647,64.98917748917748,35.01082251082251,Unisex
YANNE,1970,420,204,216,48.57142857142857,51.42857142857142,Unisex
JEANICK,1970,322,126,196,39.130434782608695,60.86956521739131,Unisex
LUCE,1971,16,16,0,100.0,0.0,Female
ANA,1971,300,300,0,100.0,0.0,Female
NATALINA,1971,5,5,0,100.0,0.0,Female
JEAN-LUC,1971,1878,0,1878,0.0,100.0,Male
JOANN,1971,5,0,5,0.0,100.0,Male
GIANI,1971,8,0,8,0.0,100.0,Male
DANY,1971,26027,7836,18191,30.10719637299728,69.89280362700273,Unisex
YAËL,1971,3502,1564,1938,44.66019417475729,55.33980582524271,Unisex
JANY,1971,3897,2256,1641,57.89068514241724,42.10931485758276,Unisex
ANNABEL,1972,187,187,0,100.0,0.0,Female
LIZA,1972,19,19,0,100.0,0.0,Female
LETIZIA,1972,7,7,0,100.0,0.0,Female
TAIEB,1972,9,0,9,0.0,100.0,Male
LYONEL,1972,26,0,26,0.0,100.0,Male
ALESSANDRO,1972,11,0,11,0.0,100.0,Male
CHRISTY,1972,584,396,188,67.8082191780822,32.19178082191781,Unisex
ADDA,1972,397,209,188,52.64483627204031,47.3551637279597,Unisex
_PRENOMS_RARES,1972,1760252,908578,851674,51.616359475802334,48.38364052419767,Unisex
PRUDENCE,1973,4,4,0,100.0,0.0,Female
HAYET,1973,17,17,0,100.0,0.0,Female
TANYA,1973,8,8,0,100.0,0.0,Female
SULLY,1973,29,0,29,0.0,100.0,Male
SIDNEY,1973,12,0,12,0.0,100.0,Male
BRETT,1973,3,0,3,0.0,100.0,Male
MALLORY,1973,2883,2151,732,74.60978147762746,25.390218522372525,Unisex
DANY,1973,26027,7836,18191,30.10719637299728,69.89280362700273,Unisex
JANY,1973,3897,2256,1641,57.89068514241724,42.10931485758276,Unisex
VERONICA,1974,25,25,0,100.0,0.0,Female
ALISA,1974,3,3,0,100.0,0.0,Female
GUILAINE,1974,54,54,0,100.0,0.0,Female
LILIAN,1974,262,0,262,0.0,100.0,Male
GABRIEL,1974,366,0,366,0.0,100.0,Male
EMERIC,1974,125,0,125,0.0,100.0,Male
ADAMA,1974,3805,1078,2727,28.3311432325887,71.6688567674113,Unisex
CAMILLE,1974,287709,207732,79977,72.20212089298562,27.79787910701437,Unisex
MALLORY,1974,2883,2151,732,74.60978147762746,25.390218522372525,Unisex
NASSEIRA,1975,3,3,0,100.0,0.0,Female
ANTOINETTE,1975,57,57,0,100.0,0.0,Female
MIRIANA,1975,4,4,0,100.0,0.0,Female
ABDOULAYE,1975,11,0,11,0.0,100.0,Male
AFIF,1975,10,0,10,0.0,100.0,Male
ASSANE,1975,3,0,3,0.0,100.0,Male
AMARA,1975,1568,601,967,38.329081632653065,61.670918367346935,Unisex
YOHANNE,1975,172,53,119,30.813953488372093,69.18604651162791,Unisex
JEANNICK,1975,2091,1305,786,62.4103299856528,37.589670014347206,Unisex
SEHAM,1976,5,5,0,100.0,0.0,Female
MARIE-GABRIELLE,1976,26,26,0,100.0,0.0,Female
MAURINE,1976,7,7,0,100.0,0.0,Female
GAEL,1976,28304,675,27629,2.384821933295647,97.61517806670436,Male
JEANICK,1976,4,0,4,0.0,100.0,Male
JOAQUIM,1976,87,0,87,0.0,100.0,Male
JESSY,1976,17091,3993,13098,23.363173600140424,76.63682639985957,Unisex
KRISTEN,1976,939,532,407,56.656017039403615,43.34398296059638,Unisex
KIM,1976,6518,5270,1248,80.85302239950906,19.146977600490946,Unisex
MARIE-DELPHINE,1977,10,10,0,100.0,0.0,Female
LAVINIA,1977,4,4,0,100.0,0.0,Female
STERNA,1977,3,3,0,100.0,0.0,Female
RADE,1977,4,0,4,0.0,100.0,Male
RAJ,1977,3,0,3,0.0,100.0,Male
DARIO,1977,21,0,21,0.0,100.0,Male
LENAICK,1977,695,402,293,57.84172661870504,42.15827338129496,Unisex
WISSEM,1977,3049,682,2367,22.36798950475566,77.63201049524434,Unisex
JANNICK,1977,2792,1545,1247,55.336676217765046,44.66332378223496,Unisex
BELLINDA,1978,5,5,0,100.0,0.0,Female
ELVIRA,1978,17,17,0,100.0,0.0,Female
MARIE-ESTELLE,1978,11,11,0,100.0,0.0,Female
HEIDY,1978,4,0,4,0.0,100.0,Male
NASRDINE,1978,3,0,3,0.0,100.0,Male
GUILLERMO,1978,5,0,5,0.0,100.0,Male
JANICK,1978,4109,2203,1906,53.61401800924799,46.38598199075201,Unisex
YAËL,1978,3502,1564,1938,44.66019417475729,55.33980582524271,Unisex
HAMIDA,1978,759,628,131,82.74044795783925,17.25955204216074,Unisex
FILOMENA,1979,7,7,0,100.0,0.0,Female
MARIE-CINDY,1979,5,5,0,100.0,0.0,Female
SALOMÉ,1979,18,18,0,100.0,0.0,Female
JOCELYN,1979,195,0,195,0.0,100.0,Male
ABDELOUAHAB,1979,4,0,4,0.0,100.0,Male
TOUFIK,1979,79,0,79,0.0,100.0,Male
AMARA,1979,1568,601,967,38.329081632653065,61.670918367346935,Unisex
DENIZ,1979,1954,675,1279,34.54452405322416,65.45547594677585,Unisex
YANICK,1979,3028,482,2546,15.918097754293262,84.08190224570674,Unisex
LORRIE,1980,4,4,0,100.0,0.0,Female
LAURENNE,1980,7,7,0,100.0,0.0,Female
JAMELA,1980,5,5,0,100.0,0.0,Female
KAO,1980,4,0,4,0.0,100.0,Male
CONSTANT,1980,23,0,23,0.0,100.0,Male
NIELS,1980,3,0,3,0.0,100.0,Male
BAO,1980,294,112,182,38.095238095238095,61.90476190476191,Unisex
YAEL,1980,6161,3036,3125,49.27771465671157,50.72228534328843,Unisex
LY,1980,327,215,112,65.74923547400611,34.25076452599388,Unisex
MARIE-FRANCE,1981,99,99,0,100.0,0.0,Female
EMÉLIE,1981,4,4,0,100.0,0.0,Female
PARISSA,1981,3,3,0,100.0,0.0,Female
KARIME,1981,11,0,11,0.0,100.0,Male
BALIGH,1981,4,0,4,0.0,100.0,Male
DENIS,1981,879,0,879,0.0,100.0,Male
SYDNEY,1981,2101,1236,865,58.829128986197055,41.17087101380295,Unisex
LENAICK,1981,695,402,293,57.84172661870504,42.15827338129496,Unisex
SIDNEY,1981,2484,951,1533,38.28502415458937,61.71497584541063,Unisex
LAURIE-ANNE,1982,7,7,0,100.0,0.0,Female
CHRYSTEL,1982,54,54,0,100.0,0.0,Female
LAILLA,1982,8,8,0,100.0,0.0,Female
GUEWEN,1982,7,0,7,0.0,100.0,Male
FRANCKY,1982,67,0,67,0.0,100.0,Male
CARL,1982,59,0,59,0.0,100.0,Male
ANAËL,1982,1563,505,1058,32.30966090850927,67.69033909149073,Unisex
DOMINIQUE,1982,409989,168027,241962,40.98329467375954,59.01670532624046,Unisex
ANH,1982,394,164,230,41.62436548223351,58.37563451776649,Unisex
DANIA,1983,9,9,0,100.0,0.0,Female
MARIE-LUDIVINE,1983,3,3,0,100.0,0.0,Female
INESS,1983,5,5,0,100.0,0.0,Female
ANDRY,1983,4,0,4,0.0,100.0,Male
OUISSAM,1983,7,0,7,0.0,100.0,Male
SIDALI,1983,3,0,3,0.0,100.0,Male
KIM,1983,6518,5270,1248,80.85302239950906,19.146977600490946,Unisex
CYRIEL,1983,332,116,216,34.93975903614458,65.06024096385542,Unisex
NGOC,1983,641,437,204,68.17472698907956,31.82527301092044,Unisex
LAURIE,1984,29786,29732,54,99.81870677499496,0.1812932250050359,Female
MOUNIA,1984,130,130,0,100.0,0.0,Female
HADJER,1984,3,3,0,100.0,0.0,Female
JAMIL,1984,9,0,9,0.0,100.0,Male
SILVAIN,1984,7,0,7,0.0,100.0,Male
IHEB,1984,3,0,3,0.0,100.0,Male
MALORY,1984,2305,1892,413,82.08242950108459,17.9175704989154,Unisex
JANICK,1984,4109,2203,1906,53.61401800924799,46.38598199075201,Unisex
THANH,1984,630,259,371,41.11111111111111,58.88888888888889,Unisex
SANELA,1985,5,5,0,100.0,0.0,Female
ELINA,1985,30,30,0,100.0,0.0,Female
NOEMIE,1985,941,941,0,100.0,0.0,Female
ESTEBAN,1985,40,0,40,0.0,100.0,Male
TAYFUN,1985,6,0,6,0.0,100.0,Male
EUDES,1985,12,0,12,0.0,100.0,Male
ANAËL,1985,1563,505,1058,32.30966090850927,67.69033909149073,Unisex
SADIO,1985,1523,895,628,58.76559422193039,41.2344057780696,Unisex
AUDRY,1985,293,54,239,18.43003412969283,81.56996587030717,Unisex
OIHIBA,1986,5,5,0,100.0,0.0,Female
BETHSABEE,1986,4,4,0,100.0,0.0,Female
MARIE-JEANNE,1986,14,14,0,100.0,0.0,Female
JEAN-STÉPHANE,1986,3,0,3,0.0,100.0,Male
LORYS,1986,4,0,4,0.0,100.0,Male
PIERRE-THOMAS,1986,5,0,5,0.0,100.0,Male
KANI,1986,311,260,51,83.60128617363344,16.39871382636656,Unisex
DOMINIQUE,1986,409989,168027,241962,40.98329467375954,59.01670532624046,Unisex
DALI,1986,329,84,245,25.53191489361702,74.46808510638297,Unisex
MARIE-ALINE,1987,10,10,0,100.0,0.0,Female
SAVINA,1987,8,8,0,100.0,0.0,Female
ROSELYNE,1987,41,41,0,100.0,0.0,Female
ABDELHAK,1987,17,0,17,0.0,100.0,Male
ABDELILAH,1987,10,0,10,0.0,100.0,Male
MADJID,1987,29,0,29,0.0,100.0,Male
MORGANN,1987,1229,459,770,37.34743694060212,62.65256305939788,Unisex
MALEK,1987,3570,1060,2510,29.69187675070028,70.30812324929971,Unisex
ANH,1987,394,164,230,41.62436548223351,58.37563451776649,Unisex
FATIME,1988,4,4,0,100.0,0.0,Female
BENOITE,1988,6,6,0,100.0,0.0,Female
MACHA,1988,8,8,0,100.0,0.0,Female
LOUIS-MARIE,1988,48,0,48,0.0,100.0,Male
RICCARDO,1988,4,0,4,0.0,100.0,Male
GHANI,1988,3,0,3,0.0,100.0,Male
MELAINE,1988,1656,1288,368,77.77777777777779,22.22222222222222,Unisex
JANY,1988,3897,2256,1641,57.89068514241724,42.10931485758276,Unisex
MORGANN,1988,1229,459,770,37.34743694060212,62.65256305939788,Unisex
NOUHAD,1989,3,3,0,100.0,0.0,Female
MARIE-VICTOIRE,1989,6,6,0,100.0,0.0,Female
AMALIA,1989,16,16,0,100.0,0.0,Female
LILIAN,1989,165,0,165,0.0,100.0,Male
MASSIMO,1989,14,0,14,0.0,100.0,Male
MOULAY,1989,14,0,14,0.0,100.0,Male
DEVY,1989,290,45,245,15.517241379310343,84.48275862068965,Unisex
ORPHEE,1989,466,267,199,57.2961373390558,42.70386266094421,Unisex
YAEL,1989,6161,3036,3125,49.27771465671157,50.72228534328843,Unisex
AMI,1990,5,5,0,100.0,0.0,Female
DANAÉ,1990,3,3,0,100.0,0.0,Female
JENNIFER,1990,3519,3519,0,100.0,0.0,Female
MILOS,1990,8,0,8,0.0,100.0,Male
ABDEL-KADER,1990,5,0,5,0.0,100.0,Male
SHADY,1990,3,0,3,0.0,100.0,Male
GWEN,1990,941,419,522,44.52709883103082,55.47290116896918,Unisex
TENNESSEE,1990,361,232,129,64.26592797783933,35.73407202216066,Unisex
LORI,1990,430,327,103,76.04651162790698,23.953488372093023,Unisex
CAMILA,1991,14,14,0,100.0,0.0,Female
DJEMILA,1991,16,16,0,100.0,0.0,Female
LAURENA,1991,28,28,0,100.0,0.0,Female
AMIN,1991,69,0,69,0.0,100.0,Male
FAWZI,1991,6,0,6,0.0,100.0,Male
EDERN,1991,6,0,6,0.0,100.0,Male
LOÏS,1991,11236,3416,7820,30.40227839088644,69.59772160911356,Unisex
WISSAM,1991,2491,451,2040,18.105178643115213,81.89482135688479,Unisex
NICKY,1991,573,134,439,23.38568935427574,76.61431064572426,Unisex
EULALIE,1992,30,30,0,100.0,0.0,Female
FLORENE,1992,5,5,0,100.0,0.0,Female
SITA,1992,266,243,23,91.35338345864662,8.646616541353383,Female
CAMILE,1992,3,0,3,0.0,100.0,Male
BILLALE,1992,3,0,3,0.0,100.0,Male
LASSANA,1992,29,0,29,0.0,100.0,Male
MALORY,1992,2305,1892,413,82.08242950108459,17.9175704989154,Unisex
MORGANN,1992,1229,459,770,37.34743694060212,62.65256305939788,Unisex
NICKY,1992,573,134,439,23.38568935427574,76.61431064572426,Unisex
ODELIE,1993,3,3,0,100.0,0.0,Female
CHRISTÈLE,1993,8,8,0,100.0,0.0,Female
DIANA,1993,172,172,0,100.0,0.0,Female
LAMBERT,1993,44,0,44,0.0,100.0,Male
STEPHEN,1993,157,0,157,0.0,100.0,Male
PIERRE-LUC,1993,30,0,30,0.0,100.0,Male
SASCHA,1993,525,132,393,25.142857142857142,74.85714285714286,Unisex
CLARENCE,1993,2943,924,2019,31.39653414882773,68.60346585117227,Unisex
CLAUDY,1993,2240,835,1405,37.27678571428572,62.72321428571429,Unisex
FÉLICIE,1994,6,6,0,100.0,0.0,Female
ISLAH,1994,3,3,0,100.0,0.0,Female
SABRIA,1994,7,7,0,100.0,0.0,Female
MOÏSE,1994,3,0,3,0.0,100.0,Male
DYLLAN,1994,6,0,6,0.0,100.0,Male
ELIEL,1994,5,0,5,0.0,100.0,Male
KEZIAH,1994,1699,467,1232,27.48675691583284,72.51324308416716,Unisex
KIM,1994,6518,5270,1248,80.85302239950906,19.146977600490946,Unisex
MALLORY,1994,2883,2151,732,74.60978147762746,25.390218522372525,Unisex
KADIDJA,1995,5,5,0,100.0,0.0,Female
NOÉMIE,1995,304,304,0,100.0,0.0,Female
MARIE-THÉRÈSE,1995,10,10,0,100.0,0.0,Female
ZIED,1995,7,0,7,0.0,100.0,Male
JACQUES-ANTOINE,1995,5,0,5,0.0,100.0,Male
RONALDO,1995,4,0,4,0.0,100.0,Male
MEDINE,1995,1343,634,709,47.20774385703649,52.79225614296351,Unisex
MINH,1995,738,185,553,25.067750677506773,74.93224932249322,Unisex
JASMIN,1995,917,170,747,18.538713195201744,81.46128680479825,Unisex
ANNIKA,1996,3,3,0,100.0,0.0,Female
OUIJDANE,1996,4,4,0,100.0,0.0,Female
HOLLY,1996,5,5,0,100.0,0.0,Female
CORANTHIN,1996,3,0,3,0.0,100.0,Male
YONI,1996,47,0,47,0.0,100.0,Male
CEDRICK,1996,16,0,16,0.0,100.0,Male
LOGANE,1996,619,495,124,79.96768982229402,20.032310177705977,Unisex
KAREL,1996,1060,233,827,21.9811320754717,78.01886792452831,Unisex
MAELIG,1996,554,238,316,42.96028880866426,57.03971119133574,Unisex
AMAZONE,1997,4,4,0,100.0,0.0,Female
SÉFORA,1997,3,3,0,100.0,0.0,Female
DELPHINE,1997,599,599,0,100.0,0.0,Female
KEATON,1997,4,0,4,0.0,100.0,Male
JEAN-PATRICK,1997,6,0,6,0.0,100.0,Male
WLADIMIR,1997,8,0,8,0.0,100.0,Male
MADY,1997,2286,1197,1089,52.362204724409445,47.63779527559055,Unisex
GWENN,1997,1848,1201,647,64.98917748917748,35.01082251082251,Unisex
AXELL,1997,165,71,94,43.03030303030303,56.96969696969697,Unisex
FANNY,1998,1550,1550,0,100.0,0.0,Female
BRITANY,1998,16,16,0,100.0,0.0,Female
STEFI,1998,3,3,0,100.0,0.0,Female
VALENTYN,1998,5,0,5,0.0,100.0,Male
MELEN,1998,3,0,3,0.0,100.0,Male
BERAT,1998,9,0,9,0.0,100.0,Male
ADJI,1998,164,124,40,75.60975609756098,24.390243902439025,Unisex
ANAEL,1998,2957,1241,1716,41.96821102468719,58.031788975312814,Unisex
SUNNY,1998,823,128,695,15.552855407047389,84.44714459295261,Unisex
ORIANNE,1999,61,61,0,100.0,0.0,Female
ELDA,1999,4,4,0,100.0,0.0,Female
SHEREEN,1999,10,10,0,100.0,0.0,Female
DIVIN,1999,4,0,4,0.0,100.0,Male
ROBBY,1999,14,0,14,0.0,100.0,Male
RAMI,1999,27,0,27,0.0,100.0,Male
DANY,1999,26027,7836,18191,30.10719637299728,69.89280362700273,Unisex
CHAMS,1999,444,209,235,47.07207207207208,52.92792792792793,Unisex
SASCHA,1999,525,132,393,25.142857142857142,74.85714285714286,Unisex
AUDELINE,2000,9,9,0,100.0,0.0,Female
CATHIA,2000,11,11,0,100.0,0.0,Female
YLONA,2000,30,30,0,100.0,0.0,Female
AYKUT,2000,8,0,8,0.0,100.0,Male
OGUZ,2000,10,0,10,0.0,100.0,Male
CHUN,2000,3,0,3,0.0,100.0,Male
DIALLA,2000,209,150,59,71.77033492822966,28.22966507177033,Unisex
MOANA,2000,1034,769,265,74.37137330754352,25.62862669245648,Unisex
KILLIANE,2000,171,71,100,41.52046783625731,58.47953216374269,Unisex
GLWADYS,2001,11,11,0,100.0,0.0,Female
HULYA,2001,11,11,0,100.0,0.0,Female
CHANA,2001,22,22,0,100.0,0.0,Female
SOUAREBA,2001,8,0,8,0.0,100.0,Male
YAO,2001,3,0,3,0.0,100.0,Male
TARKAN,2001,3,0,3,0.0,100.0,Male
ALIX,2001,37305,28371,8934,76.05146763168477,23.94853236831524,Unisex
ANAEL,2001,2957,1241,1716,41.96821102468719,58.031788975312814,Unisex
LOGANE,2001,619,495,124,79.96768982229402,20.032310177705977,Unisex
STESSIE,2002,15,15,0,100.0,0.0,Female
CANDY,2002,21,21,0,100.0,0.0,Female
AINES,2002,8,8,0,100.0,0.0,Female
SEYDOU,2002,20,0,20,0.0,100.0,Male
EMILIANO,2002,9,0,9,0.0,100.0,Male
ABDENNOUR,2002,7,0,7,0.0,100.0,Male
GABRIELE,2002,993,563,430,56.6968781470292,43.3031218529708,Unisex
NIKITA,2002,1692,1106,586,65.36643026004728,34.63356973995272,Unisex
DJODY,2002,131,85,46,64.8854961832061,35.11450381679389,Unisex
LEAH,2003,44,44,0,100.0,0.0,Female
SELIN,2003,76,76,0,100.0,0.0,Female
EMMANUELLE,2003,221,221,0,100.0,0.0,Female
NEZAR,2003,7,0,7,0.0,100.0,Male
SZYMON,2003,4,0,4,0.0,100.0,Male
TÉO,2003,464,0,464,0.0,100.0,Male
CYAN,2003,141,45,96,31.91489361702128,68.08510638297872,Unisex
LORI,2003,430,327,103,76.04651162790698,23.953488372093023,Unisex
ADAMA,2003,3805,1078,2727,28.3311432325887,71.6688567674113,Unisex
JOELINE,2004,5,5,0,100.0,0.0,Female
MAELLANE,2004,5,5,0,100.0,0.0,Female
NILAY,2004,9,9,0,100.0,0.0,Female
MEIR,2004,10,0,10,0.0,100.0,Male
MASSIRE,2004,5,0,5,0.0,100.0,Male
SHAI,2004,20,0,20,0.0,100.0,Male
JOHANY,2004,273,57,216,20.87912087912088,79.12087912087912,Unisex
GWEN,2004,941,419,522,44.52709883103082,55.47290116896918,Unisex
LY,2004,327,215,112,65.74923547400611,34.25076452599388,Unisex
ANNE-LAURE,2005,79,79,0,100.0,0.0,Female
NOURYA,2005,4,4,0,100.0,0.0,Female
GILDA,2005,6,6,0,100.0,0.0,Female
MEROUANE,2005,23,0,23,0.0,100.0,Male
GAIAN,2005,3,0,3,0.0,100.0,Male
ESTEVAN,2005,33,0,33,0.0,100.0,Male
DANY,2005,26027,7836,18191,30.10719637299728,69.89280362700273,Unisex
JANIS,2005,1364,884,480,64.80938416422288,35.19061583577713,Unisex
MEWENN,2005,281,96,185,34.16370106761566,65.83629893238434,Unisex
ASHLEY,2006,5559,5281,278,94.99910055765426,5.000899442345745,Female
KEYNA,2006,14,14,0,100.0,0.0,Female
MAIA,2006,437,437,0,100.0,0.0,Female
JAWED,2006,65,0,65,0.0,100.0,Male
SAJAD,2006,3,0,3,0.0,100.0,Male
BALAMINE,2006,4,0,4,0.0,100.0,Male
MANOE,2006,581,132,449,22.719449225473323,77.28055077452667,Unisex
SOANE,2006,1340,953,387,71.11940298507463,28.88059701492537,Unisex
TENNESSEE,2006,361,232,129,64.26592797783933,35.73407202216066,Unisex
THAMARA,2007,5,5,0,100.0,0.0,Female
VINCIANE,2007,17,17,0,100.0,0.0,Female
SARAH-LOU,2007,15,15,0,100.0,0.0,Female
ELIAN,2007,99,0,99,0.0,100.0,Male
BETSALEL,2007,4,0,4,0.0,100.0,Male
EPHRAM,2007,9,0,9,0.0,100.0,Male
KIM,2007,6518,5270,1248,80.85302239950906,19.146977600490946,Unisex
NESTA,2007,786,234,552,29.77099236641221,70.22900763358778,Unisex
TANIS,2007,113,33,80,29.20353982300885,70.79646017699115,Unisex
HOUDA,2008,58,58,0,100.0,0.0,Female
BERTILLE,2008,185,185,0,100.0,0.0,Female
DJAMILA,2008,25,25,0,100.0,0.0,Female
GIULIAN,2008,28,0,28,0.0,100.0,Male
KEIS,2008,4,0,4,0.0,100.0,Male
ISHAAC,2008,3,0,3,0.0,100.0,Male
LOANN,2008,4020,941,3079,23.40796019900497,76.59203980099502,Unisex
ISLEM,2008,2699,701,1998,25.972582437939977,74.02741756206002,Unisex
DIYA,2008,260,194,66,74.61538461538461,25.384615384615383,Unisex
AMBER,2009,17,17,0,100.0,0.0,Female
DARINE,2009,32,32,0,100.0,0.0,Female
DOINA,2009,3,3,0,100.0,0.0,Female
SAIF,2009,13,0,13,0.0,100.0,Male
HIPPOLYTE,2009,234,0,234,0.0,100.0,Male
ZYAD,2009,79,0,79,0.0,100.0,Male
JASMIN,2009,917,170,747,18.538713195201744,81.46128680479825,Unisex
RAFAELE,2009,320,265,55,82.8125,17.1875,Unisex
MANOA,2009,2510,554,1956,22.07171314741036,77.92828685258965,Unisex
SAOUSSANE,2010,6,6,0,100.0,0.0,Female
LÉNAÏG,2010,7,7,0,100.0,0.0,Female
ALYSON,2010,84,84,0,100.0,0.0,Female
AYHAM,2010,9,0,9,0.0,100.0,Male
LYLIO,2010,9,0,9,0.0,100.0,Male
SINAN,2010,31,0,31,0.0,100.0,Male
MEL,2010,553,129,424,23.32730560578662,76.67269439421338,Unisex
SHANE,2010,479,136,343,28.39248434237996,71.60751565762004,Unisex
SOLANE,2010,370,234,136,63.24324324324324,36.75675675675676,Unisex
KEYLANA,2011,3,3,0,100.0,0.0,Female
HOUSNA,2011,3,3,0,100.0,0.0,Female
WILLIANA,2011,10,10,0,100.0,0.0,Female
ILEL,2011,4,0,4,0.0,100.0,Male
NADEM,2011,3,0,3,0.0,100.0,Male
KERWAN,2011,13,0,13,0.0,100.0,Male
MEL,2011,553,129,424,23.32730560578662,76.67269439421338,Unisex
WARIS,2011,133,41,92,30.82706766917293,69.17293233082707,Unisex
ANAEL,2011,2957,1241,1716,41.96821102468719,58.031788975312814,Unisex
LUCIANNE,2012,3,3,0,100.0,0.0,Female
YUI,2012,4,4,0,100.0,0.0,Female
AMBRYNE,2012,7,7,0,100.0,0.0,Female
ELIYAS,2012,7,0,7,0.0,100.0,Male
CHEIKH,2012,45,0,45,0.0,100.0,Male
AMELIEN,2012,4,0,4,0.0,100.0,Male
MEDINE,2012,1343,634,709,47.20774385703649,52.79225614296351,Unisex
SWANNY,2012,534,310,224,58.05243445692884,41.94756554307117,Unisex
KINANE,2012,270,52,218,19.25925925925926,80.74074074074075,Unisex
PETRA,2013,6,6,0,100.0,0.0,Female
ZALIA,2013,3,3,0,100.0,0.0,Female
UHAÏNA,2013,3,3,0,100.0,0.0,Female
BABACAR,2013,23,0,23,0.0,100.0,Male
JULEN,2013,40,0,40,0.0,100.0,Male
NEYMAR,2013,11,0,11,0.0,100.0,Male
CYANN,2013,327,277,50,84.70948012232415,15.29051987767584,Unisex
SLOANN,2013,233,40,193,17.167381974248926,82.83261802575107,Unisex
ANDREA,2013,7488,1918,5570,25.61431623931624,74.38568376068376,Unisex
AMBER,2014,40,40,0,100.0,0.0,Female
ATHÉNA,2014,56,56,0,100.0,0.0,Female
MARILYN,2014,12,12,0,100.0,0.0,Female
ALBAN,2014,538,0,538,0.0,100.0,Male
ILHANN,2014,5,0,5,0.0,100.0,Male
NAHEL,2014,4125,96,4029,2.327272727272727,97.67272727272729,Male
LIOR,2014,1001,172,829,17.182817182817185,82.81718281718283,Unisex
CEYLAN,2014,353,234,119,66.28895184135978,33.711048158640224,Unisex
JOÉ,2014,358,75,283,20.949720670391063,79.05027932960894,Unisex
SHANELL,2015,3,3,0,100.0,0.0,Female
NADIRA,2015,3,3,0,100.0,0.0,Female
VITA,2015,3,3,0,100.0,0.0,Female
LUIDJI,2015,7,0,7,0.0,100.0,Male
WILHEM,2015,11,0,11,0.0,100.0,Male
LEONARDO,2015,69,0,69,0.0,100.0,Male
ORPHÉE,2015,293,121,172,41.29692832764505,58.70307167235495,Unisex
ISLAM,2015,1463,253,1210,17.293233082706767,82.70676691729322,Unisex
JAËL,2015,294,138,156,46.93877551020408,53.06122448979592,Unisex
YÛNA,2016,5,5,0,100.0,0.0,Female
NURIA,2016,9,9,0,100.0,0.0,Female
KASSANDRA,2016,50,50,0,100.0,0.0,Female
MANAËL,2016,22,0,22,0.0,100.0,Male
DERMAN,2016,3,0,3,0.0,100.0,Male
LUIGI,2016,31,0,31,0.0,100.0,Male
MINH,2016,738,185,553,25.067750677506773,74.93224932249322,Unisex
DESTINY,2016,424,211,213,49.764150943396224,50.235849056603776,Unisex
KALYS,2016,212,73,139,34.43396226415094,65.56603773584906,Unisex
DOHA,2017,16,16,0,100.0,0.0,Female
KHADIDJA,2017,91,91,0,100.0,0.0,Female
MAYLINA,2017,10,10,0,100.0,0.0,Female
MEDHI,2017,11,0,11,0.0,100.0,Male
OTTO,2017,5,0,5,0.0,100.0,Male
KAELIG,2017,3,0,3,0.0,100.0,Male
LYSSANDRE,2017,574,157,417,27.35191637630662,72.64808362369338,Unisex
ANAEL,2017,2957,1241,1716,41.96821102468719,58.031788975312814,Unisex
BÉRYL,2017,444,367,77,82.65765765765765,17.34234234234234,Unisex
LIVIANA,2018,3,3,0,100.0,0.0,Female
JYHANE,2018,3,3,0,100.0,0.0,Female
ZABIBOU,2018,3,3,0,100.0,0.0,Female
ZAHIM,2018,4,0,4,0.0,100.0,Male
TAMATOA,2018,3,0,3,0.0,100.0,Male
MAHAMAT,2018,4,0,4,0.0,100.0,Male
JAËL,2018,294,138,156,46.93877551020408,53.06122448979592,Unisex
JOHANE,2018,818,633,185,77.3838630806846,22.6161369193154,Unisex
MINH,2018,738,185,553,25.067750677506773,74.93224932249322,Unisex
ALANNAH,2019,9,9,0,100.0,0.0,Female
SORIYA,2019,4,4,0,100.0,0.0,Female
NOHEMIE,2019,3,3,0,100.0,0.0,Female
ILYANE,2019,1015,51,964,5.024630541871921,94.97536945812809,Male
DJAMY,2019,3,0,3,0.0,100.0,Male
KEÏLAN,2019,21,0,21,0.0,100.0,Male
ELIYAH,2019,431,358,73,83.06264501160094,16.937354988399072,Unisex
JAYMIE,2019,109,35,74,32.11009174311927,67.88990825688074,Unisex
WINNER,2019,261,57,204,21.83908045977012,78.16091954022988,Unisex
NAÏKA,2020,5,5,0,100.0,0.0,Female
WIKTORIA,2020,3,3,0,100.0,0.0,Female
SIBYLE,2020,10,10,0,100.0,0.0,Female
SOILIHI,2020,4,0,4,0.0,100.0,Male
KEHAN,2020,3,0,3,0.0,100.0,Male
AYSSAR,2020,3,0,3,0.0,100.0,Male
ÉDEN,2020,2423,529,1894,21.83243912505159,78.16756087494842,Unisex
JAZZ,2020,597,400,197,67.00167504187606,32.99832495812395,Unisex
EZEL,2020,520,144,376,27.692307692307693,72.3076923076923,Unisex
MAYSSAM,2021,15,15,0,100.0,0.0,Female
THIA,2021,8,8,0,100.0,0.0,Female
KÉLYSSA,2021,3,3,0,100.0,0.0,Female
RAYANI,2021,4,0,4,0.0,100.0,Male
RASLEN,2021,10,0,10,0.0,100.0,Male
SOHÄN,2021,7,0,7,0.0,100.0,Male
YAKINE,2021,610,342,268,56.0655737704918,43.9344262295082,Unisex
JAËL,2021,294,138,156,46.93877551020408,53.06122448979592,Unisex
SHAY,2021,194,34,160,17.525773195876287,82.4742268041237,Unisex
LÉANNAH,2022,4,4,0,100.0,0.0,Female
ABIGAHEL,2022,9,9,0,100.0,0.0,Female
KATHALYNA,2022,6,6,0,100.0,0.0,Female
WARYS,2022,3,0,3,0.0,100.0,Male
SOULEÏMAN,2022,4,0,4,0.0,100.0,Male
ELYZIO,2022,10,0,10,0.0,100.0,Male
AIKO,2022,183,130,53,71.03825136612022,28.96174863387978,Unisex
ILIANE,2022,869,168,701,19.332566168009205,80.66743383199079,Unisex
JAYMIE,2022,109,35,74,32.11009174311927,67.88990825688074,Unisex
