Name,Year,Total_sum,Female_count,Male_count,Female_percentage,Male_percentage,Gender
Freida,1914,122,122,0,100.0,0.0,Female
Deana,1914,5,5,0,100.0,0.0,Female
Notie,1914,5,5,0,100.0,0.0,Female
Adaline,1914,67,67,0,100.0,0.0,Female
Odean,1914,9,9,0,100.0,0.0,Female
Melvia,1914,8,8,0,100.0,0.0,Female
Maria,1914,1125,1117,8,99.28888888888888,0.7111111111111111,Female
Ailene,1914,19,19,0,100.0,0.0,Female
Helma,1914,18,18,0,100.0,0.0,Female
Georgiana,1914,98,98,0,100.0,0.0,Female
Blondie,1914,5,5,0,100.0,0.0,Female
Rosalie,1914,584,584,0,100.0,0.0,Female
Zella,1914,224,224,0,100.0,0.0,Female
Anastacia,1914,7,7,0,100.0,0.0,Female
Arleen,1914,44,44,0,100.0,0.0,Female
Hildred,1914,68,58,10,85.29411764705883,14.705882352941178,Female
Alicia,1914,54,54,0,100.0,0.0,Female
Arleta,1914,11,11,0,100.0,0.0,Female
Eunice,1914,1499,1478,21,98.59906604402934,1.400933955970647,Female
Arena,1914,7,7,0,100.0,0.0,Female
Nella,1914,44,44,0,100.0,0.0,Female
Elzora,1914,13,13,0,100.0,0.0,Female
Catalina,1914,25,25,0,100.0,0.0,Female
Corina,1914,17,17,0,100.0,0.0,Female
Lounette,1914,7,7,0,100.0,0.0,Female
Sydelle,1914,16,16,0,100.0,0.0,Female
Bama,1914,5,5,0,100.0,0.0,Female
Arzelia,1914,5,5,0,100.0,0.0,Female
Alvira,1914,23,23,0,100.0,0.0,Female
Novelle,1914,6,6,0,100.0,0.0,Female
Terence,1914,19,0,19,0.0,100.0,Male
Madison,1914,56,0,56,0.0,100.0,Male
Eino,1914,50,0,50,0.0,100.0,Male
Blanchard,1914,7,0,7,0.0,100.0,Male
Wallis,1914,15,0,15,0.0,100.0,Male
Rowe,1914,6,0,6,0.0,100.0,Male
Troy,1914,315,8,307,2.5396825396825395,97.46031746031746,Male
Eulalio,1914,8,0,8,0.0,100.0,Male
Martin,1914,1690,14,1676,0.8284023668639053,99.1715976331361,Male
Phares,1914,9,0,9,0.0,100.0,Male
Vance,1914,140,6,134,4.285714285714286,95.71428571428572,Male
Crockett,1914,6,0,6,0.0,100.0,Male
Nevins,1914,5,0,5,0.0,100.0,Male
Elroy,1914,75,0,75,0.0,100.0,Male
Emery,1914,211,0,211,0.0,100.0,Male
Eulis,1914,14,0,14,0.0,100.0,Male
Berkley,1914,18,0,18,0.0,100.0,Male
Claudis,1914,10,0,10,0.0,100.0,Male
Vincent,1914,1969,7,1962,0.3555104113763331,99.64448958862366,Male
Albion,1914,14,0,14,0.0,100.0,Male
Lecil,1914,5,0,5,0.0,100.0,Male
Buren,1914,19,0,19,0.0,100.0,Male
Merrell,1914,11,0,11,0.0,100.0,Male
Florian,1914,66,5,61,7.575757575757576,92.42424242424242,Male
Orvel,1914,25,0,25,0.0,100.0,Male
Emert,1914,5,0,5,0.0,100.0,Male
Fread,1914,7,0,7,0.0,100.0,Male
Domingo,1914,27,0,27,0.0,100.0,Male
Michael,1914,3378,16,3362,0.4736530491415038,99.5263469508585,Male
Gonzalo,1914,12,0,12,0.0,100.0,Male
Ossie,1914,83,59,24,71.08433734939759,28.915662650602407,Unisex
Bethel,1914,107,79,28,73.83177570093457,26.16822429906541,Unisex
Posie,1914,11,6,5,54.54545454545454,45.45454545454545,Unisex
Myrle,1914,89,66,23,74.15730337078652,25.842696629213485,Unisex
Velmer,1914,16,7,9,43.75,56.25,Unisex
Alison,1914,28,22,6,78.57142857142857,21.428571428571427,Unisex
Simmie,1914,18,5,13,27.77777777777778,72.22222222222221,Unisex
Ariel,1914,16,7,9,43.75,56.25,Unisex
Fay,1914,668,566,102,84.73053892215569,15.269461077844312,Unisex
Aurel,1914,14,7,7,50.0,50.0,Unisex
Lannie,1914,26,18,8,69.23076923076923,30.76923076923077,Unisex
Hildreth,1914,33,28,5,84.84848484848484,15.151515151515152,Unisex
Carmen,1914,547,374,173,68.37294332723948,31.62705667276051,Unisex
Oval,1914,22,6,16,27.27272727272727,72.72727272727273,Unisex
Merced,1914,14,5,9,35.714285714285715,64.28571428571429,Unisex
Evon,1914,18,13,5,72.22222222222221,27.77777777777778,Unisex
Dell,1914,54,32,22,59.25925925925925,40.74074074074074,Unisex
Gene,1914,461,109,352,23.644251626898047,76.35574837310195,Unisex
Oley,1914,13,5,8,38.46153846153847,61.53846153846154,Unisex
Bobby,1914,57,21,36,36.84210526315789,63.1578947368421,Unisex
Earlie,1914,54,19,35,35.18518518518518,64.81481481481481,Unisex
Zenith,1914,11,6,5,54.54545454545454,45.45454545454545,Unisex
Oda,1914,34,23,11,67.64705882352942,32.35294117647059,Unisex
Eppie,1914,10,5,5,50.0,50.0,Unisex
Drexel,1914,29,5,24,17.24137931034483,82.75862068965517,Unisex
Afton,1914,60,47,13,78.33333333333333,21.666666666666668,Unisex
Collie,1914,30,7,23,23.33333333333333,76.66666666666667,Unisex
Fidelis,1914,12,7,5,58.333333333333336,41.66666666666667,Unisex
Merril,1914,25,6,19,24.0,76.0,Unisex
Loris,1914,29,18,11,62.06896551724138,37.93103448275862,Unisex
Janie,1915,571,571,0,100.0,0.0,Female
Orphia,1915,5,5,0,100.0,0.0,Female
Talma,1915,5,5,0,100.0,0.0,Female
Illa,1915,44,44,0,100.0,0.0,Female
Indiana,1915,7,7,0,100.0,0.0,Female
Jennette,1915,24,24,0,100.0,0.0,Female
Callista,1915,9,9,0,100.0,0.0,Female
Evaline,1915,38,38,0,100.0,0.0,Female
Sherry,1915,7,7,0,100.0,0.0,Female
Alyne,1915,19,19,0,100.0,0.0,Female
Marijane,1915,9,9,0,100.0,0.0,Female
Alena,1915,18,18,0,100.0,0.0,Female
Azella,1915,5,5,0,100.0,0.0,Female
Erma,1915,1384,1375,9,99.34971098265896,0.6502890173410405,Female
Willena,1915,25,25,0,100.0,0.0,Female
Wilmetta,1915,7,7,0,100.0,0.0,Female
Evie,1915,110,104,6,94.54545454545456,5.454545454545454,Female
Burniece,1915,5,5,0,100.0,0.0,Female
Gretta,1915,31,31,0,100.0,0.0,Female
Lurla,1915,5,5,0,100.0,0.0,Female
Michelina,1915,35,35,0,100.0,0.0,Female
Dolores,1915,1285,1280,5,99.61089494163424,0.3891050583657587,Female
Stephane,1915,7,7,0,100.0,0.0,Female
Janelle,1915,14,14,0,100.0,0.0,Female
Elinora,1915,9,9,0,100.0,0.0,Female
Luada,1915,5,5,0,100.0,0.0,Female
Zilla,1915,9,9,0,100.0,0.0,Female
Lakie,1915,11,11,0,100.0,0.0,Female
Luciana,1915,6,6,0,100.0,0.0,Female
Paula,1915,228,228,0,100.0,0.0,Female
Jimmy,1915,147,11,136,7.482993197278912,92.51700680272108,Male
Tommy,1915,215,22,193,10.232558139534884,89.76744186046511,Male
Alben,1915,5,0,5,0.0,100.0,Male
Morrill,1915,8,0,8,0.0,100.0,Male
Marshal,1915,30,0,30,0.0,100.0,Male
Belton,1915,20,0,20,0.0,100.0,Male
Guillermo,1915,33,0,33,0.0,100.0,Male
Ewart,1915,8,0,8,0.0,100.0,Male
Arthur,1915,8602,38,8564,0.4417577307602883,99.55824226923971,Male
Esequiel,1915,11,0,11,0.0,100.0,Male
Belmont,1915,10,0,10,0.0,100.0,Male
Daley,1915,6,0,6,0.0,100.0,Male
Cuthbert,1915,6,0,6,0.0,100.0,Male
Standley,1915,6,0,6,0.0,100.0,Male
Tunis,1915,14,0,14,0.0,100.0,Male
Demar,1915,9,0,9,0.0,100.0,Male
Jonathan,1915,83,0,83,0.0,100.0,Male
Ottavio,1915,6,0,6,0.0,100.0,Male
Walt,1915,8,0,8,0.0,100.0,Male
Dorrell,1915,8,0,8,0.0,100.0,Male
Justus,1915,26,0,26,0.0,100.0,Male
Winfrey,1915,10,0,10,0.0,100.0,Male
Arley,1915,54,0,54,0.0,100.0,Male
Leanord,1915,14,0,14,0.0,100.0,Male
Lory,1915,5,0,5,0.0,100.0,Male
Holton,1915,6,0,6,0.0,100.0,Male
Darold,1915,18,0,18,0.0,100.0,Male
Woodro,1915,5,0,5,0.0,100.0,Male
Hoyte,1915,7,0,7,0.0,100.0,Male
Edison,1915,81,0,81,0.0,100.0,Male
Daris,1915,12,5,7,41.66666666666667,58.333333333333336,Unisex
Carnell,1915,21,10,11,47.61904761904761,52.38095238095239,Unisex
Camille,1915,205,165,40,80.48780487804879,19.51219512195122,Unisex
Vernie,1915,182,117,65,64.28571428571429,35.714285714285715,Unisex
Renie,1915,12,6,6,50.0,50.0,Unisex
Tonnie,1915,12,5,7,41.66666666666667,58.333333333333336,Unisex
Lennis,1915,21,10,11,47.61904761904761,52.38095238095239,Unisex
Lonie,1915,55,37,18,67.27272727272727,32.72727272727273,Unisex
Loys,1915,21,13,8,61.90476190476191,38.095238095238095,Unisex
Myrl,1915,88,51,37,57.95454545454546,42.04545454545455,Unisex
Arlyn,1915,16,9,7,56.25,43.75,Unisex
Paz,1915,11,6,5,54.54545454545454,45.45454545454545,Unisex
Lavergne,1915,26,21,5,80.76923076923077,19.23076923076924,Unisex
Erie,1915,38,32,6,84.21052631578947,15.789473684210526,Unisex
America,1915,36,30,6,83.33333333333334,16.666666666666664,Unisex
Atlas,1915,15,6,9,40.0,60.0,Unisex
Dee,1915,161,41,120,25.465838509316768,74.53416149068323,Unisex
Silver,1915,16,8,8,50.0,50.0,Unisex
Daryl,1915,36,6,30,16.666666666666664,83.33333333333334,Unisex
Mayo,1915,53,12,41,22.641509433962263,77.35849056603774,Unisex
Carmen,1915,694,483,211,69.59654178674351,30.403458213256485,Unisex
Beryle,1915,18,13,5,72.22222222222221,27.77777777777778,Unisex
Romayne,1915,29,24,5,82.75862068965517,17.24137931034483,Unisex
Ardell,1915,82,55,27,67.07317073170732,32.926829268292686,Unisex
Alva,1915,408,146,262,35.78431372549019,64.2156862745098,Unisex
Murle,1915,19,10,9,52.63157894736842,47.368421052631575,Unisex
Arnell,1915,16,9,7,56.25,43.75,Unisex
Asencion,1915,14,8,6,57.14285714285714,42.85714285714285,Unisex
Aquilla,1915,19,14,5,73.68421052631578,26.31578947368421,Unisex
Gean,1915,17,9,8,52.94117647058824,47.05882352941176,Unisex
Santa,1916,88,88,0,100.0,0.0,Female
Josephina,1916,9,9,0,100.0,0.0,Female
Dalia,1916,9,9,0,100.0,0.0,Female
Marylena,1916,5,5,0,100.0,0.0,Female
Gladis,1916,50,50,0,100.0,0.0,Female
Teodora,1916,11,11,0,100.0,0.0,Female
Arnetta,1916,31,31,0,100.0,0.0,Female
Nerva,1916,6,6,0,100.0,0.0,Female
Rhetta,1916,7,7,0,100.0,0.0,Female
Verda,1916,220,213,7,96.8181818181818,3.1818181818181817,Female
Zelda,1916,258,258,0,100.0,0.0,Female
Mitsuko,1916,16,16,0,100.0,0.0,Female
Alphild,1916,6,6,0,100.0,0.0,Female
Levenia,1916,6,6,0,100.0,0.0,Female
Concettina,1916,12,12,0,100.0,0.0,Female
Donata,1916,9,9,0,100.0,0.0,Female
Casimera,1916,9,9,0,100.0,0.0,Female
Honora,1916,24,24,0,100.0,0.0,Female
Valesta,1916,6,6,0,100.0,0.0,Female
Lourene,1916,10,10,0,100.0,0.0,Female
Adelaine,1916,5,5,0,100.0,0.0,Female
Avelina,1916,6,6,0,100.0,0.0,Female
India,1916,29,29,0,100.0,0.0,Female
Jestine,1916,9,9,0,100.0,0.0,Female
Candis,1916,5,5,0,100.0,0.0,Female
Vinetta,1916,6,6,0,100.0,0.0,Female
Norva,1916,6,6,0,100.0,0.0,Female
Blossie,1916,8,8,0,100.0,0.0,Female
Icie,1916,33,33,0,100.0,0.0,Female
Guila,1916,7,7,0,100.0,0.0,Female
Kenny,1916,10,0,10,0.0,100.0,Male
Orlin,1916,36,0,36,0.0,100.0,Male
Walker,1916,104,0,104,0.0,100.0,Male
Duke,1916,37,0,37,0.0,100.0,Male
Rollan,1916,5,0,5,0.0,100.0,Male
Gregory,1916,144,0,144,0.0,100.0,Male
Ermil,1916,7,0,7,0.0,100.0,Male
Silvester,1916,17,0,17,0.0,100.0,Male
Domenico,1916,34,0,34,0.0,100.0,Male
Orvin,1916,34,0,34,0.0,100.0,Male
Fitzhugh,1916,6,0,6,0.0,100.0,Male
Silven,1916,5,0,5,0.0,100.0,Male
Smith,1916,60,0,60,0.0,100.0,Male
Ellwood,1916,73,0,73,0.0,100.0,Male
Kervin,1916,5,0,5,0.0,100.0,Male
Hugo,1916,200,0,200,0.0,100.0,Male
Boss,1916,5,0,5,0.0,100.0,Male
Bristol,1916,5,0,5,0.0,100.0,Male
Linden,1916,24,0,24,0.0,100.0,Male
Salvador,1916,133,0,133,0.0,100.0,Male
Stonewall,1916,22,0,22,0.0,100.0,Male
Norman,1916,3633,24,3609,0.6606110652353426,99.33938893476466,Male
Benjman,1916,5,0,5,0.0,100.0,Male
Levester,1916,8,0,8,0.0,100.0,Male
Osmond,1916,5,0,5,0.0,100.0,Male
Wayne,1916,1601,14,1587,0.8744534665833853,99.12554653341662,Male
Harwell,1916,7,0,7,0.0,100.0,Male
Ab,1916,8,0,8,0.0,100.0,Male
Cranford,1916,7,0,7,0.0,100.0,Male
Douglass,1916,37,0,37,0.0,100.0,Male
Rosemond,1916,19,14,5,73.68421052631578,26.31578947368421,Unisex
Verl,1916,68,12,56,17.647058823529413,82.35294117647058,Unisex
Elgie,1916,34,14,20,41.17647058823529,58.82352941176471,Unisex
Estle,1916,37,9,28,24.324324324324326,75.67567567567568,Unisex
Ivey,1916,45,17,28,37.77777777777778,62.22222222222222,Unisex
Venice,1916,55,45,10,81.81818181818183,18.181818181818183,Unisex
Pearley,1916,17,10,7,58.82352941176471,41.17647058823529,Unisex
Murrel,1916,29,7,22,24.13793103448276,75.86206896551724,Unisex
Zollie,1916,29,6,23,20.6896551724138,79.3103448275862,Unisex
Wille,1916,11,5,6,45.45454545454545,54.54545454545454,Unisex
Orean,1916,10,5,5,50.0,50.0,Unisex
Bernell,1916,26,8,18,30.76923076923077,69.23076923076923,Unisex
Love,1916,34,19,15,55.88235294117647,44.11764705882353,Unisex
Simone,1916,41,34,7,82.92682926829268,17.073170731707318,Unisex
Laurice,1916,18,12,6,66.66666666666666,33.33333333333333,Unisex
Caryl,1916,61,51,10,83.60655737704919,16.39344262295082,Unisex
Laverne,1916,885,642,243,72.54237288135593,27.45762711864407,Unisex
Fayette,1916,29,14,15,48.27586206896552,51.72413793103448,Unisex
Earlie,1916,66,24,42,36.36363636363637,63.63636363636363,Unisex
Irby,1916,39,6,33,15.384615384615383,84.61538461538461,Unisex
Delma,1916,152,129,23,84.86842105263158,15.13157894736842,Unisex
Lee,1916,2491,475,2016,19.0686471296668,80.9313528703332,Unisex
Cola,1916,23,17,6,73.91304347826086,26.08695652173913,Unisex
Ozzie,1916,22,15,7,68.18181818181817,31.818181818181817,Unisex
Arla,1916,36,30,6,83.33333333333334,16.666666666666664,Unisex
Vester,1916,84,15,69,17.857142857142858,82.14285714285714,Unisex
Ora,1916,1010,857,153,84.85148514851485,15.148514851485148,Unisex
Lonie,1916,53,37,16,69.81132075471697,30.18867924528302,Unisex
Wilmar,1916,23,6,17,26.08695652173913,73.91304347826086,Unisex
Bee,1916,41,23,18,56.09756097560976,43.90243902439025,Unisex
Icy,1917,21,21,0,100.0,0.0,Female
Albie,1917,11,11,0,100.0,0.0,Female
Erma,1917,1436,1436,0,100.0,0.0,Female
Gaynell,1917,67,67,0,100.0,0.0,Female
Mamye,1917,12,12,0,100.0,0.0,Female
Amye,1917,5,5,0,100.0,0.0,Female
Jenny,1917,131,131,0,100.0,0.0,Female
Toshie,1917,10,10,0,100.0,0.0,Female
Helena,1917,440,440,0,100.0,0.0,Female
Aldea,1917,10,10,0,100.0,0.0,Female
Aleta,1917,36,36,0,100.0,0.0,Female
Cleva,1917,17,17,0,100.0,0.0,Female
Estaline,1917,8,8,0,100.0,0.0,Female
Lizzy,1917,5,5,0,100.0,0.0,Female
Aurelia,1917,173,173,0,100.0,0.0,Female
Delvina,1917,6,6,0,100.0,0.0,Female
Micaela,1917,19,19,0,100.0,0.0,Female
Earma,1917,14,14,0,100.0,0.0,Female
Hazle,1917,71,71,0,100.0,0.0,Female
Corinna,1917,12,12,0,100.0,0.0,Female
Lossie,1917,40,40,0,100.0,0.0,Female
Ottelia,1917,5,5,0,100.0,0.0,Female
Marcelline,1917,15,15,0,100.0,0.0,Female
Patty,1917,54,49,5,90.74074074074076,9.25925925925926,Female
Naydene,1917,5,5,0,100.0,0.0,Female
Elmi,1917,5,5,0,100.0,0.0,Female
Salvatrice,1917,15,15,0,100.0,0.0,Female
Carnelia,1917,8,8,0,100.0,0.0,Female
Toyoko,1917,9,9,0,100.0,0.0,Female
Lenamae,1917,5,5,0,100.0,0.0,Female
Wilbert,1917,755,0,755,0.0,100.0,Male
Bright,1917,6,0,6,0.0,100.0,Male
Havis,1917,5,0,5,0.0,100.0,Male
Arnold,1917,1793,12,1781,0.6692693809258227,99.3307306190742,Male
Major,1917,159,0,159,0.0,100.0,Male
Hersey,1917,9,0,9,0.0,100.0,Male
Wallace,1917,1228,13,1215,1.0586319218241045,98.9413680781759,Male
Manny,1917,22,0,22,0.0,100.0,Male
Gregory,1917,158,0,158,0.0,100.0,Male
Baxter,1917,46,0,46,0.0,100.0,Male
Lanson,1917,5,0,5,0.0,100.0,Male
Alvis,1917,96,9,87,9.375,90.625,Male
Dover,1917,10,0,10,0.0,100.0,Male
Hutson,1917,6,0,6,0.0,100.0,Male
Amerigo,1917,29,0,29,0.0,100.0,Male
Pius,1917,10,0,10,0.0,100.0,Male
Irven,1917,24,0,24,0.0,100.0,Male
Alexsander,1917,5,0,5,0.0,100.0,Male
Deloss,1917,10,0,10,0.0,100.0,Male
Mason,1917,114,0,114,0.0,100.0,Male
Hymie,1917,11,0,11,0.0,100.0,Male
Lemon,1917,23,0,23,0.0,100.0,Male
Lane,1917,28,0,28,0.0,100.0,Male
Harley,1917,430,0,430,0.0,100.0,Male
Elden,1917,91,0,91,0.0,100.0,Male
Olden,1917,12,0,12,0.0,100.0,Male
Revis,1917,9,0,9,0.0,100.0,Male
Waldon,1917,13,0,13,0.0,100.0,Male
Garlin,1917,6,0,6,0.0,100.0,Male
Glenden,1917,6,0,6,0.0,100.0,Male
Sakae,1917,14,6,8,42.85714285714285,57.14285714285714,Unisex
Atha,1917,45,36,9,80.0,20.0,Unisex
Jacque,1917,14,6,8,42.85714285714285,57.14285714285714,Unisex
Ollie,1917,1206,911,295,75.53897180762851,24.46102819237148,Unisex
Ivon,1917,11,6,5,54.54545454545454,45.45454545454545,Unisex
Jamie,1917,73,45,28,61.64383561643836,38.35616438356164,Unisex
Glennie,1917,40,34,6,85.0,15.0,Unisex
Eddie,1917,1519,254,1265,16.721527320605663,83.27847267939433,Unisex
Eudell,1917,11,6,5,54.54545454545454,45.45454545454545,Unisex
Byrd,1917,18,7,11,38.88888888888889,61.11111111111112,Unisex
Ardel,1917,11,6,5,54.54545454545454,45.45454545454545,Unisex
Levern,1917,18,6,12,33.33333333333333,66.66666666666666,Unisex
Avon,1917,21,5,16,23.809523809523807,76.19047619047619,Unisex
Lacey,1917,23,8,15,34.78260869565217,65.21739130434783,Unisex
Alpha,1917,230,191,39,83.04347826086956,16.956521739130434,Unisex
Gennie,1917,45,37,8,82.22222222222221,17.77777777777778,Unisex
Rue,1917,27,11,16,40.74074074074074,59.25925925925925,Unisex
Odie,1917,101,47,54,46.53465346534654,53.46534653465347,Unisex
Vestal,1917,19,8,11,42.10526315789473,57.89473684210527,Unisex
Luby,1917,15,8,7,53.333333333333336,46.66666666666666,Unisex
Loy,1917,98,16,82,16.3265306122449,83.6734693877551,Unisex
Samie,1917,18,5,13,27.77777777777778,72.22222222222221,Unisex
Carman,1917,24,7,17,29.166666666666668,70.83333333333334,Unisex
Ellie,1917,105,84,21,80.0,20.0,Unisex
Santos,1917,95,33,62,34.73684210526316,65.26315789473685,Unisex
Lorain,1917,31,15,16,48.38709677419355,51.61290322580645,Unisex
Garnett,1917,136,66,70,48.52941176470589,51.47058823529412,Unisex
Sammy,1917,88,16,72,18.181818181818183,81.81818181818183,Unisex
Brownie,1917,38,17,21,44.73684210526316,55.26315789473685,Unisex
Mannie,1917,42,19,23,45.23809523809524,54.761904761904766,Unisex
Antonette,1918,131,131,0,100.0,0.0,Female
Nettye,1918,7,7,0,100.0,0.0,Female
Margarete,1918,74,74,0,100.0,0.0,Female
Marilla,1918,11,11,0,100.0,0.0,Female
Ninfa,1918,18,18,0,100.0,0.0,Female
Rosea,1918,7,7,0,100.0,0.0,Female
Rosann,1918,9,9,0,100.0,0.0,Female
Melda,1918,39,39,0,100.0,0.0,Female
Mariah,1918,43,43,0,100.0,0.0,Female
Nondas,1918,5,5,0,100.0,0.0,Female
Floride,1918,7,7,0,100.0,0.0,Female
Fifi,1918,6,6,0,100.0,0.0,Female
Geraline,1918,6,6,0,100.0,0.0,Female
Dorthy,1918,412,412,0,100.0,0.0,Female
Sachiko,1918,14,14,0,100.0,0.0,Female
Myrtha,1918,7,7,0,100.0,0.0,Female
Tomasa,1918,42,42,0,100.0,0.0,Female
Thordis,1918,5,5,0,100.0,0.0,Female
Oneta,1918,43,43,0,100.0,0.0,Female
Hattye,1918,5,5,0,100.0,0.0,Female
Jennett,1918,9,9,0,100.0,0.0,Female
Emagene,1918,5,5,0,100.0,0.0,Female
Lynette,1918,31,31,0,100.0,0.0,Female
Bronnie,1918,5,5,0,100.0,0.0,Female
Ricarda,1918,7,7,0,100.0,0.0,Female
Delores,1918,436,436,0,100.0,0.0,Female
Clodean,1918,5,5,0,100.0,0.0,Female
Bethyl,1918,10,10,0,100.0,0.0,Female
Gaynelle,1918,34,34,0,100.0,0.0,Female
Media,1918,10,10,0,100.0,0.0,Female
Wise,1918,5,0,5,0.0,100.0,Male
Mance,1918,7,0,7,0.0,100.0,Male
Ogle,1918,7,0,7,0.0,100.0,Male
Euell,1918,13,0,13,0.0,100.0,Male
Harland,1918,155,0,155,0.0,100.0,Male
Waylon,1918,11,0,11,0.0,100.0,Male
Irwin,1918,297,5,292,1.6835016835016834,98.31649831649833,Male
Arnold,1918,1927,17,1910,0.8822003113648157,99.1177996886352,Male
Hurley,1918,39,0,39,0.0,100.0,Male
Gresham,1918,5,0,5,0.0,100.0,Male
Milledge,1918,8,0,8,0.0,100.0,Male
Eloy,1918,28,0,28,0.0,100.0,Male
Maynord,1918,5,0,5,0.0,100.0,Male
Haywood,1918,101,0,101,0.0,100.0,Male
Cornelious,1918,32,0,32,0.0,100.0,Male
Zygmunt,1918,27,0,27,0.0,100.0,Male
Junior,1918,389,0,389,0.0,100.0,Male
Hyram,1918,5,0,5,0.0,100.0,Male
Waddell,1918,14,0,14,0.0,100.0,Male
Barclay,1918,11,0,11,0.0,100.0,Male
Tip,1918,7,0,7,0.0,100.0,Male
Colby,1918,7,0,7,0.0,100.0,Male
Moody,1918,23,0,23,0.0,100.0,Male
Park,1918,32,0,32,0.0,100.0,Male
Cain,1918,8,0,8,0.0,100.0,Male
Delroy,1918,5,0,5,0.0,100.0,Male
Beecher,1918,27,0,27,0.0,100.0,Male
Hartford,1918,14,0,14,0.0,100.0,Male
Leron,1918,10,0,10,0.0,100.0,Male
Darrel,1918,105,0,105,0.0,100.0,Male
Robie,1918,17,10,7,58.82352941176471,41.17647058823529,Unisex
Unknown,1918,51,20,31,39.21568627450981,60.78431372549019,Unisex
Montie,1918,37,17,20,45.94594594594595,54.054054054054056,Unisex
Holland,1918,28,5,23,17.857142857142858,82.14285714285714,Unisex
Rea,1918,32,18,14,56.25,43.75,Unisex
Collie,1918,43,13,30,30.23255813953488,69.76744186046511,Unisex
Carnell,1918,26,13,13,50.0,50.0,Unisex
Myrl,1918,113,74,39,65.48672566371681,34.51327433628318,Unisex
Murl,1918,82,29,53,35.36585365853659,64.63414634146342,Unisex
Aldine,1918,40,30,10,75.0,25.0,Unisex
Othello,1918,16,6,10,37.5,62.5,Unisex
Ventura,1918,13,5,8,38.46153846153847,61.53846153846154,Unisex
Levie,1918,33,11,22,33.33333333333333,66.66666666666666,Unisex
Vernell,1918,126,103,23,81.74603174603175,18.253968253968253,Unisex
Fayette,1918,26,9,17,34.61538461538461,65.38461538461539,Unisex
Bennie,1918,1000,181,819,18.1,81.89999999999999,Unisex
Elba,1918,48,36,12,75.0,25.0,Unisex
Johnie,1918,829,196,633,23.64294330518697,76.35705669481302,Unisex
Patsy,1918,459,177,282,38.56209150326798,61.43790849673203,Unisex
Oda,1918,52,43,9,82.6923076923077,17.307692307692307,Unisex
Evon,1918,24,16,8,66.66666666666666,33.33333333333333,Unisex
Marrion,1918,16,6,10,37.5,62.5,Unisex
Oree,1918,14,9,5,64.28571428571429,35.714285714285715,Unisex
Cleo,1918,1372,1009,363,73.54227405247813,26.457725947521865,Unisex
Penny,1918,27,21,6,77.77777777777779,22.22222222222222,Unisex
Lovell,1918,52,10,42,19.23076923076924,80.76923076923077,Unisex
Tex,1918,20,5,15,25.0,75.0,Unisex
Lavere,1918,22,10,12,45.45454545454545,54.54545454545454,Unisex
Fran,1918,21,16,5,76.19047619047619,23.809523809523807,Unisex
Murrel,1918,36,10,26,27.77777777777778,72.22222222222221,Unisex
Valiree,1919,6,6,0,100.0,0.0,Female
Francelina,1919,5,5,0,100.0,0.0,Female
Olevia,1919,48,48,0,100.0,0.0,Female
Winiferd,1919,6,6,0,100.0,0.0,Female
Hester,1919,379,360,19,94.9868073878628,5.013192612137203,Female
Willo,1919,5,5,0,100.0,0.0,Female
Armetha,1919,7,7,0,100.0,0.0,Female
Ninetta,1919,5,5,0,100.0,0.0,Female
Ona,1919,168,163,5,97.02380952380952,2.976190476190476,Female
Johnniemae,1919,9,9,0,100.0,0.0,Female
Blondena,1919,5,5,0,100.0,0.0,Female
Lucetta,1919,15,15,0,100.0,0.0,Female
Roma,1919,152,133,19,87.5,12.5,Female
Adella,1919,141,141,0,100.0,0.0,Female
Faun,1919,7,7,0,100.0,0.0,Female
Costella,1919,8,8,0,100.0,0.0,Female
Hazelle,1919,34,34,0,100.0,0.0,Female
Lurene,1919,27,27,0,100.0,0.0,Female
Geneviene,1919,8,8,0,100.0,0.0,Female
Claudia,1919,362,355,7,98.06629834254144,1.933701657458564,Female
Dorene,1919,34,34,0,100.0,0.0,Female
Michelina,1919,29,29,0,100.0,0.0,Female
Tena,1919,45,45,0,100.0,0.0,Female
Mazola,1919,8,8,0,100.0,0.0,Female
Wenona,1919,16,16,0,100.0,0.0,Female
Vernella,1919,6,6,0,100.0,0.0,Female
Mitsue,1919,18,18,0,100.0,0.0,Female
Sarita,1919,7,7,0,100.0,0.0,Female
Dela,1919,13,13,0,100.0,0.0,Female
Florie,1919,10,10,0,100.0,0.0,Female
Jimmy,1919,254,15,239,5.905511811023622,94.09448818897636,Male
Edmundo,1919,11,0,11,0.0,100.0,Male
Charle,1919,7,0,7,0.0,100.0,Male
Eldrige,1919,7,0,7,0.0,100.0,Male
Hanley,1919,6,0,6,0.0,100.0,Male
Buster,1919,219,0,219,0.0,100.0,Male
Owens,1919,16,0,16,0.0,100.0,Male
Ceylon,1919,7,0,7,0.0,100.0,Male
Zack,1919,66,0,66,0.0,100.0,Male
Rance,1919,11,0,11,0.0,100.0,Male
Arvid,1919,79,0,79,0.0,100.0,Male
Graves,1919,5,0,5,0.0,100.0,Male
Edvin,1919,6,0,6,0.0,100.0,Male
Owen,1919,556,0,556,0.0,100.0,Male
Rolly,1919,5,0,5,0.0,100.0,Male
Dalmer,1919,6,0,6,0.0,100.0,Male
Vahan,1919,6,0,6,0.0,100.0,Male
Rodger,1919,63,0,63,0.0,100.0,Male
Apolonio,1919,11,0,11,0.0,100.0,Male
Emile,1919,156,6,150,3.8461538461538463,96.15384615384616,Male
Wendall,1919,16,0,16,0.0,100.0,Male
Jaroslav,1919,7,0,7,0.0,100.0,Male
Jason,1919,81,0,81,0.0,100.0,Male
Stephen,1919,1702,9,1693,0.5287896592244419,99.47121034077556,Male
Kester,1919,6,0,6,0.0,100.0,Male
Amos,1919,523,0,523,0.0,100.0,Male
Bernhardt,1919,16,0,16,0.0,100.0,Male
Elwin,1919,104,0,104,0.0,100.0,Male
Shelly,1919,18,0,18,0.0,100.0,Male
Alver,1919,8,0,8,0.0,100.0,Male
Gray,1919,32,7,25,21.875,78.125,Unisex
Dorris,1919,245,203,42,82.85714285714286,17.142857142857142,Unisex
Murle,1919,15,8,7,53.333333333333336,46.66666666666666,Unisex
Carmie,1919,19,11,8,57.89473684210527,42.10526315789473,Unisex
Temple,1919,21,7,14,33.33333333333333,66.66666666666666,Unisex
Elzie,1919,119,25,94,21.00840336134453,78.99159663865547,Unisex
Jamie,1919,110,73,37,66.36363636363637,33.63636363636363,Unisex
Tonie,1919,15,8,7,53.333333333333336,46.66666666666666,Unisex
Glennie,1919,52,41,11,78.84615384615384,21.15384615384616,Unisex
Villa,1919,16,10,6,62.5,37.5,Unisex
Darnell,1919,16,5,11,31.25,68.75,Unisex
Virgal,1919,13,5,8,38.46153846153847,61.53846153846154,Unisex
Carmel,1919,128,105,23,82.03125,17.96875,Unisex
Lemon,1919,27,5,22,18.51851851851852,81.48148148148148,Unisex
Vollie,1919,15,8,7,53.333333333333336,46.66666666666666,Unisex
Rudell,1919,20,12,8,60.0,40.0,Unisex
Cleatus,1919,22,5,17,22.727272727272727,77.27272727272727,Unisex
Larue,1919,131,103,28,78.62595419847328,21.37404580152672,Unisex
Burnice,1919,86,53,33,61.627906976744185,38.372093023255815,Unisex
Verlon,1919,35,14,21,40.0,60.0,Unisex
Jemmie,1919,13,5,8,38.46153846153847,61.53846153846154,Unisex
Ivery,1919,30,11,19,36.66666666666666,63.33333333333333,Unisex
Burnette,1919,26,20,6,76.92307692307693,23.07692307692308,Unisex
Dell,1919,80,37,43,46.25,53.75,Unisex
Ossie,1919,138,96,42,69.56521739130434,30.434782608695656,Unisex
Toby,1919,75,45,30,60.0,40.0,Unisex
Luvern,1919,11,5,6,45.45454545454545,54.54545454545454,Unisex
Jody,1919,11,5,6,45.45454545454545,54.54545454545454,Unisex
Murl,1919,78,13,65,16.666666666666664,83.33333333333334,Unisex
Rozell,1919,26,12,14,46.15384615384615,53.84615384615385,Unisex
Jeanelle,1920,6,6,0,100.0,0.0,Female
Alpine,1920,7,7,0,100.0,0.0,Female
Saleta,1920,5,5,0,100.0,0.0,Female
Arda,1920,12,12,0,100.0,0.0,Female
Theresa,1920,2432,2426,6,99.75328947368422,0.2467105263157894,Female
Lovenia,1920,11,11,0,100.0,0.0,Female
Jeri,1920,6,6,0,100.0,0.0,Female
Ninfa,1920,16,16,0,100.0,0.0,Female
Fronnie,1920,9,9,0,100.0,0.0,Female
Vincenta,1920,5,5,0,100.0,0.0,Female
Bridget,1920,70,70,0,100.0,0.0,Female
Virgia,1920,37,37,0,100.0,0.0,Female
Rosamae,1920,6,6,0,100.0,0.0,Female
Eveline,1920,55,55,0,100.0,0.0,Female
Clotee,1920,6,6,0,100.0,0.0,Female
Valeda,1920,12,12,0,100.0,0.0,Female
Vieno,1920,8,8,0,100.0,0.0,Female
Eurith,1920,7,7,0,100.0,0.0,Female
Luola,1920,6,6,0,100.0,0.0,Female
Eliz,1920,7,7,0,100.0,0.0,Female
Delila,1920,20,20,0,100.0,0.0,Female
Cinda,1920,11,11,0,100.0,0.0,Female
Edmonia,1920,23,23,0,100.0,0.0,Female
Verbena,1920,6,6,0,100.0,0.0,Female
Hatsuye,1920,5,5,0,100.0,0.0,Female
Mercie,1920,5,5,0,100.0,0.0,Female
Estela,1920,40,40,0,100.0,0.0,Female
Merial,1920,5,5,0,100.0,0.0,Female
Fredna,1920,8,8,0,100.0,0.0,Female
Lugenia,1920,15,15,0,100.0,0.0,Female
Gusty,1920,5,0,5,0.0,100.0,Male
Tyler,1920,30,0,30,0.0,100.0,Male
Vern,1920,282,8,274,2.8368794326241136,97.16312056737588,Male
Alger,1920,18,0,18,0.0,100.0,Male
Hoy,1920,25,0,25,0.0,100.0,Male
Colvin,1920,15,0,15,0.0,100.0,Male
Julio,1920,98,0,98,0.0,100.0,Male
Lem,1920,23,0,23,0.0,100.0,Male
Narciso,1920,19,0,19,0.0,100.0,Male
Myer,1920,23,0,23,0.0,100.0,Male
Hall,1920,16,0,16,0.0,100.0,Male
Darvin,1920,20,0,20,0.0,100.0,Male
Hobert,1920,168,0,168,0.0,100.0,Male
Elbern,1920,5,0,5,0.0,100.0,Male
Windsor,1920,7,0,7,0.0,100.0,Male
Floid,1920,8,0,8,0.0,100.0,Male
Evin,1920,5,0,5,0.0,100.0,Male
Patricio,1920,24,0,24,0.0,100.0,Male
Einer,1920,7,0,7,0.0,100.0,Male
Sidney,1920,1664,54,1610,3.245192307692308,96.7548076923077,Male
Jethro,1920,32,0,32,0.0,100.0,Male
Carley,1920,15,0,15,0.0,100.0,Male
Evert,1920,90,0,90,0.0,100.0,Male
Dean,1920,835,47,788,5.62874251497006,94.37125748502991,Male
Legrande,1920,7,0,7,0.0,100.0,Male
Viviano,1920,7,0,7,0.0,100.0,Male
Quinten,1920,33,0,33,0.0,100.0,Male
Cletus,1920,182,9,173,4.945054945054945,95.05494505494504,Male
Argle,1920,5,0,5,0.0,100.0,Male
Estus,1920,6,0,6,0.0,100.0,Male
Vester,1920,80,13,67,16.25,83.75,Unisex
Burnette,1920,29,23,6,79.3103448275862,20.6896551724138,Unisex
Nicola,1920,30,5,25,16.666666666666664,83.33333333333334,Unisex
Ronnie,1920,53,31,22,58.490566037735846,41.50943396226416,Unisex
Marion,1920,7349,5745,1604,78.17390121104913,21.82609878895088,Unisex
Maryland,1920,20,9,11,45.0,55.00000000000001,Unisex
Vere,1920,18,6,12,33.33333333333333,66.66666666666666,Unisex
Junie,1920,27,19,8,70.37037037037037,29.629629629629623,Unisex
Jamie,1920,93,64,29,68.81720430107528,31.18279569892473,Unisex
Curley,1920,40,7,33,17.5,82.5,Unisex
Lugene,1920,21,12,9,57.14285714285714,42.85714285714285,Unisex
Dorian,1920,13,6,7,46.15384615384615,53.84615384615385,Unisex
Ivor,1920,16,5,11,31.25,68.75,Unisex
Verlin,1920,93,14,79,15.053763440860216,84.94623655913979,Unisex
Berlin,1920,52,10,42,19.23076923076924,80.76923076923077,Unisex
Jackie,1920,183,144,39,78.68852459016394,21.311475409836063,Unisex
Hildreth,1920,36,28,8,77.77777777777779,22.22222222222222,Unisex
Gerry,1920,53,43,10,81.13207547169812,18.867924528301888,Unisex
Dennie,1920,36,8,28,22.22222222222222,77.77777777777779,Unisex
Vilas,1920,25,8,17,32.0,68.0,Unisex
Lyndell,1920,26,13,13,50.0,50.0,Unisex
Bradie,1920,14,6,8,42.85714285714285,57.14285714285714,Unisex
Bobby,1920,223,53,170,23.76681614349776,76.23318385650224,Unisex
Verlyn,1920,29,13,16,44.82758620689656,55.172413793103445,Unisex
Byrl,1920,30,6,24,20.0,80.0,Unisex
Murrel,1920,36,11,25,30.55555555555556,69.44444444444444,Unisex
Lavell,1920,28,15,13,53.57142857142857,46.42857142857143,Unisex
Penny,1920,31,26,5,83.87096774193549,16.129032258064516,Unisex
Vertis,1920,14,7,7,50.0,50.0,Unisex
Gale,1920,211,35,176,16.587677725118482,83.41232227488152,Unisex
Rusha,1921,6,6,0,100.0,0.0,Female
Ardine,1921,7,7,0,100.0,0.0,Female
Lossie,1921,51,44,7,86.27450980392157,13.725490196078432,Female
Valeta,1921,10,10,0,100.0,0.0,Female
Luzetta,1921,5,5,0,100.0,0.0,Female
Angie,1921,230,230,0,100.0,0.0,Female
Teola,1921,11,11,0,100.0,0.0,Female
Erlean,1921,5,5,0,100.0,0.0,Female
Odelia,1921,48,48,0,100.0,0.0,Female
Zanna,1921,7,7,0,100.0,0.0,Female
Dillie,1921,12,12,0,100.0,0.0,Female
Ethelene,1921,53,53,0,100.0,0.0,Female
Lucill,1921,13,13,0,100.0,0.0,Female
Philis,1921,8,8,0,100.0,0.0,Female
Luna,1921,61,61,0,100.0,0.0,Female
Honey,1921,8,8,0,100.0,0.0,Female
Dovey,1921,8,8,0,100.0,0.0,Female
Roseanna,1921,35,35,0,100.0,0.0,Female
Janey,1921,26,26,0,100.0,0.0,Female
Mariellen,1921,19,19,0,100.0,0.0,Female
Yuki,1921,5,5,0,100.0,0.0,Female
Audre,1921,16,16,0,100.0,0.0,Female
Okie,1921,9,9,0,100.0,0.0,Female
Charlotte,1921,3594,3587,7,99.80523094045633,0.1947690595436839,Female
Capitola,1921,14,14,0,100.0,0.0,Female
Jennifer,1921,5,5,0,100.0,0.0,Female
Berdina,1921,14,14,0,100.0,0.0,Female
Hilma,1921,72,72,0,100.0,0.0,Female
Teresita,1921,10,10,0,100.0,0.0,Female
Katsuko,1921,6,6,0,100.0,0.0,Female
Victorino,1921,6,0,6,0.0,100.0,Male
Burman,1921,6,0,6,0.0,100.0,Male
Donn,1921,38,0,38,0.0,100.0,Male
Tetsuo,1921,20,0,20,0.0,100.0,Male
Noval,1921,5,0,5,0.0,100.0,Male
Gonzalo,1921,20,0,20,0.0,100.0,Male
Waverly,1921,27,0,27,0.0,100.0,Male
Armen,1921,12,0,12,0.0,100.0,Male
Nickey,1921,5,0,5,0.0,100.0,Male
Gladstone,1921,6,0,6,0.0,100.0,Male
Jorden,1921,5,0,5,0.0,100.0,Male
Elvyn,1921,8,0,8,0.0,100.0,Male
Corbin,1921,20,0,20,0.0,100.0,Male
Crayton,1921,9,0,9,0.0,100.0,Male
Ulrich,1921,5,0,5,0.0,100.0,Male
Hobart,1921,136,0,136,0.0,100.0,Male
Phillips,1921,14,0,14,0.0,100.0,Male
Mason,1921,144,0,144,0.0,100.0,Male
Martyn,1921,6,0,6,0.0,100.0,Male
Eldie,1921,5,0,5,0.0,100.0,Male
Sherman,1921,492,5,487,1.016260162601626,98.98373983739836,Male
Giovanni,1921,22,0,22,0.0,100.0,Male
Milfred,1921,16,0,16,0.0,100.0,Male
Gilmore,1921,15,0,15,0.0,100.0,Male
Swan,1921,8,0,8,0.0,100.0,Male
Gary,1921,95,9,86,9.473684210526317,90.52631578947368,Male
Rito,1921,10,0,10,0.0,100.0,Male
Wilfred,1921,747,10,737,1.3386880856760377,98.66131191432396,Male
Kiyoto,1921,7,0,7,0.0,100.0,Male
Garlen,1921,5,0,5,0.0,100.0,Male
Marlowe,1921,19,6,13,31.57894736842105,68.42105263157895,Unisex
Lupe,1921,384,302,82,78.64583333333334,21.354166666666664,Unisex
Ferris,1921,53,8,45,15.09433962264151,84.90566037735849,Unisex
Burnette,1921,25,16,9,64.0,36.0,Unisex
Ascencion,1921,15,6,9,40.0,60.0,Unisex
Maxie,1921,146,87,59,59.589041095890416,40.41095890410959,Unisex
Edie,1921,19,13,6,68.42105263157895,31.57894736842105,Unisex
Artie,1921,214,156,58,72.89719626168224,27.10280373831776,Unisex
Elvie,1921,104,87,17,83.65384615384616,16.346153846153847,Unisex
Vernie,1921,172,95,77,55.23255813953488,44.76744186046512,Unisex
Carmello,1921,22,5,17,22.727272727272727,77.27272727272727,Unisex
Earlie,1921,79,27,52,34.177215189873415,65.82278481012658,Unisex
Ivery,1921,20,11,9,55.00000000000001,45.0,Unisex
Laverne,1921,1568,1163,405,74.17091836734694,25.82908163265306,Unisex
Sherley,1921,16,6,10,37.5,62.5,Unisex
Arvis,1921,26,8,18,30.76923076923077,69.23076923076923,Unisex
Rene,1921,204,42,162,20.588235294117645,79.41176470588235,Unisex
Vernis,1921,17,9,8,52.94117647058824,47.05882352941176,Unisex
Valjean,1921,15,9,6,60.0,40.0,Unisex
Farrel,1921,14,5,9,35.714285714285715,64.28571428571429,Unisex
Golden,1921,116,58,58,50.0,50.0,Unisex
Zell,1921,19,14,5,73.68421052631578,26.31578947368421,Unisex
Burnett,1921,49,11,38,22.448979591836736,77.55102040816327,Unisex
Nieves,1921,30,15,15,50.0,50.0,Unisex
Bertice,1921,13,7,6,53.84615384615385,46.15384615384615,Unisex
Odell,1921,495,171,324,34.54545454545455,65.45454545454545,Unisex
Mannie,1921,35,13,22,37.142857142857146,62.85714285714285,Unisex
Pat,1921,298,75,223,25.16778523489933,74.83221476510067,Unisex
Lorenza,1921,91,45,46,49.45054945054945,50.54945054945055,Unisex
Courtney,1921,54,16,38,29.629629629629623,70.37037037037037,Unisex
Katina,1922,5,5,0,100.0,0.0,Female
Gustavia,1922,12,12,0,100.0,0.0,Female
Hanako,1922,13,13,0,100.0,0.0,Female
Jana,1922,6,6,0,100.0,0.0,Female
Maragret,1922,9,9,0,100.0,0.0,Female
Katherina,1922,7,7,0,100.0,0.0,Female
Rayola,1922,5,5,0,100.0,0.0,Female
Senia,1922,6,6,0,100.0,0.0,Female
Willetta,1922,52,52,0,100.0,0.0,Female
Elinor,1922,539,539,0,100.0,0.0,Female
Rebeca,1922,22,22,0,100.0,0.0,Female
Myrth,1922,5,5,0,100.0,0.0,Female
Marsella,1922,6,6,0,100.0,0.0,Female
Margurette,1922,9,9,0,100.0,0.0,Female
Mescal,1922,12,12,0,100.0,0.0,Female
Florine,1922,362,362,0,100.0,0.0,Female
Marigold,1922,6,6,0,100.0,0.0,Female
Marlene,1922,59,59,0,100.0,0.0,Female
Maralyn,1922,11,11,0,100.0,0.0,Female
Doretha,1922,114,114,0,100.0,0.0,Female
Madalena,1922,5,5,0,100.0,0.0,Female
Fumiko,1922,48,48,0,100.0,0.0,Female
Audery,1922,9,9,0,100.0,0.0,Female
Zina,1922,18,18,0,100.0,0.0,Female
Middie,1922,6,6,0,100.0,0.0,Female
Patricia,1922,3910,3902,8,99.79539641943734,0.2046035805626598,Female
Margerite,1922,7,7,0,100.0,0.0,Female
Carol,1922,1655,1522,133,91.96374622356495,8.036253776435046,Female
Elmire,1922,5,5,0,100.0,0.0,Female
Eva,1922,4212,4192,20,99.52516619183284,0.4748338081671415,Female
Jessee,1922,21,0,21,0.0,100.0,Male
Scipio,1922,5,0,5,0.0,100.0,Male
Federico,1922,39,0,39,0.0,100.0,Male
Nial,1922,5,0,5,0.0,100.0,Male
Myers,1922,12,0,12,0.0,100.0,Male
Donavan,1922,8,0,8,0.0,100.0,Male
Fidencio,1922,8,0,8,0.0,100.0,Male
Harce,1922,10,0,10,0.0,100.0,Male
Friend,1922,6,0,6,0.0,100.0,Male
Denton,1922,48,0,48,0.0,100.0,Male
Hoover,1922,7,0,7,0.0,100.0,Male
Grant,1922,417,0,417,0.0,100.0,Male
Gyle,1922,5,0,5,0.0,100.0,Male
Dearl,1922,7,0,7,0.0,100.0,Male
Pervis,1922,14,0,14,0.0,100.0,Male
Jona,1922,5,0,5,0.0,100.0,Male
Donovan,1922,52,0,52,0.0,100.0,Male
Nephi,1922,6,0,6,0.0,100.0,Male
Mateo,1922,16,0,16,0.0,100.0,Male
Gorden,1922,82,0,82,0.0,100.0,Male
Ulesses,1922,5,0,5,0.0,100.0,Male
Mitsuyoshi,1922,5,0,5,0.0,100.0,Male
Charley,1922,444,9,435,2.027027027027027,97.97297297297295,Male
Bruno,1922,261,0,261,0.0,100.0,Male
Benard,1922,32,0,32,0.0,100.0,Male
Lusiano,1922,5,0,5,0.0,100.0,Male
Sheldon,1922,233,0,233,0.0,100.0,Male
Regis,1922,95,8,87,8.421052631578947,91.57894736842104,Male
Barton,1922,72,0,72,0.0,100.0,Male
Coley,1922,20,0,20,0.0,100.0,Male
Ardell,1922,143,96,47,67.13286713286713,32.86713286713287,Unisex
Ernie,1922,80,16,64,20.0,80.0,Unisex
Willie,1922,10789,3885,6904,36.008897951617385,63.99110204838261,Unisex
Courtney,1922,63,15,48,23.809523809523807,76.19047619047619,Unisex
Perle,1922,19,13,6,68.42105263157895,31.57894736842105,Unisex
Rudell,1922,15,9,6,60.0,40.0,Unisex
Tommie,1922,711,286,425,40.22503516174402,59.774964838255976,Unisex
Cleo,1922,1300,991,309,76.23076923076924,23.76923076923077,Unisex
Hildred,1922,95,80,15,84.21052631578947,15.789473684210526,Unisex
Frankie,1922,568,452,116,79.5774647887324,20.422535211267608,Unisex
Lynn,1922,460,77,383,16.73913043478261,83.26086956521739,Unisex
Rue,1922,18,5,13,27.77777777777778,72.22222222222221,Unisex
Marvie,1922,12,6,6,50.0,50.0,Unisex
Caroll,1922,18,7,11,38.88888888888889,61.11111111111112,Unisex
Alvah,1922,35,7,28,20.0,80.0,Unisex
Burdell,1922,15,7,8,46.66666666666666,53.333333333333336,Unisex
Estell,1922,162,135,27,83.33333333333334,16.666666666666664,Unisex
Daris,1922,19,14,5,73.68421052631578,26.31578947368421,Unisex
Ruble,1922,13,7,6,53.84615384615385,46.15384615384615,Unisex
Erie,1922,42,28,14,66.66666666666666,33.33333333333333,Unisex
Ottie,1922,52,29,23,55.76923076923077,44.230769230769226,Unisex
Vearl,1922,19,7,12,36.84210526315789,63.1578947368421,Unisex
Clemence,1922,32,9,23,28.125,71.875,Unisex
San,1922,14,9,5,64.28571428571429,35.714285714285715,Unisex
Sydney,1922,191,30,161,15.706806282722512,84.29319371727748,Unisex
Ezell,1922,71,19,52,26.76056338028169,73.23943661971832,Unisex
Robie,1922,29,13,16,44.82758620689656,55.172413793103445,Unisex
Adna,1922,12,5,7,41.66666666666667,58.333333333333336,Unisex
Jodie,1922,63,13,50,20.63492063492064,79.36507936507937,Unisex
Elzie,1922,113,20,93,17.699115044247787,82.30088495575221,Unisex
Dollye,1923,9,9,0,100.0,0.0,Female
Gerlene,1923,6,6,0,100.0,0.0,Female
Millie,1923,420,406,14,96.66666666666669,3.333333333333333,Female
Pencie,1923,5,5,0,100.0,0.0,Female
Okla,1923,6,6,0,100.0,0.0,Female
Arleene,1923,19,19,0,100.0,0.0,Female
Bianca,1923,11,11,0,100.0,0.0,Female
Dillie,1923,12,12,0,100.0,0.0,Female
Kiyo,1923,7,7,0,100.0,0.0,Female
Sharron,1923,5,5,0,100.0,0.0,Female
Odile,1923,18,18,0,100.0,0.0,Female
Genevie,1923,42,42,0,100.0,0.0,Female
Myrtha,1923,10,10,0,100.0,0.0,Female
Helenann,1923,6,6,0,100.0,0.0,Female
Reecie,1923,7,7,0,100.0,0.0,Female
Sweetie,1923,8,8,0,100.0,0.0,Female
Hisaye,1923,7,7,0,100.0,0.0,Female
Earlene,1923,181,181,0,100.0,0.0,Female
Edda,1923,7,7,0,100.0,0.0,Female
Anner,1923,25,25,0,100.0,0.0,Female
Marilynn,1923,243,243,0,100.0,0.0,Female
Jeweline,1923,8,8,0,100.0,0.0,Female
Madeline,1923,1756,1756,0,100.0,0.0,Female
Linnea,1923,24,24,0,100.0,0.0,Female
Lealer,1923,5,5,0,100.0,0.0,Female
Vicie,1923,20,20,0,100.0,0.0,Female
Macaria,1923,9,9,0,100.0,0.0,Female
Lauraine,1923,20,20,0,100.0,0.0,Female
Alvira,1923,31,31,0,100.0,0.0,Female
Margrie,1923,12,12,0,100.0,0.0,Female
Sandy,1923,84,12,72,14.285714285714285,85.71428571428571,Male
Edwards,1923,13,0,13,0.0,100.0,Male
Beal,1923,6,0,6,0.0,100.0,Male
Susano,1923,6,0,6,0.0,100.0,Male
Kazuo,1923,44,0,44,0.0,100.0,Male
Alonso,1923,5,0,5,0.0,100.0,Male
Noboru,1923,32,0,32,0.0,100.0,Male
Guiseppe,1923,5,0,5,0.0,100.0,Male
Hachiro,1923,7,0,7,0.0,100.0,Male
Toshiro,1923,5,0,5,0.0,100.0,Male
Grey,1923,6,0,6,0.0,100.0,Male
Richard,1923,18965,78,18887,0.4112839441075666,99.58871605589243,Male
Elvert,1923,6,0,6,0.0,100.0,Male
Barney,1923,268,8,260,2.985074626865672,97.01492537313432,Male
Henery,1923,42,0,42,0.0,100.0,Male
Luke,1923,185,0,185,0.0,100.0,Male
Estevan,1923,12,0,12,0.0,100.0,Male
Artemus,1923,7,0,7,0.0,100.0,Male
Sanders,1923,30,0,30,0.0,100.0,Male
Bisente,1923,5,0,5,0.0,100.0,Male
Loys,1923,5,0,5,0.0,100.0,Male
Carter,1923,84,0,84,0.0,100.0,Male
Cesar,1923,15,0,15,0.0,100.0,Male
Isami,1923,10,0,10,0.0,100.0,Male
Vergil,1923,72,5,67,6.944444444444445,93.05555555555556,Male
Jarl,1923,5,0,5,0.0,100.0,Male
Grover,1923,575,0,575,0.0,100.0,Male
Rufino,1923,14,0,14,0.0,100.0,Male
Armon,1923,18,0,18,0.0,100.0,Male
Berthold,1923,9,0,9,0.0,100.0,Male
Melvine,1923,17,12,5,70.58823529411765,29.411764705882355,Unisex
Zell,1923,12,7,5,58.333333333333336,41.66666666666667,Unisex
Posey,1923,17,5,12,29.411764705882355,70.58823529411765,Unisex
Tobie,1923,11,5,6,45.45454545454545,54.54545454545454,Unisex
Ivy,1923,148,102,46,68.91891891891892,31.08108108108108,Unisex
Maxie,1923,162,87,75,53.70370370370371,46.2962962962963,Unisex
Willie,1923,10628,3963,6665,37.2882950696274,62.711704930372605,Unisex
Arie,1923,50,29,21,57.99999999999999,42.0,Unisex
Macy,1923,33,25,8,75.75757575757575,24.24242424242424,Unisex
Johnie,1923,776,176,600,22.68041237113402,77.31958762886599,Unisex
Mayo,1923,46,13,33,28.26086956521739,71.73913043478261,Unisex
Arnell,1923,21,14,7,66.66666666666666,33.33333333333333,Unisex
Ottie,1923,41,27,14,65.85365853658537,34.14634146341464,Unisex
Pernell,1923,13,6,7,46.15384615384615,53.84615384615385,Unisex
Marcy,1923,15,9,6,60.0,40.0,Unisex
Meryl,1923,54,37,17,68.51851851851852,31.48148148148148,Unisex
Artie,1923,200,144,56,72.0,28.000000000000004,Unisex
Simone,1923,48,39,9,81.25,18.75,Unisex
Caroll,1923,11,5,6,45.45454545454545,54.54545454545454,Unisex
Rossie,1923,38,27,11,71.05263157894737,28.94736842105264,Unisex
Angel,1923,100,18,82,18.0,82.0,Unisex
Allie,1923,483,402,81,83.22981366459628,16.77018633540373,Unisex
Randy,1923,13,6,7,46.15384615384615,53.84615384615385,Unisex
Hollie,1923,29,10,19,34.48275862068966,65.51724137931035,Unisex
Cleofas,1923,13,8,5,61.53846153846154,38.46153846153847,Unisex
Verlin,1923,81,13,68,16.049382716049383,83.9506172839506,Unisex
Foy,1923,65,13,52,20.0,80.0,Unisex
Carrol,1923,168,41,127,24.404761904761905,75.59523809523809,Unisex
Silver,1923,12,6,6,50.0,50.0,Unisex
Rozell,1923,14,9,5,64.28571428571429,35.714285714285715,Unisex
Mayda,1924,5,5,0,100.0,0.0,Female
Nancey,1924,5,5,0,100.0,0.0,Female
Yola,1924,27,27,0,100.0,0.0,Female
Mary,1924,73758,73534,224,99.69630412972153,0.3036958702784783,Female
Maudell,1924,21,21,0,100.0,0.0,Female
Elizabeth,1924,14992,14950,42,99.71985058697972,0.2801494130202774,Female
Joscelyn,1924,5,5,0,100.0,0.0,Female
Loreen,1924,22,22,0,100.0,0.0,Female
Hilaria,1924,26,26,0,100.0,0.0,Female
Arleane,1924,6,6,0,100.0,0.0,Female
Donzella,1924,7,7,0,100.0,0.0,Female
Reathel,1924,13,13,0,100.0,0.0,Female
Flossie,1924,467,467,0,100.0,0.0,Female
Kiyono,1924,5,5,0,100.0,0.0,Female
Arla,1924,40,40,0,100.0,0.0,Female
Tressie,1924,103,103,0,100.0,0.0,Female
Irene,1924,9957,9928,29,99.7087476147434,0.2912523852566034,Female
Theone,1924,11,11,0,100.0,0.0,Female
Dema,1924,10,10,0,100.0,0.0,Female
Lorice,1924,6,6,0,100.0,0.0,Female
Anna,1924,13108,13076,32,99.75587427525176,0.2441257247482453,Female
Abba,1924,6,6,0,100.0,0.0,Female
Blossie,1924,6,6,0,100.0,0.0,Female
Herberta,1924,6,6,0,100.0,0.0,Female
Polly,1924,348,340,8,97.70114942528735,2.2988505747126435,Female
Laurabel,1924,7,7,0,100.0,0.0,Female
Margree,1924,10,10,0,100.0,0.0,Female
Prudie,1924,8,8,0,100.0,0.0,Female
Nelwyn,1924,14,14,0,100.0,0.0,Female
Serafine,1924,5,5,0,100.0,0.0,Female
Rodrick,1924,6,0,6,0.0,100.0,Male
Regino,1924,9,0,9,0.0,100.0,Male
Searcy,1924,11,0,11,0.0,100.0,Male
Bernardino,1924,17,0,17,0.0,100.0,Male
Wadell,1924,9,0,9,0.0,100.0,Male
Chilton,1924,11,0,11,0.0,100.0,Male
Ruben,1924,398,0,398,0.0,100.0,Male
Troy,1924,573,14,559,2.4432809773123907,97.55671902268762,Male
Welford,1924,8,0,8,0.0,100.0,Male
Mancil,1924,6,0,6,0.0,100.0,Male
Coleman,1924,107,0,107,0.0,100.0,Male
Andy,1924,272,6,266,2.2058823529411766,97.79411764705884,Male
Alman,1924,6,0,6,0.0,100.0,Male
Walt,1924,13,0,13,0.0,100.0,Male
Gee,1924,5,0,5,0.0,100.0,Male
Vinson,1924,16,0,16,0.0,100.0,Male
Sterlin,1924,5,0,5,0.0,100.0,Male
Girolamo,1924,5,0,5,0.0,100.0,Male
Billy,1924,3369,98,3271,2.9088750371029977,97.091124962897,Male
Ural,1924,12,0,12,0.0,100.0,Male
Ozel,1924,5,0,5,0.0,100.0,Male
Wildon,1924,5,0,5,0.0,100.0,Male
Teodoro,1924,36,0,36,0.0,100.0,Male
Fenton,1924,34,0,34,0.0,100.0,Male
Wilborn,1924,24,0,24,0.0,100.0,Male
Carmelo,1924,85,0,85,0.0,100.0,Male
Darrold,1924,5,0,5,0.0,100.0,Male
Hewitt,1924,22,0,22,0.0,100.0,Male
Kerwin,1924,8,0,8,0.0,100.0,Male
Oties,1924,5,0,5,0.0,100.0,Male
Sherley,1924,15,9,6,60.0,40.0,Unisex
Lavon,1924,183,152,31,83.06010928961749,16.939890710382514,Unisex
Juel,1924,36,19,17,52.77777777777778,47.22222222222222,Unisex
Roby,1924,37,8,29,21.62162162162162,78.37837837837837,Unisex
Laverne,1924,1785,1383,402,77.47899159663866,22.521008403361343,Unisex
Delma,1924,227,188,39,82.81938325991189,17.180616740088105,Unisex
Emerald,1924,19,6,13,31.57894736842105,68.42105263157895,Unisex
Osie,1924,53,32,21,60.37735849056604,39.62264150943396,Unisex
Lovell,1924,59,24,35,40.67796610169492,59.32203389830508,Unisex
Alison,1924,34,23,11,67.64705882352942,32.35294117647059,Unisex
Christie,1924,42,21,21,50.0,50.0,Unisex
Tracy,1924,76,13,63,17.105263157894736,82.89473684210526,Unisex
Bernie,1924,118,29,89,24.57627118644068,75.42372881355932,Unisex
Ozzie,1924,20,12,8,60.0,40.0,Unisex
Carlyn,1924,28,21,7,75.0,25.0,Unisex
Luverne,1924,100,35,65,35.0,65.0,Unisex
Lindy,1924,12,6,6,50.0,50.0,Unisex
Oris,1924,56,10,46,17.857142857142858,82.14285714285714,Unisex
Berlie,1924,17,8,9,47.05882352941176,52.94117647058824,Unisex
Marcell,1924,36,14,22,38.88888888888889,61.11111111111112,Unisex
Odelle,1924,15,10,5,66.66666666666666,33.33333333333333,Unisex
Marlyn,1924,96,46,50,47.91666666666667,52.083333333333336,Unisex
Lupe,1924,475,377,98,79.36842105263158,20.63157894736842,Unisex
Marlowe,1924,17,7,10,41.17647058823529,58.82352941176471,Unisex
Marrion,1924,21,10,11,47.61904761904761,52.38095238095239,Unisex
Atlas,1924,20,5,15,25.0,75.0,Unisex
Paris,1924,45,9,36,20.0,80.0,Unisex
Paige,1924,16,5,11,31.25,68.75,Unisex
Ellie,1924,113,87,26,76.99115044247787,23.00884955752212,Unisex
Zelmer,1924,11,6,5,54.54545454545454,45.45454545454545,Unisex
Donnetta,1925,5,5,0,100.0,0.0,Female
Sinia,1925,5,5,0,100.0,0.0,Female
Mercy,1925,35,35,0,100.0,0.0,Female
Honore,1925,5,5,0,100.0,0.0,Female
Victorine,1925,15,15,0,100.0,0.0,Female
Bama,1925,9,9,0,100.0,0.0,Female
Loveda,1925,6,6,0,100.0,0.0,Female
Emelyn,1925,7,7,0,100.0,0.0,Female
Cheryle,1925,5,5,0,100.0,0.0,Female
Ovida,1925,6,6,0,100.0,0.0,Female
Johnye,1925,8,8,0,100.0,0.0,Female
Rufina,1925,23,23,0,100.0,0.0,Female
Alys,1925,13,13,0,100.0,0.0,Female
Bulah,1925,95,95,0,100.0,0.0,Female
Therma,1925,7,7,0,100.0,0.0,Female
Wava,1925,55,55,0,100.0,0.0,Female
Joline,1925,18,18,0,100.0,0.0,Female
Saramae,1925,8,8,0,100.0,0.0,Female
Evalee,1925,21,21,0,100.0,0.0,Female
Genella,1925,13,13,0,100.0,0.0,Female
Thresa,1925,26,26,0,100.0,0.0,Female
Belva,1925,147,147,0,100.0,0.0,Female
Eunie,1925,5,5,0,100.0,0.0,Female
Imogene,1925,1257,1248,9,99.28400954653938,0.7159904534606205,Female
Inza,1925,11,11,0,100.0,0.0,Female
Sarah,1925,4709,4685,24,99.490337651306,0.5096623486939902,Female
Lucill,1925,8,8,0,100.0,0.0,Female
Ortha,1925,14,14,0,100.0,0.0,Female
Guyla,1925,5,5,0,100.0,0.0,Female
Marguerette,1925,11,11,0,100.0,0.0,Female
Neill,1925,20,0,20,0.0,100.0,Male
Hulan,1925,8,0,8,0.0,100.0,Male
Roscoe,1925,455,0,455,0.0,100.0,Male
Arles,1925,10,0,10,0.0,100.0,Male
Alvis,1925,94,12,82,12.76595744680851,87.2340425531915,Male
Magdaleno,1925,9,0,9,0.0,100.0,Male
Sammy,1925,170,13,157,7.647058823529412,92.3529411764706,Male
Curtis,1925,1541,21,1520,1.36275146009085,98.63724853990917,Male
Chris,1925,189,7,182,3.7037037037037033,96.29629629629628,Male
Blaine,1925,134,0,134,0.0,100.0,Male
Frank,1925,15427,99,15328,0.6417320282621378,99.35826797173786,Male
Vladimir,1925,10,0,10,0.0,100.0,Male
Dimas,1925,5,0,5,0.0,100.0,Male
Billy,1925,4333,126,4207,2.9079159935379644,97.09208400646204,Male
Walker,1925,108,5,103,4.62962962962963,95.37037037037037,Male
Ovie,1925,15,0,15,0.0,100.0,Male
Theophile,1925,7,0,7,0.0,100.0,Male
Tadao,1925,16,0,16,0.0,100.0,Male
Esequiel,1925,16,0,16,0.0,100.0,Male
Echol,1925,5,0,5,0.0,100.0,Male
Norvin,1925,17,0,17,0.0,100.0,Male
Burnham,1925,6,0,6,0.0,100.0,Male
Ewell,1925,51,0,51,0.0,100.0,Male
Ander,1925,7,0,7,0.0,100.0,Male
Stacey,1925,11,0,11,0.0,100.0,Male
Sloan,1925,7,0,7,0.0,100.0,Male
Harlan,1925,477,7,470,1.4675052410901468,98.53249475890983,Male
Arther,1925,119,0,119,0.0,100.0,Male
Justice,1925,12,0,12,0.0,100.0,Male
Herschel,1925,208,0,208,0.0,100.0,Male
Valentine,1925,136,30,106,22.058823529411764,77.94117647058823,Unisex
Jacky,1925,12,5,7,41.66666666666667,58.333333333333336,Unisex
Norah,1925,31,23,8,74.19354838709677,25.806451612903224,Unisex
Terry,1925,338,148,190,43.78698224852072,56.213017751479285,Unisex
Ollie,1925,1137,824,313,72.47141600703605,27.52858399296393,Unisex
Elba,1925,38,20,18,52.63157894736842,47.368421052631575,Unisex
Algie,1925,47,16,31,34.04255319148936,65.95744680851064,Unisex
Vannie,1925,22,14,8,63.63636363636363,36.36363636363637,Unisex
Loys,1925,15,7,8,46.66666666666666,53.333333333333336,Unisex
Dossie,1925,31,19,12,61.29032258064516,38.70967741935484,Unisex
Von,1925,29,6,23,20.6896551724138,79.3103448275862,Unisex
Ruther,1925,25,19,6,76.0,24.0,Unisex
Sandy,1925,88,16,72,18.181818181818183,81.81818181818183,Unisex
Rene,1925,213,35,178,16.431924882629108,83.56807511737088,Unisex
Dene,1925,16,6,10,37.5,62.5,Unisex
Diamond,1925,16,9,7,56.25,43.75,Unisex
Arlyn,1925,40,14,26,35.0,65.0,Unisex
Richie,1925,10,5,5,50.0,50.0,Unisex
Osie,1925,46,34,12,73.91304347826086,26.08695652173913,Unisex
Vestal,1925,11,5,6,45.45454545454545,54.54545454545454,Unisex
Lacey,1925,23,8,15,34.78260869565217,65.21739130434783,Unisex
Cornell,1925,57,9,48,15.789473684210526,84.21052631578947,Unisex
Merle,1925,1240,404,836,32.58064516129032,67.41935483870968,Unisex
Joey,1925,19,8,11,42.10526315789473,57.89473684210527,Unisex
Tracy,1925,91,21,70,23.07692307692308,76.92307692307693,Unisex
Christy,1925,35,7,28,20.0,80.0,Unisex
Larue,1925,147,119,28,80.95238095238095,19.047619047619047,Unisex
Aldean,1925,19,13,6,68.42105263157895,31.57894736842105,Unisex
Burnice,1925,99,67,32,67.67676767676768,32.323232323232325,Unisex
Levon,1925,16,5,11,31.25,68.75,Unisex
Vonda,1926,64,64,0,100.0,0.0,Female
Zona,1926,93,93,0,100.0,0.0,Female
Valera,1926,23,23,0,100.0,0.0,Female
Oleen,1926,5,5,0,100.0,0.0,Female
Elizebeth,1926,91,91,0,100.0,0.0,Female
Audrienne,1926,6,6,0,100.0,0.0,Female
Evelynne,1926,20,20,0,100.0,0.0,Female
Rebie,1926,8,8,0,100.0,0.0,Female
Roberta,1926,1889,1877,12,99.36474325039704,0.6352567496029645,Female
Saddie,1926,17,17,0,100.0,0.0,Female
Gearldene,1926,6,6,0,100.0,0.0,Female
Etha,1926,38,38,0,100.0,0.0,Female
Birda,1926,7,7,0,100.0,0.0,Female
Marles,1926,8,8,0,100.0,0.0,Female
Orlena,1926,9,9,0,100.0,0.0,Female
Onedia,1926,5,5,0,100.0,0.0,Female
Erna,1926,182,182,0,100.0,0.0,Female
Jonelle,1926,6,6,0,100.0,0.0,Female
Morene,1926,10,10,0,100.0,0.0,Female
Lovelle,1926,9,9,0,100.0,0.0,Female
Bella,1926,106,106,0,100.0,0.0,Female
Shirlene,1926,16,16,0,100.0,0.0,Female
Eupha,1926,6,6,0,100.0,0.0,Female
Velvie,1926,8,8,0,100.0,0.0,Female
Luddie,1926,6,6,0,100.0,0.0,Female
Dalia,1926,17,17,0,100.0,0.0,Female
Beatryce,1926,8,8,0,100.0,0.0,Female
Oletha,1926,38,38,0,100.0,0.0,Female
Sybilla,1926,5,5,0,100.0,0.0,Female
Venia,1926,11,11,0,100.0,0.0,Female
Ervil,1926,6,0,6,0.0,100.0,Male
Zenon,1926,12,0,12,0.0,100.0,Male
Phelps,1926,5,0,5,0.0,100.0,Male
Heywood,1926,6,0,6,0.0,100.0,Male
Solomon,1926,214,0,214,0.0,100.0,Male
Delphin,1926,9,0,9,0.0,100.0,Male
Amedee,1926,5,0,5,0.0,100.0,Male
Devon,1926,39,5,34,12.82051282051282,87.17948717948718,Male
Evans,1926,70,0,70,0.0,100.0,Male
Major,1926,147,0,147,0.0,100.0,Male
Cabell,1926,6,0,6,0.0,100.0,Male
Archie,1926,952,32,920,3.361344537815126,96.63865546218489,Male
Dock,1926,97,0,97,0.0,100.0,Male
Mario,1926,525,7,518,1.3333333333333337,98.66666666666669,Male
Lenny,1926,6,0,6,0.0,100.0,Male
Simon,1926,286,0,286,0.0,100.0,Male
Darrell,1926,583,5,578,0.8576329331046313,99.14236706689536,Male
Berwick,1926,5,0,5,0.0,100.0,Male
Alston,1926,13,0,13,0.0,100.0,Male
Sampson,1926,29,0,29,0.0,100.0,Male
Ottavio,1926,5,0,5,0.0,100.0,Male
Sumpter,1926,6,0,6,0.0,100.0,Male
Berlin,1926,38,0,38,0.0,100.0,Male
Constantino,1926,16,0,16,0.0,100.0,Male
Atlee,1926,12,0,12,0.0,100.0,Male
Leavy,1926,8,0,8,0.0,100.0,Male
Kenneth,1926,10414,71,10343,0.6817745342807758,99.31822546571922,Male
Wally,1926,38,0,38,0.0,100.0,Male
Claudy,1926,11,0,11,0.0,100.0,Male
Herve,1926,12,0,12,0.0,100.0,Male
Lindell,1926,26,5,21,19.23076923076924,80.76923076923077,Unisex
Jene,1926,26,9,17,34.61538461538461,65.38461538461539,Unisex
La,1926,13,7,6,53.84615384615385,46.15384615384615,Unisex
Felice,1926,46,33,13,71.73913043478261,28.26086956521739,Unisex
Climmie,1926,18,11,7,61.11111111111112,38.88888888888889,Unisex
Ozie,1926,50,32,18,64.0,36.0,Unisex
Mearl,1926,44,10,34,22.727272727272727,77.27272727272727,Unisex
Diamond,1926,17,8,9,47.05882352941176,52.94117647058824,Unisex
Oda,1926,39,28,11,71.7948717948718,28.205128205128204,Unisex
Earlie,1926,68,26,42,38.23529411764706,61.76470588235294,Unisex
Cleophus,1926,44,7,37,15.909090909090908,84.0909090909091,Unisex
Early,1926,91,15,76,16.483516483516482,83.51648351648352,Unisex
Levern,1926,46,12,34,26.08695652173913,73.91304347826086,Unisex
Levon,1926,21,8,13,38.095238095238095,61.90476190476191,Unisex
Jule,1926,61,33,28,54.09836065573771,45.90163934426229,Unisex
Dennie,1926,45,11,34,24.444444444444443,75.55555555555556,Unisex
Arvis,1926,24,8,16,33.33333333333333,66.66666666666666,Unisex
Gayle,1926,166,98,68,59.036144578313255,40.963855421686745,Unisex
Jeffie,1926,45,29,16,64.44444444444444,35.55555555555556,Unisex
Guadalupe,1926,601,383,218,63.727121464226286,36.272878535773714,Unisex
Precious,1926,26,20,6,76.92307692307693,23.07692307692308,Unisex
Arlyn,1926,42,15,27,35.714285714285715,64.28571428571429,Unisex
Cordie,1926,36,30,6,83.33333333333334,16.666666666666664,Unisex
Shellie,1926,35,10,25,28.57142857142857,71.42857142857143,Unisex
Shelly,1926,31,5,26,16.129032258064516,83.87096774193549,Unisex
Delaine,1926,16,11,5,68.75,31.25,Unisex
Lynn,1926,462,92,370,19.913419913419915,80.08658008658008,Unisex
Ovie,1926,17,5,12,29.411764705882355,70.58823529411765,Unisex
Hiawatha,1926,27,11,16,40.74074074074074,59.25925925925925,Unisex
Burnett,1926,31,6,25,19.35483870967742,80.64516129032258,Unisex
Jannie,1927,256,256,0,100.0,0.0,Female
Tassie,1927,11,11,0,100.0,0.0,Female
Larena,1927,6,6,0,100.0,0.0,Female
Lema,1927,9,9,0,100.0,0.0,Female
Marvyl,1927,5,5,0,100.0,0.0,Female
Rachelle,1927,8,8,0,100.0,0.0,Female
Ophelia,1927,316,311,5,98.41772151898736,1.5822784810126582,Female
Loletta,1927,5,5,0,100.0,0.0,Female
Annemarie,1927,11,11,0,100.0,0.0,Female
Trina,1927,9,9,0,100.0,0.0,Female
Chrystelle,1927,5,5,0,100.0,0.0,Female
Orchid,1927,7,7,0,100.0,0.0,Female
Nilah,1927,7,7,0,100.0,0.0,Female
Noma,1927,45,45,0,100.0,0.0,Female
Belia,1927,37,37,0,100.0,0.0,Female
Lucinda,1927,139,139,0,100.0,0.0,Female
Lois,1927,10587,10505,82,99.22546519316144,0.7745348068385757,Female
Coretta,1927,7,7,0,100.0,0.0,Female
Pia,1927,5,5,0,100.0,0.0,Female
Pearlena,1927,8,8,0,100.0,0.0,Female
Refujia,1927,6,6,0,100.0,0.0,Female
Lauree,1927,8,8,0,100.0,0.0,Female
Alder,1927,5,5,0,100.0,0.0,Female
Glory,1927,19,19,0,100.0,0.0,Female
Florita,1927,15,15,0,100.0,0.0,Female
Necia,1927,6,6,0,100.0,0.0,Female
Adrienne,1927,137,137,0,100.0,0.0,Female
Florina,1927,8,8,0,100.0,0.0,Female
May,1927,755,744,11,98.54304635761588,1.456953642384106,Female
Metha,1927,5,5,0,100.0,0.0,Female
Lasaro,1927,7,0,7,0.0,100.0,Male
Giuseppe,1927,10,0,10,0.0,100.0,Male
Hadley,1927,25,0,25,0.0,100.0,Male
Larwence,1927,9,0,9,0.0,100.0,Male
Gorge,1927,15,0,15,0.0,100.0,Male
Fredick,1927,8,0,8,0.0,100.0,Male
Robertson,1927,6,0,6,0.0,100.0,Male
Corwin,1927,19,0,19,0.0,100.0,Male
Filemon,1927,10,0,10,0.0,100.0,Male
Leanord,1927,14,0,14,0.0,100.0,Male
Erick,1927,16,0,16,0.0,100.0,Male
Rice,1927,7,0,7,0.0,100.0,Male
Starlin,1927,5,0,5,0.0,100.0,Male
Aloys,1927,14,0,14,0.0,100.0,Male
Alvaro,1927,28,0,28,0.0,100.0,Male
Cole,1927,10,0,10,0.0,100.0,Male
Sampson,1927,39,0,39,0.0,100.0,Male
Merritt,1927,83,0,83,0.0,100.0,Male
Powell,1927,15,0,15,0.0,100.0,Male
Hosea,1927,72,5,67,6.944444444444445,93.05555555555556,Male
Hall,1927,23,0,23,0.0,100.0,Male
Alvan,1927,53,0,53,0.0,100.0,Male
Linsey,1927,9,0,9,0.0,100.0,Male
Nathan,1927,643,7,636,1.088646967340591,98.9113530326594,Male
Ransom,1927,38,0,38,0.0,100.0,Male
Denver,1927,199,5,194,2.512562814070352,97.48743718592964,Male
Kermitt,1927,5,0,5,0.0,100.0,Male
Hersel,1927,8,0,8,0.0,100.0,Male
Talbert,1927,15,0,15,0.0,100.0,Male
Berkley,1927,21,0,21,0.0,100.0,Male
Montie,1927,29,14,15,48.27586206896552,51.72413793103448,Unisex
Byrl,1927,19,5,14,26.31578947368421,73.68421052631578,Unisex
Neville,1927,33,7,26,21.21212121212121,78.78787878787878,Unisex
Merced,1927,21,9,12,42.85714285714285,57.14285714285714,Unisex
Ricky,1927,11,5,6,45.45454545454545,54.54545454545454,Unisex
Deryl,1927,17,5,12,29.411764705882355,70.58823529411765,Unisex
Donnell,1927,29,5,24,17.24137931034483,82.75862068965517,Unisex
Carry,1927,18,13,5,72.22222222222221,27.77777777777778,Unisex
Loye,1927,19,6,13,31.57894736842105,68.42105263157895,Unisex
Marcy,1927,25,20,5,80.0,20.0,Unisex
Rennie,1927,20,11,9,55.00000000000001,45.0,Unisex
Tracy,1927,96,16,80,16.666666666666664,83.33333333333334,Unisex
Holly,1927,46,25,21,54.34782608695652,45.65217391304348,Unisex
Afton,1927,49,35,14,71.42857142857143,28.57142857142857,Unisex
Venice,1927,35,24,11,68.57142857142857,31.428571428571427,Unisex
Romie,1927,28,5,23,17.857142857142858,82.14285714285714,Unisex
Myrl,1927,79,54,25,68.35443037974683,31.64556962025317,Unisex
Arnie,1927,25,5,20,20.0,80.0,Unisex
Loris,1927,48,35,13,72.91666666666666,27.08333333333333,Unisex
Bethel,1927,117,99,18,84.61538461538461,15.384615384615383,Unisex
Darris,1927,11,6,5,54.54545454545454,45.45454545454545,Unisex
Ether,1927,49,41,8,83.6734693877551,16.3265306122449,Unisex
Kellie,1927,15,5,10,33.33333333333333,66.66666666666666,Unisex
Toby,1927,58,25,33,43.103448275862064,56.896551724137936,Unisex
Murel,1927,25,8,17,32.0,68.0,Unisex
Cary,1927,74,19,55,25.67567567567568,74.32432432432432,Unisex
Estle,1927,24,5,19,20.833333333333336,79.16666666666666,Unisex
Mercer,1927,13,6,7,46.15384615384615,53.84615384615385,Unisex
Lucky,1927,32,6,26,18.75,81.25,Unisex
Mel,1927,30,6,24,20.0,80.0,Unisex
Corine,1928,266,266,0,100.0,0.0,Female
Petra,1928,189,182,7,96.29629629629628,3.7037037037037033,Female
Ona,1928,113,113,0,100.0,0.0,Female
Huldah,1928,11,11,0,100.0,0.0,Female
Donia,1928,11,11,0,100.0,0.0,Female
Jacklyn,1928,28,28,0,100.0,0.0,Female
Winefred,1928,10,10,0,100.0,0.0,Female
Denice,1928,5,5,0,100.0,0.0,Female
Janis,1928,199,194,5,97.48743718592964,2.512562814070352,Female
Bianca,1928,15,15,0,100.0,0.0,Female
Marilynn,1928,101,101,0,100.0,0.0,Female
Susie,1928,1063,1051,12,98.87111947318908,1.1288805268109126,Female
Donata,1928,8,8,0,100.0,0.0,Female
Jeanene,1928,6,6,0,100.0,0.0,Female
Loda,1928,6,6,0,100.0,0.0,Female
Dela,1928,8,8,0,100.0,0.0,Female
Dorisann,1928,5,5,0,100.0,0.0,Female
Adella,1928,81,81,0,100.0,0.0,Female
Vinie,1928,7,7,0,100.0,0.0,Female
Inez,1928,1391,1370,21,98.490294751977,1.509705248023005,Female
Melida,1928,6,6,0,100.0,0.0,Female
Sallye,1928,24,24,0,100.0,0.0,Female
Shirle,1928,7,7,0,100.0,0.0,Female
Neysa,1928,8,8,0,100.0,0.0,Female
Anamae,1928,7,7,0,100.0,0.0,Female
Glory,1928,25,25,0,100.0,0.0,Female
Edith,1928,4861,4846,15,99.69142151820614,0.3085784817938696,Female
Lorella,1928,11,11,0,100.0,0.0,Female
Evangeline,1928,227,227,0,100.0,0.0,Female
Florrie,1928,32,32,0,100.0,0.0,Female
Reino,1928,13,0,13,0.0,100.0,Male
Smiley,1928,7,0,7,0.0,100.0,Male
Arnet,1928,6,0,6,0.0,100.0,Male
Armin,1928,39,0,39,0.0,100.0,Male
Coit,1928,7,0,7,0.0,100.0,Male
Gill,1928,10,0,10,0.0,100.0,Male
Metro,1928,15,0,15,0.0,100.0,Male
Lucky,1928,22,0,22,0.0,100.0,Male
Alver,1928,6,0,6,0.0,100.0,Male
Ewel,1928,5,0,5,0.0,100.0,Male
Flavius,1928,5,0,5,0.0,100.0,Male
Thadeus,1928,11,0,11,0.0,100.0,Male
Kirkland,1928,7,0,7,0.0,100.0,Male
Donnell,1928,37,5,32,13.513513513513514,86.48648648648648,Male
Cornelio,1928,12,0,12,0.0,100.0,Male
Malvern,1928,6,0,6,0.0,100.0,Male
Levaughn,1928,5,0,5,0.0,100.0,Male
Earvin,1928,12,0,12,0.0,100.0,Male
Socrates,1928,9,0,9,0.0,100.0,Male
Alexis,1928,8,0,8,0.0,100.0,Male
Layman,1928,5,0,5,0.0,100.0,Male
Ezra,1928,117,0,117,0.0,100.0,Male
Rino,1928,5,0,5,0.0,100.0,Male
Fiore,1928,15,0,15,0.0,100.0,Male
Gavin,1928,13,0,13,0.0,100.0,Male
Luigi,1928,29,0,29,0.0,100.0,Male
Osborne,1928,26,0,26,0.0,100.0,Male
Kevin,1928,68,0,68,0.0,100.0,Male
Cesar,1928,16,0,16,0.0,100.0,Male
Lasaro,1928,5,0,5,0.0,100.0,Male
Eddie,1928,2160,353,1807,16.34259259259259,83.6574074074074,Unisex
Ferrell,1928,37,6,31,16.216216216216218,83.78378378378379,Unisex
Ozell,1928,55,26,29,47.27272727272727,52.72727272727272,Unisex
Orange,1928,20,7,13,35.0,65.0,Unisex
Marzell,1928,12,7,5,58.333333333333336,41.66666666666667,Unisex
Ladell,1928,12,6,6,50.0,50.0,Unisex
Reyes,1928,58,10,48,17.24137931034483,82.75862068965517,Unisex
Lynne,1928,30,24,6,80.0,20.0,Unisex
Clare,1928,309,231,78,74.75728155339806,25.24271844660194,Unisex
Rickey,1928,12,5,7,41.66666666666667,58.333333333333336,Unisex
Othel,1928,30,5,25,16.666666666666664,83.33333333333334,Unisex
Ardell,1928,123,69,54,56.09756097560976,43.90243902439025,Unisex
Little,1928,24,6,18,25.0,75.0,Unisex
Vivan,1928,11,6,5,54.54545454545454,45.45454545454545,Unisex
Arlis,1928,67,26,41,38.80597014925373,61.19402985074627,Unisex
Cleo,1928,847,606,241,71.54663518299881,28.45336481700118,Unisex
Claudie,1928,143,80,63,55.94405594405595,44.05594405594406,Unisex
Cornie,1928,14,7,7,50.0,50.0,Unisex
Macy,1928,32,27,5,84.375,15.625,Unisex
Zell,1928,15,6,9,40.0,60.0,Unisex
Holly,1928,38,24,14,63.1578947368421,36.84210526315789,Unisex
Vernie,1928,134,84,50,62.68656716417911,37.3134328358209,Unisex
Bernell,1928,46,18,28,39.130434782608695,60.86956521739131,Unisex
Lennie,1928,84,63,21,75.0,25.0,Unisex
Nicky,1928,20,7,13,35.0,65.0,Unisex
Golden,1928,71,33,38,46.478873239436616,53.52112676056338,Unisex
Encarnacion,1928,35,9,26,25.71428571428571,74.28571428571429,Unisex
Cordell,1928,21,8,13,38.095238095238095,61.90476190476191,Unisex
Love,1928,27,11,16,40.74074074074074,59.25925925925925,Unisex
Ritchie,1928,13,6,7,46.15384615384615,53.84615384615385,Unisex
Clydel,1929,5,5,0,100.0,0.0,Female
Ardeth,1929,38,38,0,100.0,0.0,Female
Anetta,1929,7,7,0,100.0,0.0,Female
Iula,1929,8,8,0,100.0,0.0,Female
Fernanda,1929,10,10,0,100.0,0.0,Female
Solange,1929,7,7,0,100.0,0.0,Female
Gwendoline,1929,6,6,0,100.0,0.0,Female
Osceola,1929,5,5,0,100.0,0.0,Female
Irena,1929,18,18,0,100.0,0.0,Female
Versie,1929,52,52,0,100.0,0.0,Female
Lovella,1929,22,22,0,100.0,0.0,Female
Kazuko,1929,20,20,0,100.0,0.0,Female
Imo,1929,34,34,0,100.0,0.0,Female
Candy,1929,8,8,0,100.0,0.0,Female
Ione,1929,203,203,0,100.0,0.0,Female
Palma,1929,68,68,0,100.0,0.0,Female
Helene,1929,483,483,0,100.0,0.0,Female
Frances,1929,11187,11092,95,99.1508000357558,0.8491999642442121,Female
Donna,1929,5157,5140,17,99.6703509792515,0.3296490207484971,Female
Camilla,1929,125,125,0,100.0,0.0,Female
Carmita,1929,6,6,0,100.0,0.0,Female
Lanette,1929,5,5,0,100.0,0.0,Female
Omega,1929,27,27,0,100.0,0.0,Female
Bernice,1929,4641,4551,90,98.06076276664513,1.9392372333548804,Female
Ema,1929,25,25,0,100.0,0.0,Female
Masel,1929,5,5,0,100.0,0.0,Female
Simone,1929,29,29,0,100.0,0.0,Female
Agueda,1929,7,7,0,100.0,0.0,Female
Evelena,1929,18,18,0,100.0,0.0,Female
Armentha,1929,6,6,0,100.0,0.0,Female
Duel,1929,10,0,10,0.0,100.0,Male
Dock,1929,73,0,73,0.0,100.0,Male
Clairmont,1929,6,0,6,0.0,100.0,Male
Vern,1929,194,10,184,5.154639175257731,94.84536082474226,Male
Marlon,1929,28,0,28,0.0,100.0,Male
Hayward,1929,71,0,71,0.0,100.0,Male
Valentin,1929,28,0,28,0.0,100.0,Male
Emmett,1929,425,0,425,0.0,100.0,Male
Veldon,1929,6,0,6,0.0,100.0,Male
Dillon,1929,9,0,9,0.0,100.0,Male
Erich,1929,28,0,28,0.0,100.0,Male
Isaac,1929,585,0,585,0.0,100.0,Male
Aden,1929,11,0,11,0.0,100.0,Male
Aristeo,1929,9,0,9,0.0,100.0,Male
Claron,1929,8,0,8,0.0,100.0,Male
Olden,1929,12,0,12,0.0,100.0,Male
Karl,1929,644,7,637,1.0869565217391304,98.91304347826086,Male
Carr,1929,7,0,7,0.0,100.0,Male
Issac,1929,61,0,61,0.0,100.0,Male
Cephas,1929,9,0,9,0.0,100.0,Male
Lowry,1929,9,0,9,0.0,100.0,Male
Matias,1929,12,0,12,0.0,100.0,Male
Nephi,1929,5,0,5,0.0,100.0,Male
Ambers,1929,10,0,10,0.0,100.0,Male
Wendel,1929,23,0,23,0.0,100.0,Male
Nolan,1929,142,0,142,0.0,100.0,Male
Barton,1929,63,0,63,0.0,100.0,Male
Alejandro,1929,83,0,83,0.0,100.0,Male
Harlan,1929,354,0,354,0.0,100.0,Male
Omar,1929,69,6,63,8.695652173913043,91.30434782608695,Male
Garnett,1929,120,65,55,54.16666666666666,45.83333333333333,Unisex
Lennis,1929,34,17,17,50.0,50.0,Unisex
Ozell,1929,49,25,24,51.02040816326531,48.97959183673469,Unisex
Carmon,1929,33,6,27,18.181818181818183,81.81818181818183,Unisex
Loy,1929,88,16,72,18.181818181818183,81.81818181818183,Unisex
Arie,1929,46,23,23,50.0,50.0,Unisex
Onnie,1929,31,19,12,61.29032258064516,38.70967741935484,Unisex
Myrl,1929,74,46,28,62.16216216216216,37.83783783783784,Unisex
Lee,1929,2683,474,2209,17.666790905702573,82.33320909429743,Unisex
Arvis,1929,13,6,7,46.15384615384615,53.84615384615385,Unisex
Odell,1929,395,103,292,26.075949367088608,73.9240506329114,Unisex
Avon,1929,27,6,21,22.22222222222222,77.77777777777779,Unisex
Gennie,1929,46,39,7,84.78260869565217,15.217391304347828,Unisex
Ventura,1929,28,8,20,28.57142857142857,71.42857142857143,Unisex
Alvia,1929,21,7,14,33.33333333333333,66.66666666666666,Unisex
Val,1929,66,22,44,33.33333333333333,66.66666666666666,Unisex
Clemence,1929,27,10,17,37.03703703703704,62.96296296296296,Unisex
Burnice,1929,72,43,29,59.72222222222222,40.27777777777778,Unisex
Murl,1929,53,20,33,37.735849056603776,62.264150943396224,Unisex
Mallie,1929,40,28,12,70.0,30.0,Unisex
Robie,1929,20,10,10,50.0,50.0,Unisex
Ivor,1929,18,5,13,27.77777777777778,72.22222222222221,Unisex
Bunny,1929,29,24,5,82.75862068965517,17.24137931034483,Unisex
Burnie,1929,26,6,20,23.07692307692308,76.92307692307693,Unisex
Kaye,1929,28,15,13,53.57142857142857,46.42857142857143,Unisex
Sandy,1929,89,20,69,22.47191011235955,77.52808988764045,Unisex
Shannon,1929,35,20,15,57.14285714285714,42.85714285714285,Unisex
Virdell,1929,11,6,5,54.54545454545454,45.45454545454545,Unisex
Oral,1929,57,10,47,17.543859649122805,82.45614035087719,Unisex
Kay,1929,298,218,80,73.15436241610739,26.84563758389261,Unisex
Louretta,1930,6,6,0,100.0,0.0,Female
Morna,1930,8,8,0,100.0,0.0,Female
Perline,1930,8,8,0,100.0,0.0,Female
Odilia,1930,13,13,0,100.0,0.0,Female
Myla,1930,14,14,0,100.0,0.0,Female
Georgine,1930,41,41,0,100.0,0.0,Female
Cozetta,1930,6,6,0,100.0,0.0,Female
Marieta,1930,16,16,0,100.0,0.0,Female
Lorrene,1930,10,10,0,100.0,0.0,Female
Arva,1930,15,15,0,100.0,0.0,Female
Elmarie,1930,8,8,0,100.0,0.0,Female
Zilla,1930,7,7,0,100.0,0.0,Female
Emeline,1930,20,20,0,100.0,0.0,Female
Sunnie,1930,5,5,0,100.0,0.0,Female
Naomia,1930,34,34,0,100.0,0.0,Female
Coramae,1930,5,5,0,100.0,0.0,Female
Dolline,1930,6,6,0,100.0,0.0,Female
Palestine,1930,5,5,0,100.0,0.0,Female
Vee,1930,6,6,0,100.0,0.0,Female
Dorene,1930,76,76,0,100.0,0.0,Female
Verlene,1930,36,36,0,100.0,0.0,Female
Alfrieda,1930,16,16,0,100.0,0.0,Female
Pinkie,1930,51,51,0,100.0,0.0,Female
Irmalee,1930,5,5,0,100.0,0.0,Female
Francina,1930,15,15,0,100.0,0.0,Female
Jennifer,1930,17,17,0,100.0,0.0,Female
Romelle,1930,5,5,0,100.0,0.0,Female
Merlene,1930,42,42,0,100.0,0.0,Female
Margretta,1930,8,8,0,100.0,0.0,Female
Mossie,1930,18,18,0,100.0,0.0,Female
Thomes,1930,5,0,5,0.0,100.0,Male
Orris,1930,15,0,15,0.0,100.0,Male
Elton,1930,304,0,304,0.0,100.0,Male
Linzy,1930,8,0,8,0.0,100.0,Male
Merrell,1930,21,0,21,0.0,100.0,Male
Myrel,1930,5,0,5,0.0,100.0,Male
Gardiner,1930,6,0,6,0.0,100.0,Male
Donard,1930,5,0,5,0.0,100.0,Male
Hervey,1930,19,0,19,0.0,100.0,Male
Fitzhugh,1930,12,0,12,0.0,100.0,Male
Teruo,1930,12,0,12,0.0,100.0,Male
Elias,1930,177,5,172,2.824858757062147,97.17514124293784,Male
Huel,1930,10,0,10,0.0,100.0,Male
Nels,1930,26,0,26,0.0,100.0,Male
Neville,1930,26,0,26,0.0,100.0,Male
Milledge,1930,5,0,5,0.0,100.0,Male
Meade,1930,14,0,14,0.0,100.0,Male
Anton,1930,145,0,145,0.0,100.0,Male
Erhard,1930,7,0,7,0.0,100.0,Male
Teodoro,1930,33,0,33,0.0,100.0,Male
Melchor,1930,7,0,7,0.0,100.0,Male
Cleave,1930,7,0,7,0.0,100.0,Male
Lyell,1930,9,0,9,0.0,100.0,Male
Wilgus,1930,7,0,7,0.0,100.0,Male
Mason,1930,95,0,95,0.0,100.0,Male
Handy,1930,11,0,11,0.0,100.0,Male
Thornton,1930,47,0,47,0.0,100.0,Male
Baker,1930,6,0,6,0.0,100.0,Male
Lamont,1930,42,0,42,0.0,100.0,Male
Colen,1930,7,0,7,0.0,100.0,Male
Laurice,1930,38,28,10,73.68421052631578,26.31578947368421,Unisex
Rennie,1930,15,8,7,53.333333333333336,46.66666666666666,Unisex
Concepcion,1930,102,81,21,79.41176470588235,20.588235294117645,Unisex
Vonnie,1930,58,41,17,70.6896551724138,29.310344827586203,Unisex
Juel,1930,21,14,7,66.66666666666666,33.33333333333333,Unisex
Garnet,1930,136,106,30,77.94117647058823,22.058823529411764,Unisex
Adell,1930,131,102,29,77.86259541984732,22.13740458015268,Unisex
Loy,1930,104,18,86,17.307692307692307,82.6923076923077,Unisex
Sunny,1930,33,18,15,54.54545454545454,45.45454545454545,Unisex
Marvell,1930,19,12,7,63.1578947368421,36.84210526315789,Unisex
Garnett,1930,113,54,59,47.78761061946903,52.21238938053098,Unisex
Jody,1930,20,11,9,55.00000000000001,45.0,Unisex
Carrol,1930,237,46,191,19.40928270042194,80.59071729957806,Unisex
Cornie,1930,10,5,5,50.0,50.0,Unisex
Ammie,1930,30,25,5,83.33333333333334,16.666666666666664,Unisex
Robin,1930,121,50,71,41.32231404958678,58.67768595041323,Unisex
Carmello,1930,18,6,12,33.33333333333333,66.66666666666666,Unisex
Wm,1930,21,7,14,33.33333333333333,66.66666666666666,Unisex
Audie,1930,78,44,34,56.41025641025641,43.58974358974359,Unisex
Vollie,1930,15,5,10,33.33333333333333,66.66666666666666,Unisex
Arley,1930,44,8,36,18.181818181818183,81.81818181818183,Unisex
Johnnie,1930,2696,912,1784,33.82789317507419,66.17210682492582,Unisex
Arrie,1930,25,19,6,76.0,24.0,Unisex
Ivy,1930,145,94,51,64.82758620689654,35.172413793103445,Unisex
Delane,1930,12,5,7,41.66666666666667,58.333333333333336,Unisex
Hollie,1930,36,12,24,33.33333333333333,66.66666666666666,Unisex
Lavell,1930,24,9,15,37.5,62.5,Unisex
Ara,1930,24,16,8,66.66666666666666,33.33333333333333,Unisex
Ariel,1930,16,8,8,50.0,50.0,Unisex
Baby,1930,39,28,11,71.7948717948718,28.205128205128204,Unisex
Delilah,1931,53,53,0,100.0,0.0,Female
Sydell,1931,36,36,0,100.0,0.0,Female
Ofilia,1931,8,8,0,100.0,0.0,Female
Vlasta,1931,10,10,0,100.0,0.0,Female
Corinne,1931,383,383,0,100.0,0.0,Female
Marlyce,1931,17,17,0,100.0,0.0,Female
Amanda,1931,209,209,0,100.0,0.0,Female
Jerlean,1931,15,15,0,100.0,0.0,Female
Wylodine,1931,6,6,0,100.0,0.0,Female
Rilda,1931,8,8,0,100.0,0.0,Female
Clementine,1931,114,114,0,100.0,0.0,Female
Ellar,1931,7,7,0,100.0,0.0,Female
Eugenia,1931,331,331,0,100.0,0.0,Female
Michie,1931,5,5,0,100.0,0.0,Female
Lettie,1931,91,91,0,100.0,0.0,Female
Meriam,1931,21,21,0,100.0,0.0,Female
Doralene,1931,5,5,0,100.0,0.0,Female
Evah,1931,7,7,0,100.0,0.0,Female
Emmogene,1931,15,15,0,100.0,0.0,Female
Azalee,1931,25,25,0,100.0,0.0,Female
Sada,1931,5,5,0,100.0,0.0,Female
Margareta,1931,6,6,0,100.0,0.0,Female
Nathalia,1931,7,7,0,100.0,0.0,Female
Lourene,1931,9,9,0,100.0,0.0,Female
Audree,1931,18,18,0,100.0,0.0,Female
Francella,1931,5,5,0,100.0,0.0,Female
Janella,1931,9,9,0,100.0,0.0,Female
Lella,1931,11,11,0,100.0,0.0,Female
Syril,1931,5,5,0,100.0,0.0,Female
Maryjean,1931,7,7,0,100.0,0.0,Female
Ladon,1931,7,0,7,0.0,100.0,Male
Clynton,1931,5,0,5,0.0,100.0,Male
Brinton,1931,5,0,5,0.0,100.0,Male
Sim,1931,33,0,33,0.0,100.0,Male
Hisao,1931,7,0,7,0.0,100.0,Male
Haynes,1931,6,0,6,0.0,100.0,Male
Rafael,1931,189,0,189,0.0,100.0,Male
Hartsell,1931,5,0,5,0.0,100.0,Male
Jun,1931,5,0,5,0.0,100.0,Male
Corbin,1931,10,0,10,0.0,100.0,Male
Kelton,1931,10,0,10,0.0,100.0,Male
Phill,1931,5,0,5,0.0,100.0,Male
Hayward,1931,76,0,76,0.0,100.0,Male
Erven,1931,14,0,14,0.0,100.0,Male
Minoru,1931,18,0,18,0.0,100.0,Male
Doil,1931,7,0,7,0.0,100.0,Male
Uyless,1931,6,0,6,0.0,100.0,Male
Lemoine,1931,7,0,7,0.0,100.0,Male
Everitt,1931,9,0,9,0.0,100.0,Male
Roe,1931,19,0,19,0.0,100.0,Male
Marcelino,1931,56,0,56,0.0,100.0,Male
Myron,1931,686,6,680,0.8746355685131195,99.12536443148689,Male
Lasalle,1931,7,0,7,0.0,100.0,Male
Olie,1931,18,0,18,0.0,100.0,Male
Duanne,1931,5,0,5,0.0,100.0,Male
Dillon,1931,15,0,15,0.0,100.0,Male
Rollo,1931,22,0,22,0.0,100.0,Male
Pleas,1931,17,0,17,0.0,100.0,Male
Rainey,1931,5,0,5,0.0,100.0,Male
Regis,1931,85,5,80,5.88235294117647,94.11764705882352,Male
Jan,1931,153,104,49,67.97385620915033,32.02614379084967,Unisex
Vernal,1931,40,9,31,22.5,77.5,Unisex
Sydney,1931,116,41,75,35.3448275862069,64.65517241379311,Unisex
Lovell,1931,50,14,36,28.000000000000004,72.0,Unisex
Ezell,1931,60,11,49,18.33333333333333,81.66666666666667,Unisex
Oris,1931,36,6,30,16.666666666666664,83.33333333333334,Unisex
Del,1931,36,9,27,25.0,75.0,Unisex
Jule,1931,42,26,16,61.90476190476191,38.095238095238095,Unisex
Lavern,1931,355,104,251,29.295774647887324,70.70422535211267,Unisex
Ricky,1931,16,6,10,37.5,62.5,Unisex
Artie,1931,122,100,22,81.9672131147541,18.0327868852459,Unisex
Laurel,1931,161,127,34,78.88198757763976,21.11801242236025,Unisex
Carrol,1931,234,60,174,25.64102564102564,74.35897435897436,Unisex
Odean,1931,31,15,16,48.38709677419355,51.61290322580645,Unisex
Caroll,1931,31,12,19,38.70967741935484,61.29032258064516,Unisex
Donnis,1931,17,9,8,52.94117647058824,47.05882352941176,Unisex
Tomie,1931,27,9,18,33.33333333333333,66.66666666666666,Unisex
Hildred,1931,60,49,11,81.66666666666667,18.33333333333333,Unisex
Valjean,1931,20,10,10,50.0,50.0,Unisex
Frankie,1931,805,526,279,65.3416149068323,34.6583850931677,Unisex
Aquilla,1931,12,6,6,50.0,50.0,Unisex
Marty,1931,46,18,28,39.130434782608695,60.86956521739131,Unisex
Cloyce,1931,33,10,23,30.303030303030305,69.6969696969697,Unisex
Clare,1931,293,234,59,79.86348122866895,20.13651877133106,Unisex
Osie,1931,39,21,18,53.84615384615385,46.15384615384615,Unisex
Delma,1931,179,144,35,80.44692737430168,19.553072625698324,Unisex
Myrl,1931,48,28,20,58.333333333333336,41.66666666666667,Unisex
Ventura,1931,24,5,19,20.833333333333336,79.16666666666666,Unisex
Arie,1931,37,26,11,70.27027027027027,29.72972972972973,Unisex
Vernie,1931,105,61,44,58.0952380952381,41.90476190476191,Unisex
Nelle,1932,35,35,0,100.0,0.0,Female
Nadean,1932,37,37,0,100.0,0.0,Female
Teressa,1932,5,5,0,100.0,0.0,Female
Emmie,1932,55,55,0,100.0,0.0,Female
Florabelle,1932,5,5,0,100.0,0.0,Female
Norinne,1932,5,5,0,100.0,0.0,Female
Edrie,1932,10,10,0,100.0,0.0,Female
Henryetta,1932,14,14,0,100.0,0.0,Female
Merrilee,1932,15,15,0,100.0,0.0,Female
Audrienne,1932,5,5,0,100.0,0.0,Female
Lovina,1932,28,28,0,100.0,0.0,Female
Elberta,1932,30,30,0,100.0,0.0,Female
Julienne,1932,10,10,0,100.0,0.0,Female
Genetta,1932,6,6,0,100.0,0.0,Female
Cresencia,1932,6,6,0,100.0,0.0,Female
Faylene,1932,5,5,0,100.0,0.0,Female
Juna,1932,12,12,0,100.0,0.0,Female
Christal,1932,8,8,0,100.0,0.0,Female
Mira,1932,10,10,0,100.0,0.0,Female
Jerolene,1932,6,6,0,100.0,0.0,Female
Elizebeth,1932,49,49,0,100.0,0.0,Female
Clarissa,1932,51,51,0,100.0,0.0,Female
Thelda,1932,12,12,0,100.0,0.0,Female
Consuella,1932,9,9,0,100.0,0.0,Female
Suanne,1932,7,7,0,100.0,0.0,Female
Olean,1932,25,25,0,100.0,0.0,Female
Tresa,1932,16,16,0,100.0,0.0,Female
Bettylu,1932,6,6,0,100.0,0.0,Female
Lucia,1932,185,185,0,100.0,0.0,Female
Genoveva,1932,24,24,0,100.0,0.0,Female
Roby,1932,26,0,26,0.0,100.0,Male
Arvle,1932,6,0,6,0.0,100.0,Male
Brown,1932,24,0,24,0.0,100.0,Male
Cleve,1932,53,0,53,0.0,100.0,Male
Wilkins,1932,5,0,5,0.0,100.0,Male
Fleming,1932,13,0,13,0.0,100.0,Male
Cesar,1932,14,0,14,0.0,100.0,Male
Lucien,1932,73,0,73,0.0,100.0,Male
Theotis,1932,9,0,9,0.0,100.0,Male
Augustus,1932,149,0,149,0.0,100.0,Male
Ammon,1932,16,0,16,0.0,100.0,Male
Dicky,1932,14,0,14,0.0,100.0,Male
Bryce,1932,93,0,93,0.0,100.0,Male
Loy,1932,95,12,83,12.63157894736842,87.36842105263159,Male
Ogden,1932,11,0,11,0.0,100.0,Male
Sims,1932,10,0,10,0.0,100.0,Male
Plato,1932,8,0,8,0.0,100.0,Male
Horatio,1932,10,0,10,0.0,100.0,Male
Orson,1932,11,0,11,0.0,100.0,Male
Steve,1932,780,0,780,0.0,100.0,Male
Angel,1932,145,20,125,13.79310344827586,86.20689655172413,Male
Isidor,1932,9,0,9,0.0,100.0,Male
Tomas,1932,130,0,130,0.0,100.0,Male
Valerian,1932,10,0,10,0.0,100.0,Male
Lex,1932,16,0,16,0.0,100.0,Male
Wayne,1932,3414,26,3388,0.7615700058582308,99.23842999414175,Male
Terence,1932,74,0,74,0.0,100.0,Male
Alex,1932,688,5,683,0.7267441860465116,99.27325581395348,Male
Antonino,1932,7,0,7,0.0,100.0,Male
Sebastian,1932,87,0,87,0.0,100.0,Male
Cloyce,1932,25,6,19,24.0,76.0,Unisex
Velmer,1932,13,6,7,46.15384615384615,53.84615384615385,Unisex
Rue,1932,18,8,10,44.44444444444444,55.55555555555556,Unisex
Marice,1932,12,6,6,50.0,50.0,Unisex
Elgie,1932,31,16,15,51.61290322580645,48.38709677419355,Unisex
Lorenza,1932,84,32,52,38.095238095238095,61.90476190476191,Unisex
Glynn,1932,76,15,61,19.73684210526316,80.26315789473685,Unisex
Texas,1932,11,6,5,54.54545454545454,45.45454545454545,Unisex
Estle,1932,19,5,14,26.31578947368421,73.68421052631578,Unisex
Johnie,1932,519,104,415,20.03853564547206,79.96146435452793,Unisex
Lauris,1932,12,6,6,50.0,50.0,Unisex
Laurel,1932,168,119,49,70.83333333333334,29.166666666666668,Unisex
Ellie,1932,54,35,19,64.81481481481481,35.18518518518518,Unisex
Val,1932,91,22,69,24.17582417582417,75.82417582417582,Unisex
Caroll,1932,38,16,22,42.10526315789473,57.89473684210527,Unisex
Laverne,1932,1293,927,366,71.6937354988399,28.306264501160094,Unisex
Elgin,1932,37,7,30,18.91891891891892,81.08108108108108,Unisex
Pink,1932,12,5,7,41.66666666666667,58.333333333333336,Unisex
Brownie,1932,30,17,13,56.66666666666666,43.333333333333336,Unisex
Aster,1932,14,8,6,57.14285714285714,42.85714285714285,Unisex
Ammie,1932,29,24,5,82.75862068965517,17.24137931034483,Unisex
Ludie,1932,40,34,6,85.0,15.0,Unisex
Vernel,1932,13,5,8,38.46153846153847,61.53846153846154,Unisex
Mackie,1932,29,13,16,44.82758620689656,55.172413793103445,Unisex
Carrol,1932,228,68,160,29.82456140350877,70.17543859649122,Unisex
Donie,1932,18,12,6,66.66666666666666,33.33333333333333,Unisex
Marion,1932,4808,3493,1315,72.64975041597339,27.35024958402662,Unisex
Rene,1932,216,35,181,16.203703703703702,83.79629629629629,Unisex
America,1932,21,16,5,76.19047619047619,23.809523809523807,Unisex
Nance,1932,28,23,5,82.14285714285714,17.857142857142858,Unisex
Modine,1933,6,6,0,100.0,0.0,Female
Solange,1933,8,8,0,100.0,0.0,Female
Henryetta,1933,8,8,0,100.0,0.0,Female
Kathleene,1933,5,5,0,100.0,0.0,Female
Nelwyn,1933,16,16,0,100.0,0.0,Female
Mariette,1933,22,22,0,100.0,0.0,Female
Deloras,1933,27,27,0,100.0,0.0,Female
Barnetta,1933,5,5,0,100.0,0.0,Female
Minta,1933,6,6,0,100.0,0.0,Female
Sharleen,1933,42,42,0,100.0,0.0,Female
Vernetta,1933,28,28,0,100.0,0.0,Female
Charlotte,1933,3128,3114,14,99.55242966751918,0.4475703324808184,Female
Maebelle,1933,17,17,0,100.0,0.0,Female
Freida,1933,147,147,0,100.0,0.0,Female
Evanell,1933,7,7,0,100.0,0.0,Female
Faustine,1933,10,10,0,100.0,0.0,Female
Fonda,1933,20,20,0,100.0,0.0,Female
Deborah,1933,242,242,0,100.0,0.0,Female
Gearline,1933,7,7,0,100.0,0.0,Female
Annamarie,1933,30,30,0,100.0,0.0,Female
Yvetta,1933,6,6,0,100.0,0.0,Female
Burnestine,1933,5,5,0,100.0,0.0,Female
Polly,1933,372,372,0,100.0,0.0,Female
Gailya,1933,7,7,0,100.0,0.0,Female
Girtha,1933,17,17,0,100.0,0.0,Female
Jean,1933,10170,9966,204,97.99410029498526,2.005899705014749,Female
Remona,1933,32,32,0,100.0,0.0,Female
Cherry,1933,83,78,5,93.97590361445783,6.024096385542169,Female
Sharla,1933,5,5,0,100.0,0.0,Female
Anastasia,1933,46,46,0,100.0,0.0,Female
Pietro,1933,6,0,6,0.0,100.0,Male
Cloyse,1933,8,0,8,0.0,100.0,Male
Luther,1933,886,8,878,0.9029345372460496,99.09706546275396,Male
Aurther,1933,8,0,8,0.0,100.0,Male
Davis,1933,104,8,96,7.6923076923076925,92.3076923076923,Male
Serapio,1933,6,0,6,0.0,100.0,Male
Fuller,1933,11,0,11,0.0,100.0,Male
Cole,1933,10,0,10,0.0,100.0,Male
Owens,1933,16,0,16,0.0,100.0,Male
Maximino,1933,5,0,5,0.0,100.0,Male
Carmine,1933,136,0,136,0.0,100.0,Male
Doran,1933,20,0,20,0.0,100.0,Male
Lewie,1933,15,0,15,0.0,100.0,Male
Tod,1933,9,0,9,0.0,100.0,Male
Henri,1933,24,0,24,0.0,100.0,Male
Barnie,1933,8,0,8,0.0,100.0,Male
Buford,1933,169,0,169,0.0,100.0,Male
Erskine,1933,15,0,15,0.0,100.0,Male
Ansel,1933,31,0,31,0.0,100.0,Male
Corbett,1933,14,0,14,0.0,100.0,Male
Maury,1933,20,0,20,0.0,100.0,Male
Romain,1933,7,0,7,0.0,100.0,Male
Arwin,1933,5,0,5,0.0,100.0,Male
Calvin,1933,1500,11,1489,0.7333333333333333,99.26666666666668,Male
Hubert,1933,936,7,929,0.7478632478632479,99.25213675213676,Male
Quintin,1933,13,0,13,0.0,100.0,Male
Marcus,1933,239,0,239,0.0,100.0,Male
Reynaldo,1933,75,0,75,0.0,100.0,Male
Bartholomew,1933,20,0,20,0.0,100.0,Male
Dencil,1933,8,0,8,0.0,100.0,Male
Marlon,1933,31,5,26,16.129032258064516,83.87096774193549,Unisex
Kaye,1933,102,66,36,64.70588235294117,35.294117647058826,Unisex
Llewellyn,1933,51,8,43,15.68627450980392,84.31372549019608,Unisex
Hildred,1933,48,39,9,81.25,18.75,Unisex
Rosario,1933,95,24,71,25.26315789473684,74.73684210526315,Unisex
Levern,1933,31,5,26,16.129032258064516,83.87096774193549,Unisex
Brownie,1933,24,18,6,75.0,25.0,Unisex
Johnnie,1933,2340,879,1461,37.56410256410256,62.43589743589744,Unisex
Farris,1933,53,10,43,18.867924528301888,81.13207547169812,Unisex
Orie,1933,28,8,20,28.57142857142857,71.42857142857143,Unisex
Ivey,1933,37,14,23,37.83783783783784,62.16216216216216,Unisex
Dee,1933,161,62,99,38.50931677018634,61.49068322981367,Unisex
Delma,1933,200,167,33,83.5,16.5,Unisex
Adair,1933,10,5,5,50.0,50.0,Unisex
Arnell,1933,21,10,11,47.61904761904761,52.38095238095239,Unisex
Holly,1933,42,25,17,59.523809523809526,40.47619047619048,Unisex
Robie,1933,14,5,9,35.714285714285715,64.28571428571429,Unisex
Silver,1933,10,5,5,50.0,50.0,Unisex
Dorris,1933,178,137,41,76.96629213483146,23.03370786516854,Unisex
Hollie,1933,34,12,22,35.294117647058826,64.70588235294117,Unisex
Dana,1933,242,108,134,44.62809917355372,55.371900826446286,Unisex
Sammie,1933,434,134,300,30.87557603686636,69.12442396313364,Unisex
Laurie,1933,71,41,30,57.74647887323944,42.25352112676056,Unisex
Sandy,1933,106,31,75,29.245283018867923,70.75471698113208,Unisex
Burnie,1933,18,7,11,38.88888888888889,61.11111111111112,Unisex
Oree,1933,12,5,7,41.66666666666667,58.333333333333336,Unisex
Dariel,1933,13,6,7,46.15384615384615,53.84615384615385,Unisex
Loye,1933,24,7,17,29.166666666666668,70.83333333333334,Unisex
Ara,1933,27,18,9,66.66666666666666,33.33333333333333,Unisex
Lavone,1933,31,25,6,80.64516129032258,19.35483870967742,Unisex
Carollee,1934,12,12,0,100.0,0.0,Female
Evadene,1934,5,5,0,100.0,0.0,Female
Raelene,1934,5,5,0,100.0,0.0,Female
Fonda,1934,12,12,0,100.0,0.0,Female
Refugia,1934,20,20,0,100.0,0.0,Female
Jaci,1934,5,5,0,100.0,0.0,Female
Karma,1934,18,18,0,100.0,0.0,Female
Alfretta,1934,7,7,0,100.0,0.0,Female
Rhea,1934,110,104,6,94.54545454545456,5.454545454545454,Female
Valaria,1934,5,5,0,100.0,0.0,Female
Carolynn,1934,37,37,0,100.0,0.0,Female
Ilene,1934,223,223,0,100.0,0.0,Female
Aileene,1934,6,6,0,100.0,0.0,Female
Adelina,1934,50,50,0,100.0,0.0,Female
Luretha,1934,5,5,0,100.0,0.0,Female
Lida,1934,54,54,0,100.0,0.0,Female
Lyda,1934,41,41,0,100.0,0.0,Female
Lucindia,1934,6,6,0,100.0,0.0,Female
Dorothe,1934,6,6,0,100.0,0.0,Female
Nesta,1934,9,9,0,100.0,0.0,Female
Pernie,1934,5,5,0,100.0,0.0,Female
Earnstine,1934,6,6,0,100.0,0.0,Female
Ardys,1934,23,23,0,100.0,0.0,Female
Junita,1934,29,29,0,100.0,0.0,Female
Olivia,1934,359,359,0,100.0,0.0,Female
Clarinda,1934,8,8,0,100.0,0.0,Female
Madlyn,1934,13,13,0,100.0,0.0,Female
Claramae,1934,7,7,0,100.0,0.0,Female
Madora,1934,8,8,0,100.0,0.0,Female
Sylvania,1934,7,7,0,100.0,0.0,Female
Pedro,1934,363,0,363,0.0,100.0,Male
Guido,1934,34,0,34,0.0,100.0,Male
Eldridge,1934,60,0,60,0.0,100.0,Male
Harlow,1934,36,0,36,0.0,100.0,Male
Clayborn,1934,11,0,11,0.0,100.0,Male
Lalo,1934,6,0,6,0.0,100.0,Male
Estill,1934,17,0,17,0.0,100.0,Male
Gaither,1934,11,0,11,0.0,100.0,Male
Manning,1934,15,0,15,0.0,100.0,Male
Bud,1934,162,0,162,0.0,100.0,Male
Harvest,1934,5,0,5,0.0,100.0,Male
Onofre,1934,8,0,8,0.0,100.0,Male
Paulo,1934,18,0,18,0.0,100.0,Male
Glade,1934,13,0,13,0.0,100.0,Male
Kee,1934,21,0,21,0.0,100.0,Male
Aruther,1934,5,0,5,0.0,100.0,Male
Haskel,1934,18,0,18,0.0,100.0,Male
Major,1934,95,0,95,0.0,100.0,Male
Aloysius,1934,63,0,63,0.0,100.0,Male
Otho,1934,44,0,44,0.0,100.0,Male
Linford,1934,11,0,11,0.0,100.0,Male
Wilbur,1934,927,6,921,0.6472491909385114,99.35275080906148,Male
Tomie,1934,14,0,14,0.0,100.0,Male
Raphael,1934,59,0,59,0.0,100.0,Male
Melton,1934,63,0,63,0.0,100.0,Male
Ulysee,1934,13,0,13,0.0,100.0,Male
Roddy,1934,22,0,22,0.0,100.0,Male
Niel,1934,13,0,13,0.0,100.0,Male
Delaney,1934,6,0,6,0.0,100.0,Male
Gray,1934,19,0,19,0.0,100.0,Male
Ariel,1934,13,6,7,46.15384615384615,53.84615384615385,Unisex
El,1934,10,5,5,50.0,50.0,Unisex
Fayette,1934,13,6,7,46.15384615384615,53.84615384615385,Unisex
Kim,1934,40,16,24,40.0,60.0,Unisex
Dois,1934,14,9,5,64.28571428571429,35.714285714285715,Unisex
Orva,1934,15,9,6,60.0,40.0,Unisex
Luverne,1934,44,17,27,38.63636363636363,61.36363636363637,Unisex
Beryl,1934,204,146,58,71.56862745098039,28.431372549019606,Unisex
Dene,1934,13,7,6,53.84615384615385,46.15384615384615,Unisex
Laurie,1934,116,71,45,61.206896551724135,38.793103448275865,Unisex
Karel,1934,14,5,9,35.714285714285715,64.28571428571429,Unisex
Toy,1934,29,8,21,27.58620689655172,72.41379310344827,Unisex
Mannie,1934,22,8,14,36.36363636363637,63.63636363636363,Unisex
Ivery,1934,13,7,6,53.84615384615385,46.15384615384615,Unisex
Ura,1934,15,10,5,66.66666666666666,33.33333333333333,Unisex
Merion,1934,16,8,8,50.0,50.0,Unisex
Burnis,1934,20,5,15,25.0,75.0,Unisex
Binnie,1934,11,6,5,54.54545454545454,45.45454545454545,Unisex
Bernell,1934,48,21,27,43.75,56.25,Unisex
Carman,1934,33,12,21,36.36363636363637,63.63636363636363,Unisex
Carmon,1934,28,11,17,39.285714285714285,60.71428571428571,Unisex
Myrle,1934,45,32,13,71.11111111111111,28.88888888888889,Unisex
Claudie,1934,131,56,75,42.74809160305343,57.25190839694656,Unisex
Earnie,1934,17,8,9,47.05882352941176,52.94117647058824,Unisex
Courtney,1934,50,13,37,26.0,74.0,Unisex
Adell,1934,86,73,13,84.88372093023256,15.11627906976744,Unisex
Ermal,1934,15,5,10,33.33333333333333,66.66666666666666,Unisex
Vernal,1934,43,10,33,23.25581395348837,76.74418604651163,Unisex
Edell,1934,11,6,5,54.54545454545454,45.45454545454545,Unisex
Guadalupe,1934,482,284,198,58.92116182572615,41.078838174273855,Unisex
Sarajane,1935,6,6,0,100.0,0.0,Female
Romanita,1935,5,5,0,100.0,0.0,Female
Loie,1935,6,6,0,100.0,0.0,Female
Valeta,1935,7,7,0,100.0,0.0,Female
Dollye,1935,5,5,0,100.0,0.0,Female
Alda,1935,73,73,0,100.0,0.0,Female
Laurette,1935,35,35,0,100.0,0.0,Female
Paquita,1935,5,5,0,100.0,0.0,Female
Palestine,1935,5,5,0,100.0,0.0,Female
Cristina,1935,25,25,0,100.0,0.0,Female
Estalene,1935,6,6,0,100.0,0.0,Female
Rachell,1935,7,7,0,100.0,0.0,Female
Lawanda,1935,75,75,0,100.0,0.0,Female
Opel,1935,10,10,0,100.0,0.0,Female
Colene,1935,32,32,0,100.0,0.0,Female
Alba,1935,23,23,0,100.0,0.0,Female
Loyola,1935,18,18,0,100.0,0.0,Female
Helen,1935,12851,12784,67,99.47863979456852,0.521360205431484,Female
Omega,1935,34,34,0,100.0,0.0,Female
Lile,1935,6,6,0,100.0,0.0,Female
Avril,1935,6,6,0,100.0,0.0,Female
Carilyn,1935,13,13,0,100.0,0.0,Female
Winnona,1935,6,6,0,100.0,0.0,Female
Attie,1935,6,6,0,100.0,0.0,Female
Mava,1935,10,10,0,100.0,0.0,Female
Armetha,1935,5,5,0,100.0,0.0,Female
Agustina,1935,10,10,0,100.0,0.0,Female
Patt,1935,17,17,0,100.0,0.0,Female
Ammie,1935,18,18,0,100.0,0.0,Female
Dorothy,1935,19526,19405,121,99.38031342824952,0.6196865717504866,Female
Okey,1935,25,0,25,0.0,100.0,Male
Theodor,1935,10,0,10,0.0,100.0,Male
Chandler,1935,25,0,25,0.0,100.0,Male
Lehman,1935,11,0,11,0.0,100.0,Male
Laurance,1935,30,0,30,0.0,100.0,Male
Brandon,1935,9,0,9,0.0,100.0,Male
Berton,1935,31,0,31,0.0,100.0,Male
Elzie,1935,65,0,65,0.0,100.0,Male
Niel,1935,12,0,12,0.0,100.0,Male
Helmer,1935,10,0,10,0.0,100.0,Male
Walker,1935,75,0,75,0.0,100.0,Male
Jammie,1935,10,0,10,0.0,100.0,Male
Hurbert,1935,10,0,10,0.0,100.0,Male
Montague,1935,6,0,6,0.0,100.0,Male
Leonidas,1935,8,0,8,0.0,100.0,Male
Curly,1935,8,0,8,0.0,100.0,Male
Needham,1935,5,0,5,0.0,100.0,Male
Giles,1935,59,0,59,0.0,100.0,Male
Gwin,1935,8,0,8,0.0,100.0,Male
Drew,1935,25,0,25,0.0,100.0,Male
Harley,1935,364,0,364,0.0,100.0,Male
Harald,1935,8,0,8,0.0,100.0,Male
Gerald,1935,8506,48,8458,0.5643075476134493,99.43569245238656,Male
Deuel,1935,8,0,8,0.0,100.0,Male
Mccoy,1935,16,0,16,0.0,100.0,Male
Timoteo,1935,12,0,12,0.0,100.0,Male
Rolly,1935,12,0,12,0.0,100.0,Male
Delano,1935,118,0,118,0.0,100.0,Male
Arvil,1935,58,0,58,0.0,100.0,Male
Veldon,1935,6,0,6,0.0,100.0,Male
Nieves,1935,23,11,12,47.82608695652174,52.17391304347826,Unisex
Rodell,1935,14,5,9,35.714285714285715,64.28571428571429,Unisex
Pat,1935,1784,1326,458,74.32735426008968,25.672645739910315,Unisex
Ermal,1935,11,6,5,54.54545454545454,45.45454545454545,Unisex
Young,1935,22,5,17,22.727272727272727,77.27272727272727,Unisex
Lannie,1935,41,26,15,63.41463414634146,36.58536585365854,Unisex
Salome,1935,29,22,7,75.86206896551724,24.13793103448276,Unisex
Marlo,1935,35,7,28,20.0,80.0,Unisex
Lee,1935,2900,474,2426,16.344827586206897,83.6551724137931,Unisex
Maxie,1935,215,90,125,41.86046511627907,58.13953488372093,Unisex
Dayle,1935,29,9,20,31.03448275862069,68.96551724137932,Unisex
Del,1935,40,11,29,27.500000000000004,72.5,Unisex
Gray,1935,23,5,18,21.73913043478261,78.26086956521739,Unisex
Lyndell,1935,25,8,17,32.0,68.0,Unisex
Odell,1935,321,71,250,22.11838006230529,77.88161993769471,Unisex
Dana,1935,248,128,120,51.61290322580645,48.38709677419355,Unisex
Starr,1935,14,7,7,50.0,50.0,Unisex
Ottie,1935,24,11,13,45.83333333333333,54.16666666666666,Unisex
Sherril,1935,19,14,5,73.68421052631578,26.31578947368421,Unisex
Allison,1935,76,31,45,40.78947368421053,59.210526315789465,Unisex
Marty,1935,34,8,26,23.52941176470588,76.47058823529412,Unisex
Shelly,1935,45,18,27,40.0,60.0,Unisex
Gale,1935,366,122,244,33.33333333333333,66.66666666666666,Unisex
Sherrill,1935,154,95,59,61.68831168831169,38.31168831168832,Unisex
Pearly,1935,31,26,5,83.87096774193549,16.129032258064516,Unisex
Arlee,1935,12,6,6,50.0,50.0,Unisex
Willie,1935,8700,2372,6328,27.264367816091955,72.73563218390805,Unisex
Rossie,1935,39,21,18,53.84615384615385,46.15384615384615,Unisex
Arnell,1935,26,18,8,69.23076923076923,30.76923076923077,Unisex
Marcell,1935,36,20,16,55.55555555555556,44.44444444444444,Unisex
Nadean,1936,26,26,0,100.0,0.0,Female
Alverna,1936,13,13,0,100.0,0.0,Female
Doloris,1936,52,52,0,100.0,0.0,Female
Palma,1936,54,54,0,100.0,0.0,Female
Claudeen,1936,9,9,0,100.0,0.0,Female
Annarose,1936,5,5,0,100.0,0.0,Female
Elizebath,1936,6,6,0,100.0,0.0,Female
Isidora,1936,5,5,0,100.0,0.0,Female
Dera,1936,5,5,0,100.0,0.0,Female
Marigene,1936,9,9,0,100.0,0.0,Female
Zula,1936,34,34,0,100.0,0.0,Female
Karolyn,1936,42,42,0,100.0,0.0,Female
Velda,1936,131,131,0,100.0,0.0,Female
Zelphia,1936,6,6,0,100.0,0.0,Female
Gerline,1936,16,16,0,100.0,0.0,Female
Catheryn,1936,12,12,0,100.0,0.0,Female
Milda,1936,10,10,0,100.0,0.0,Female
Vonnie,1936,74,66,8,89.1891891891892,10.81081081081081,Female
Verneal,1936,11,11,0,100.0,0.0,Female
Maisie,1936,8,8,0,100.0,0.0,Female
Nora,1936,801,791,10,98.75156054931335,1.2484394506866416,Female
Claudia,1936,799,792,7,99.12390488110138,0.8760951188986232,Female
Gaylene,1936,32,32,0,100.0,0.0,Female
Billee,1936,8,8,0,100.0,0.0,Female
Norrine,1936,11,11,0,100.0,0.0,Female
Santa,1936,48,48,0,100.0,0.0,Female
Fredericka,1936,11,11,0,100.0,0.0,Female
Arnette,1936,11,11,0,100.0,0.0,Female
Era,1936,43,43,0,100.0,0.0,Female
Ivalou,1936,5,5,0,100.0,0.0,Female
Hillary,1936,7,0,7,0.0,100.0,Male
Elmore,1936,53,0,53,0.0,100.0,Male
Barnard,1936,8,0,8,0.0,100.0,Male
Elias,1936,116,0,116,0.0,100.0,Male
Olaf,1936,17,0,17,0.0,100.0,Male
Valentine,1936,74,8,66,10.81081081081081,89.1891891891892,Male
Cephus,1936,12,0,12,0.0,100.0,Male
Justus,1936,13,0,13,0.0,100.0,Male
Thurlow,1936,6,0,6,0.0,100.0,Male
Aaron,1936,443,0,443,0.0,100.0,Male
Carroll,1936,927,138,789,14.886731391585762,85.11326860841424,Male
Lamon,1936,7,0,7,0.0,100.0,Male
Glendel,1936,12,0,12,0.0,100.0,Male
Darel,1936,27,0,27,0.0,100.0,Male
Alford,1936,89,0,89,0.0,100.0,Male
Creed,1936,11,0,11,0.0,100.0,Male
Nile,1936,22,0,22,0.0,100.0,Male
Willey,1936,10,0,10,0.0,100.0,Male
Karl,1936,836,5,831,0.5980861244019139,99.4019138755981,Male
Harwood,1936,6,0,6,0.0,100.0,Male
Glenard,1936,5,0,5,0.0,100.0,Male
Jimmey,1936,20,0,20,0.0,100.0,Male
Blase,1936,5,0,5,0.0,100.0,Male
Gearold,1936,6,0,6,0.0,100.0,Male
Neal,1936,426,7,419,1.643192488262911,98.35680751173707,Male
Grayson,1936,25,0,25,0.0,100.0,Male
Orrin,1936,40,0,40,0.0,100.0,Male
Errol,1936,46,0,46,0.0,100.0,Male
Masami,1936,6,0,6,0.0,100.0,Male
Malvin,1936,30,0,30,0.0,100.0,Male
Mikel,1936,19,8,11,42.10526315789473,57.89473684210527,Unisex
Ozie,1936,28,12,16,42.85714285714285,57.14285714285714,Unisex
Freddie,1936,1419,225,1194,15.856236786469344,84.14376321353065,Unisex
Jamie,1936,98,49,49,50.0,50.0,Unisex
Refugio,1936,47,11,36,23.404255319148938,76.59574468085107,Unisex
Augustine,1936,142,52,90,36.61971830985916,63.38028169014085,Unisex
Jeffie,1936,28,14,14,50.0,50.0,Unisex
Carey,1936,100,19,81,19.0,81.0,Unisex
Vannie,1936,14,9,5,64.28571428571429,35.714285714285715,Unisex
Sherril,1936,17,10,7,58.82352941176471,41.17647058823529,Unisex
Billie,1936,2814,1991,823,70.75337597725657,29.24662402274343,Unisex
Lonie,1936,21,11,10,52.38095238095239,47.61904761904761,Unisex
Almer,1936,17,6,11,35.294117647058826,64.70588235294117,Unisex
Lesley,1936,49,18,31,36.734693877551024,63.26530612244898,Unisex
Autry,1936,34,10,24,29.411764705882355,70.58823529411765,Unisex
Murel,1936,21,9,12,42.85714285714285,57.14285714285714,Unisex
Alpha,1936,87,73,14,83.9080459770115,16.091954022988507,Unisex
Paige,1936,13,6,7,46.15384615384615,53.84615384615385,Unisex
Farris,1936,47,8,39,17.02127659574468,82.97872340425532,Unisex
Adair,1936,14,8,6,57.14285714285714,42.85714285714285,Unisex
Lindsay,1936,59,15,44,25.42372881355932,74.57627118644068,Unisex
Adell,1936,103,87,16,84.46601941747572,15.53398058252427,Unisex
Romaine,1936,70,58,12,82.85714285714286,17.142857142857142,Unisex
Ocie,1936,86,53,33,61.627906976744185,38.372093023255815,Unisex
Loyce,1936,91,75,16,82.41758241758241,17.582417582417584,Unisex
Afton,1936,31,24,7,77.41935483870968,22.58064516129032,Unisex
Juel,1936,16,7,9,43.75,56.25,Unisex
Artie,1936,105,67,38,63.8095238095238,36.19047619047619,Unisex
Jule,1936,32,15,17,46.875,53.125,Unisex
Kary,1936,12,5,7,41.66666666666667,58.333333333333336,Unisex
Janean,1937,8,8,0,100.0,0.0,Female
Irmgard,1937,13,13,0,100.0,0.0,Female
Izella,1937,5,5,0,100.0,0.0,Female
Rea,1937,14,14,0,100.0,0.0,Female
Avelina,1937,12,12,0,100.0,0.0,Female
Sabina,1937,33,33,0,100.0,0.0,Female
Gloria,1937,6373,6333,40,99.37235211046604,0.6276478895339714,Female
Ferol,1937,16,16,0,100.0,0.0,Female
Christella,1937,8,8,0,100.0,0.0,Female
Tobi,1937,8,8,0,100.0,0.0,Female
Betsey,1937,34,34,0,100.0,0.0,Female
Florestine,1937,8,8,0,100.0,0.0,Female
Leota,1937,162,162,0,100.0,0.0,Female
Demaris,1937,14,14,0,100.0,0.0,Female
Dellene,1937,17,17,0,100.0,0.0,Female
Star,1937,10,10,0,100.0,0.0,Female
Merlean,1937,5,5,0,100.0,0.0,Female
Rosalind,1937,295,295,0,100.0,0.0,Female
Levada,1937,11,11,0,100.0,0.0,Female
Saloma,1937,5,5,0,100.0,0.0,Female
Ellena,1937,13,13,0,100.0,0.0,Female
Leonor,1937,64,64,0,100.0,0.0,Female
Wylodean,1937,5,5,0,100.0,0.0,Female
Janace,1937,5,5,0,100.0,0.0,Female
Deborah,1937,322,322,0,100.0,0.0,Female
Samantha,1937,23,23,0,100.0,0.0,Female
Geraldyne,1937,8,8,0,100.0,0.0,Female
Vista,1937,5,5,0,100.0,0.0,Female
Maxine,1937,1744,1731,13,99.2545871559633,0.7454128440366973,Female
Kittie,1937,24,24,0,100.0,0.0,Female
Wilbur,1937,735,9,726,1.2244897959183674,98.77551020408164,Male
Gorge,1937,14,0,14,0.0,100.0,Male
Jerral,1937,10,0,10,0.0,100.0,Male
Rochester,1937,9,0,9,0.0,100.0,Male
Shelton,1937,115,0,115,0.0,100.0,Male
Merwyn,1937,38,0,38,0.0,100.0,Male
Joe,1937,7966,226,7740,2.837057494350992,97.162942505649,Male
Alvan,1937,18,0,18,0.0,100.0,Male
Garvis,1937,9,0,9,0.0,100.0,Male
Heriberto,1937,24,0,24,0.0,100.0,Male
Vernal,1937,29,0,29,0.0,100.0,Male
Marland,1937,20,0,20,0.0,100.0,Male
Derrick,1937,6,0,6,0.0,100.0,Male
Boyd,1937,419,0,419,0.0,100.0,Male
Mallory,1937,8,0,8,0.0,100.0,Male
Orson,1937,11,0,11,0.0,100.0,Male
Sheldon,1937,436,0,436,0.0,100.0,Male
Bertram,1937,76,0,76,0.0,100.0,Male
Glover,1937,19,0,19,0.0,100.0,Male
Okey,1937,26,0,26,0.0,100.0,Male
Alen,1937,5,0,5,0.0,100.0,Male
Ulysee,1937,9,0,9,0.0,100.0,Male
Filiberto,1937,11,0,11,0.0,100.0,Male
Orley,1937,12,0,12,0.0,100.0,Male
Mathias,1937,16,0,16,0.0,100.0,Male
Ishmael,1937,22,0,22,0.0,100.0,Male
Lucien,1937,47,0,47,0.0,100.0,Male
Verland,1937,9,0,9,0.0,100.0,Male
Liborio,1937,5,0,5,0.0,100.0,Male
Verne,1937,81,8,73,9.876543209876544,90.12345679012346,Male
Ivory,1937,122,44,78,36.0655737704918,63.934426229508205,Unisex
Dell,1937,73,26,47,35.61643835616438,64.38356164383562,Unisex
Shelley,1937,70,47,23,67.14285714285714,32.857142857142854,Unisex
Darris,1937,21,6,15,28.57142857142857,71.42857142857143,Unisex
Lugene,1937,25,13,12,52.0,48.0,Unisex
Jodie,1937,48,17,31,35.41666666666667,64.58333333333334,Unisex
Henri,1937,33,13,20,39.39393939393939,60.60606060606061,Unisex
Fayne,1937,11,5,6,45.45454545454545,54.54545454545454,Unisex
Collie,1937,23,6,17,26.08695652173913,73.91304347826086,Unisex
Marlowe,1937,23,9,14,39.130434782608695,60.86956521739131,Unisex
Laurie,1937,116,82,34,70.6896551724138,29.310344827586203,Unisex
Ozzie,1937,43,17,26,39.53488372093023,60.46511627906976,Unisex
Jamie,1937,92,58,34,63.04347826086957,36.95652173913043,Unisex
Sherrill,1937,159,107,52,67.29559748427673,32.70440251572327,Unisex
Dorian,1937,12,5,7,41.66666666666667,58.333333333333336,Unisex
Lacy,1937,121,20,101,16.528925619834713,83.47107438016529,Unisex
Beryl,1937,169,128,41,75.7396449704142,24.2603550295858,Unisex
Santos,1937,107,26,81,24.299065420560748,75.70093457943925,Unisex
Babe,1937,11,6,5,54.54545454545454,45.45454545454545,Unisex
Audie,1937,42,22,20,52.38095238095239,47.61904761904761,Unisex
Mayo,1937,25,6,19,24.0,76.0,Unisex
Eldean,1937,14,6,8,42.85714285714285,57.14285714285714,Unisex
Estell,1937,47,38,9,80.85106382978722,19.148936170212767,Unisex
Hiawatha,1937,12,6,6,50.0,50.0,Unisex
Lannie,1937,43,15,28,34.88372093023256,65.11627906976744,Unisex
Paddy,1937,18,13,5,72.22222222222221,27.77777777777778,Unisex
Evon,1937,68,57,11,83.82352941176471,16.176470588235293,Unisex
Nieves,1937,18,10,8,55.55555555555556,44.44444444444444,Unisex
Alexandria,1937,23,17,6,73.91304347826086,26.08695652173913,Unisex
Jene,1937,29,13,16,44.82758620689656,55.172413793103445,Unisex
Reeda,1938,8,8,0,100.0,0.0,Female
Christell,1938,8,8,0,100.0,0.0,Female
Norinne,1938,7,7,0,100.0,0.0,Female
Rosanne,1938,121,121,0,100.0,0.0,Female
Lavene,1938,5,5,0,100.0,0.0,Female
Cather,1938,6,6,0,100.0,0.0,Female
Kendra,1938,7,7,0,100.0,0.0,Female
Oleva,1938,5,5,0,100.0,0.0,Female
Margarita,1938,252,252,0,100.0,0.0,Female
Vaudine,1938,12,12,0,100.0,0.0,Female
Roselia,1938,8,8,0,100.0,0.0,Female
Izola,1938,19,19,0,100.0,0.0,Female
Rosanna,1938,56,56,0,100.0,0.0,Female
Farida,1938,6,6,0,100.0,0.0,Female
Erla,1938,15,15,0,100.0,0.0,Female
Correne,1938,5,5,0,100.0,0.0,Female
Beth,1938,406,406,0,100.0,0.0,Female
Corinthia,1938,5,5,0,100.0,0.0,Female
Corrina,1938,7,7,0,100.0,0.0,Female
Jorene,1938,15,15,0,100.0,0.0,Female
Bulah,1938,24,24,0,100.0,0.0,Female
Dorothye,1938,6,6,0,100.0,0.0,Female
Merlean,1938,5,5,0,100.0,0.0,Female
Michaele,1938,5,5,0,100.0,0.0,Female
Moira,1938,12,12,0,100.0,0.0,Female
Jesusita,1938,13,13,0,100.0,0.0,Female
Joann,1938,3723,3710,13,99.65081923180232,0.34918076819769,Female
Corene,1938,58,58,0,100.0,0.0,Female
Geniel,1938,5,5,0,100.0,0.0,Female
Marietta,1938,278,278,0,100.0,0.0,Female
Lindsay,1938,52,6,46,11.538461538461538,88.46153846153845,Male
Howell,1938,56,0,56,0.0,100.0,Male
Hart,1938,13,0,13,0.0,100.0,Male
Frantz,1938,5,0,5,0.0,100.0,Male
Hosie,1938,19,0,19,0.0,100.0,Male
Farrel,1938,15,0,15,0.0,100.0,Male
El,1938,8,0,8,0.0,100.0,Male
Elder,1938,6,0,6,0.0,100.0,Male
Stafford,1938,18,0,18,0.0,100.0,Male
Harlen,1938,45,0,45,0.0,100.0,Male
Addison,1938,33,0,33,0.0,100.0,Male
Dewaine,1938,11,0,11,0.0,100.0,Male
Lance,1938,267,0,267,0.0,100.0,Male
Cosimo,1938,11,0,11,0.0,100.0,Male
Francisco,1938,305,6,299,1.9672131147540983,98.0327868852459,Male
Dallis,1938,16,0,16,0.0,100.0,Male
Levert,1938,5,0,5,0.0,100.0,Male
Rusty,1938,6,0,6,0.0,100.0,Male
Milan,1938,61,0,61,0.0,100.0,Male
Tandy,1938,12,0,12,0.0,100.0,Male
Alf,1938,13,0,13,0.0,100.0,Male
Sewell,1938,7,0,7,0.0,100.0,Male
Victor,1938,1570,9,1561,0.5732484076433121,99.4267515923567,Male
Lawyer,1938,14,0,14,0.0,100.0,Male
Ladon,1938,8,0,8,0.0,100.0,Male
Guilford,1938,10,0,10,0.0,100.0,Male
Darwin,1938,338,0,338,0.0,100.0,Male
Lenwood,1938,28,0,28,0.0,100.0,Male
Lenard,1938,139,0,139,0.0,100.0,Male
Rodgers,1938,10,0,10,0.0,100.0,Male
Ollie,1938,646,451,195,69.81424148606811,30.185758513931887,Unisex
Toby,1938,210,157,53,74.76190476190476,25.23809523809524,Unisex
Ezell,1938,59,9,50,15.254237288135592,84.7457627118644,Unisex
Bethel,1938,76,55,21,72.36842105263158,27.631578947368425,Unisex
Zannie,1938,10,5,5,50.0,50.0,Unisex
Guadalupe,1938,480,269,211,56.04166666666666,43.958333333333336,Unisex
Llewellyn,1938,53,9,44,16.9811320754717,83.01886792452831,Unisex
Kim,1938,74,34,40,45.94594594594595,54.054054054054056,Unisex
Clemmie,1938,52,34,18,65.38461538461539,34.61538461538461,Unisex
Lavon,1938,155,113,42,72.90322580645162,27.09677419354839,Unisex
Myrl,1938,44,15,29,34.090909090909086,65.9090909090909,Unisex
Love,1938,16,5,11,31.25,68.75,Unisex
Glennis,1938,72,51,21,70.83333333333334,29.166666666666668,Unisex
Billie,1938,2434,1746,688,71.73377156943303,28.26622843056697,Unisex
Sonnie,1938,17,5,12,29.411764705882355,70.58823529411765,Unisex
Bobie,1938,32,10,22,31.25,68.75,Unisex
Earnie,1938,24,10,14,41.66666666666667,58.333333333333336,Unisex
Ivy,1938,103,74,29,71.84466019417476,28.155339805825243,Unisex
Sammie,1938,480,132,348,27.500000000000004,72.5,Unisex
Alois,1938,40,10,30,25.0,75.0,Unisex
Willie,1938,8098,2018,6080,24.91973326747345,75.08026673252655,Unisex
Little,1938,15,5,10,33.33333333333333,66.66666666666666,Unisex
Jaye,1938,14,7,7,50.0,50.0,Unisex
Romie,1938,27,8,19,29.629629629629623,70.37037037037037,Unisex
Arnell,1938,25,14,11,56.00000000000001,44.0,Unisex
Jamie,1938,113,72,41,63.71681415929204,36.283185840707965,Unisex
Luverne,1938,26,9,17,34.61538461538461,65.38461538461539,Unisex
Murel,1938,23,5,18,21.73913043478261,78.26086956521739,Unisex
Curley,1938,48,11,37,22.916666666666664,77.08333333333334,Unisex
Burdell,1938,10,5,5,50.0,50.0,Unisex
Viney,1939,6,6,0,100.0,0.0,Female
Gwena,1939,5,5,0,100.0,0.0,Female
Wenda,1939,12,12,0,100.0,0.0,Female
Harriet,1939,1391,1391,0,100.0,0.0,Female
Eugenie,1939,36,36,0,100.0,0.0,Female
Vincenza,1939,21,21,0,100.0,0.0,Female
Forestine,1939,12,12,0,100.0,0.0,Female
Rita,1939,3204,3188,16,99.50062421972534,0.4993757802746567,Female
Kathlyn,1939,34,34,0,100.0,0.0,Female
Madilyn,1939,7,7,0,100.0,0.0,Female
Randi,1939,9,9,0,100.0,0.0,Female
Teri,1939,21,21,0,100.0,0.0,Female
Janae,1939,6,6,0,100.0,0.0,Female
Nicki,1939,17,17,0,100.0,0.0,Female
Maggie,1939,575,567,8,98.60869565217392,1.391304347826087,Female
Jeannine,1939,320,320,0,100.0,0.0,Female
Rosella,1939,226,226,0,100.0,0.0,Female
Glorianna,1939,7,7,0,100.0,0.0,Female
Normalee,1939,6,6,0,100.0,0.0,Female
Joye,1939,60,60,0,100.0,0.0,Female
Lenice,1939,7,7,0,100.0,0.0,Female
Letta,1939,9,9,0,100.0,0.0,Female
Izetta,1939,19,19,0,100.0,0.0,Female
Margret,1939,107,107,0,100.0,0.0,Female
Floyce,1939,12,12,0,100.0,0.0,Female
Esperanza,1939,115,115,0,100.0,0.0,Female
Arva,1939,11,11,0,100.0,0.0,Female
Esme,1939,5,5,0,100.0,0.0,Female
Petrina,1939,5,5,0,100.0,0.0,Female
Nan,1939,197,197,0,100.0,0.0,Female
Onofre,1939,7,0,7,0.0,100.0,Male
Shane,1939,5,0,5,0.0,100.0,Male
Geral,1939,8,0,8,0.0,100.0,Male
Luvern,1939,10,0,10,0.0,100.0,Male
Beecher,1939,18,0,18,0.0,100.0,Male
Aubry,1939,17,0,17,0.0,100.0,Male
Roe,1939,13,0,13,0.0,100.0,Male
Ysidro,1939,16,0,16,0.0,100.0,Male
Comer,1939,15,0,15,0.0,100.0,Male
Barrett,1939,30,0,30,0.0,100.0,Male
Raul,1939,327,5,322,1.529051987767584,98.4709480122324,Male
Elgin,1939,23,0,23,0.0,100.0,Male
Ambrose,1939,55,0,55,0.0,100.0,Male
Shaw,1939,5,0,5,0.0,100.0,Male
Florencio,1939,28,0,28,0.0,100.0,Male
Guy,1939,720,8,712,1.1111111111111112,98.88888888888889,Male
Stoney,1939,20,0,20,0.0,100.0,Male
Lincoln,1939,78,0,78,0.0,100.0,Male
Glade,1939,24,0,24,0.0,100.0,Male
Silvio,1939,26,0,26,0.0,100.0,Male
Udell,1939,11,0,11,0.0,100.0,Male
Orion,1939,20,0,20,0.0,100.0,Male
Crawford,1939,35,0,35,0.0,100.0,Male
Lynnwood,1939,6,0,6,0.0,100.0,Male
Dawson,1939,32,0,32,0.0,100.0,Male
Cloyse,1939,5,0,5,0.0,100.0,Male
Ordean,1939,5,0,5,0.0,100.0,Male
Rayburn,1939,78,0,78,0.0,100.0,Male
Einar,1939,9,0,9,0.0,100.0,Male
Rollen,1939,8,0,8,0.0,100.0,Male
Paige,1939,27,18,9,66.66666666666666,33.33333333333333,Unisex
Sydney,1939,156,77,79,49.358974358974365,50.64102564102564,Unisex
Woodie,1939,35,6,29,17.142857142857142,82.85714285714286,Unisex
Arlis,1939,56,20,36,35.714285714285715,64.28571428571429,Unisex
Mallory,1939,15,5,10,33.33333333333333,66.66666666666666,Unisex
Jewel,1939,476,392,84,82.35294117647058,17.647058823529413,Unisex
Climmie,1939,14,9,5,64.28571428571429,35.714285714285715,Unisex
Sherrel,1939,17,10,7,58.82352941176471,41.17647058823529,Unisex
Bernell,1939,48,19,29,39.58333333333333,60.41666666666666,Unisex
Darby,1939,14,8,6,57.14285714285714,42.85714285714285,Unisex
Roxy,1939,17,12,5,70.58823529411765,29.411764705882355,Unisex
Merl,1939,32,5,27,15.625,84.375,Unisex
Kim,1939,85,33,52,38.82352941176471,61.1764705882353,Unisex
Jodie,1939,55,22,33,40.0,60.0,Unisex
Pat,1939,2105,1659,446,78.812351543943,21.187648456057005,Unisex
Carlyn,1939,36,30,6,83.33333333333334,16.666666666666664,Unisex
Lavern,1939,243,73,170,30.04115226337449,69.95884773662551,Unisex
Garnet,1939,98,70,28,71.42857142857143,28.57142857142857,Unisex
Beryl,1939,155,122,33,78.70967741935485,21.29032258064516,Unisex
Merrell,1939,23,6,17,26.08695652173913,73.91304347826086,Unisex
Otha,1939,115,20,95,17.391304347826086,82.6086956521739,Unisex
Stevie,1939,12,5,7,41.66666666666667,58.333333333333336,Unisex
Dorsey,1939,76,14,62,18.421052631578945,81.57894736842105,Unisex
Von,1939,53,10,43,18.867924528301888,81.13207547169812,Unisex
Marcell,1939,24,16,8,66.66666666666666,33.33333333333333,Unisex
Sheridan,1939,50,22,28,44.0,56.00000000000001,Unisex
Bethel,1939,61,49,12,80.32786885245902,19.672131147540984,Unisex
Curley,1939,54,15,39,27.77777777777778,72.22222222222221,Unisex
Carman,1939,26,11,15,42.30769230769231,57.692307692307686,Unisex
Holly,1939,88,70,18,79.54545454545455,20.454545454545457,Unisex
Arleta,1940,19,19,0,100.0,0.0,Female
Bettyjo,1940,7,7,0,100.0,0.0,Female
Eleonor,1940,5,5,0,100.0,0.0,Female
Madalena,1940,5,5,0,100.0,0.0,Female
Cathryn,1940,81,81,0,100.0,0.0,Female
Leotha,1940,7,7,0,100.0,0.0,Female
Darcus,1940,8,8,0,100.0,0.0,Female
Michaele,1940,12,12,0,100.0,0.0,Female
Elia,1940,30,30,0,100.0,0.0,Female
Wanna,1940,13,13,0,100.0,0.0,Female
Veria,1940,7,7,0,100.0,0.0,Female
Myrtha,1940,6,6,0,100.0,0.0,Female
Dyann,1940,10,10,0,100.0,0.0,Female
Madgie,1940,6,6,0,100.0,0.0,Female
Normal,1940,5,5,0,100.0,0.0,Female
Santina,1940,16,16,0,100.0,0.0,Female
Shelah,1940,7,7,0,100.0,0.0,Female
Vinnie,1940,30,30,0,100.0,0.0,Female
Solveig,1940,5,5,0,100.0,0.0,Female
Lorana,1940,5,5,0,100.0,0.0,Female
Kathelene,1940,5,5,0,100.0,0.0,Female
Annella,1940,15,15,0,100.0,0.0,Female
Vergie,1940,61,61,0,100.0,0.0,Female
Robbye,1940,5,5,0,100.0,0.0,Female
Delories,1940,43,43,0,100.0,0.0,Female
Rafaela,1940,24,24,0,100.0,0.0,Female
Mellie,1940,15,15,0,100.0,0.0,Female
Albertina,1940,10,10,0,100.0,0.0,Female
Frieda,1940,200,200,0,100.0,0.0,Female
Nyla,1940,50,50,0,100.0,0.0,Female
Orland,1940,19,0,19,0.0,100.0,Male
Antimo,1940,6,0,6,0.0,100.0,Male
Worthington,1940,5,0,5,0.0,100.0,Male
Burdette,1940,18,0,18,0.0,100.0,Male
Emmerson,1940,6,0,6,0.0,100.0,Male
Ralston,1940,6,0,6,0.0,100.0,Male
Clevon,1940,6,0,6,0.0,100.0,Male
Lorenz,1940,12,0,12,0.0,100.0,Male
Donavon,1940,36,0,36,0.0,100.0,Male
Ebert,1940,9,0,9,0.0,100.0,Male
Cole,1940,10,0,10,0.0,100.0,Male
Bishop,1940,12,0,12,0.0,100.0,Male
Colby,1940,6,0,6,0.0,100.0,Male
Rogelio,1940,61,0,61,0.0,100.0,Male
Kinnith,1940,5,0,5,0.0,100.0,Male
Refujio,1940,5,0,5,0.0,100.0,Male
Mauricio,1940,15,0,15,0.0,100.0,Male
Lenton,1940,12,0,12,0.0,100.0,Male
Emmett,1940,338,0,338,0.0,100.0,Male
Roosevelt,1940,640,5,635,0.78125,99.21875,Male
Gilroy,1940,5,0,5,0.0,100.0,Male
Waymond,1940,25,0,25,0.0,100.0,Male
Art,1940,86,0,86,0.0,100.0,Male
Moises,1940,36,0,36,0.0,100.0,Male
Lonny,1940,71,0,71,0.0,100.0,Male
Walt,1940,27,0,27,0.0,100.0,Male
Costa,1940,7,0,7,0.0,100.0,Male
Lindle,1940,5,0,5,0.0,100.0,Male
Henley,1940,9,0,9,0.0,100.0,Male
Vilas,1940,6,0,6,0.0,100.0,Male
Darcy,1940,20,11,9,55.00000000000001,45.0,Unisex
Nicola,1940,21,9,12,42.85714285714285,57.14285714285714,Unisex
Ines,1940,29,23,6,79.3103448275862,20.6896551724138,Unisex
Golden,1940,30,15,15,50.0,50.0,Unisex
Jeryl,1940,12,7,5,58.333333333333336,41.66666666666667,Unisex
Odie,1940,42,8,34,19.047619047619047,80.95238095238095,Unisex
Willy,1940,33,6,27,18.181818181818183,81.81818181818183,Unisex
Gearl,1940,13,6,7,46.15384615384615,53.84615384615385,Unisex
Barrie,1940,62,16,46,25.806451612903224,74.19354838709677,Unisex
Osie,1940,18,13,5,72.22222222222221,27.77777777777778,Unisex
Bernis,1940,14,6,8,42.85714285714285,57.14285714285714,Unisex
Dorris,1940,122,95,27,77.8688524590164,22.131147540983605,Unisex
Macy,1940,21,14,7,66.66666666666666,33.33333333333333,Unisex
Vannie,1940,19,12,7,63.1578947368421,36.84210526315789,Unisex
Lani,1940,45,37,8,82.22222222222221,17.77777777777778,Unisex
Hosie,1940,21,6,15,28.57142857142857,71.42857142857143,Unisex
Kenna,1940,21,12,9,57.14285714285714,42.85714285714285,Unisex
Marcel,1940,63,10,53,15.873015873015872,84.12698412698413,Unisex
Timmie,1940,18,5,13,27.77777777777778,72.22222222222221,Unisex
Carel,1940,11,6,5,54.54545454545454,45.45454545454545,Unisex
Otha,1940,106,26,80,24.52830188679245,75.47169811320755,Unisex
Shellie,1940,30,14,16,46.66666666666666,53.333333333333336,Unisex
Climmie,1940,26,10,16,38.46153846153847,61.53846153846154,Unisex
Arlis,1940,61,19,42,31.14754098360656,68.85245901639344,Unisex
Bethel,1940,72,52,20,72.22222222222221,27.77777777777778,Unisex
Arlyn,1940,59,12,47,20.33898305084746,79.66101694915254,Unisex
Delane,1940,22,12,10,54.54545454545454,45.45454545454545,Unisex
Clovis,1940,55,13,42,23.63636363636364,76.36363636363637,Unisex
Marty,1940,78,29,49,37.17948717948718,62.82051282051282,Unisex
Garnet,1940,117,93,24,79.48717948717949,20.51282051282051,Unisex
Paddy,1941,5,5,0,100.0,0.0,Female
Esther,1941,1826,1810,16,99.1237677984666,0.8762322015334063,Female
Emiko,1941,7,7,0,100.0,0.0,Female
Francia,1941,16,16,0,100.0,0.0,Female
Ilah,1941,11,11,0,100.0,0.0,Female
Janann,1941,7,7,0,100.0,0.0,Female
Yuvonne,1941,5,5,0,100.0,0.0,Female
Maxine,1941,1760,1750,10,99.43181818181816,0.5681818181818182,Female
Miranda,1941,20,20,0,100.0,0.0,Female
Juliana,1941,93,93,0,100.0,0.0,Female
Lesta,1941,5,5,0,100.0,0.0,Female
Judi,1941,200,200,0,100.0,0.0,Female
Angelia,1941,12,12,0,100.0,0.0,Female
Gwendolen,1941,7,7,0,100.0,0.0,Female
Lera,1941,17,17,0,100.0,0.0,Female
Ardena,1941,13,13,0,100.0,0.0,Female
Tillie,1941,51,51,0,100.0,0.0,Female
Caroljean,1941,5,5,0,100.0,0.0,Female
Vernola,1941,5,5,0,100.0,0.0,Female
Gerrie,1941,38,38,0,100.0,0.0,Female
Creola,1941,29,29,0,100.0,0.0,Female
Kattie,1941,49,49,0,100.0,0.0,Female
Faustina,1941,13,13,0,100.0,0.0,Female
Prescilla,1941,14,14,0,100.0,0.0,Female
Nila,1941,92,92,0,100.0,0.0,Female
Lindalou,1941,9,9,0,100.0,0.0,Female
Odester,1941,5,5,0,100.0,0.0,Female
Nadine,1941,589,589,0,100.0,0.0,Female
Jennifer,1941,136,136,0,100.0,0.0,Female
Marielena,1941,9,9,0,100.0,0.0,Female
Happy,1941,5,0,5,0.0,100.0,Male
Frederico,1941,5,0,5,0.0,100.0,Male
Julious,1941,10,0,10,0.0,100.0,Male
Dillard,1941,52,0,52,0.0,100.0,Male
Darnel,1941,5,0,5,0.0,100.0,Male
Mack,1941,434,0,434,0.0,100.0,Male
Brenton,1941,16,0,16,0.0,100.0,Male
Linzy,1941,8,0,8,0.0,100.0,Male
Reg,1941,10,0,10,0.0,100.0,Male
Loranzo,1941,5,0,5,0.0,100.0,Male
Beldon,1941,5,0,5,0.0,100.0,Male
Phillips,1941,23,0,23,0.0,100.0,Male
Juluis,1941,7,0,7,0.0,100.0,Male
Arch,1941,15,0,15,0.0,100.0,Male
Quentin,1941,59,0,59,0.0,100.0,Male
Dickie,1941,143,13,130,9.090909090909092,90.9090909090909,Male
Amedeo,1941,6,0,6,0.0,100.0,Male
Rayburn,1941,87,0,87,0.0,100.0,Male
Chester,1941,1458,10,1448,0.6858710562414266,99.31412894375858,Male
Abdul,1941,9,0,9,0.0,100.0,Male
Emanual,1941,5,0,5,0.0,100.0,Male
Cosmo,1941,29,0,29,0.0,100.0,Male
Brant,1941,14,0,14,0.0,100.0,Male
Donny,1941,79,0,79,0.0,100.0,Male
Herb,1941,63,0,63,0.0,100.0,Male
Lawrence,1941,6681,29,6652,0.4340667564735818,99.56593324352642,Male
Sid,1941,32,0,32,0.0,100.0,Male
Julien,1941,11,0,11,0.0,100.0,Male
Nicolas,1941,56,0,56,0.0,100.0,Male
Robinson,1941,9,0,9,0.0,100.0,Male
Otha,1941,115,27,88,23.47826086956522,76.52173913043478,Unisex
Dayle,1941,26,14,12,53.84615384615385,46.15384615384615,Unisex
Layne,1941,25,7,18,28.000000000000004,72.0,Unisex
Arie,1941,21,16,5,76.19047619047619,23.809523809523807,Unisex
Dariel,1941,15,6,9,40.0,60.0,Unisex
Dorsie,1941,14,7,7,50.0,50.0,Unisex
Ocie,1941,65,31,34,47.69230769230769,52.30769230769232,Unisex
Marty,1941,90,32,58,35.55555555555556,64.44444444444444,Unisex
Audie,1941,30,7,23,23.33333333333333,76.66666666666667,Unisex
Vertis,1941,16,8,8,50.0,50.0,Unisex
Romaine,1941,58,48,10,82.75862068965517,17.24137931034483,Unisex
Waverly,1941,35,7,28,20.0,80.0,Unisex
Loris,1941,41,25,16,60.97560975609756,39.02439024390244,Unisex
Ladell,1941,22,11,11,50.0,50.0,Unisex
Brownie,1941,13,7,6,53.84615384615385,46.15384615384615,Unisex
Del,1941,47,10,37,21.27659574468085,78.72340425531915,Unisex
Doyce,1941,28,8,20,28.57142857142857,71.42857142857143,Unisex
Davie,1941,44,10,34,22.727272727272727,77.27272727272727,Unisex
Ara,1941,19,12,7,63.1578947368421,36.84210526315789,Unisex
Vester,1941,38,12,26,31.57894736842105,68.42105263157895,Unisex
Odell,1941,233,36,197,15.450643776824036,84.54935622317596,Unisex
Merril,1941,20,6,14,30.0,70.0,Unisex
Starling,1941,12,5,7,41.66666666666667,58.333333333333336,Unisex
Dann,1941,13,7,6,53.84615384615385,46.15384615384615,Unisex
Bennie,1941,1041,202,839,19.404418828049952,80.59558117195004,Unisex
Macy,1941,20,12,8,60.0,40.0,Unisex
Donnie,1941,934,148,786,15.845824411134904,84.1541755888651,Unisex
Curley,1941,49,12,37,24.489795918367346,75.51020408163265,Unisex
Caroll,1941,58,39,19,67.24137931034483,32.758620689655174,Unisex
Murrell,1941,29,6,23,20.6896551724138,79.3103448275862,Unisex
Garda,1942,6,6,0,100.0,0.0,Female
Nada,1942,48,48,0,100.0,0.0,Female
Tona,1942,12,12,0,100.0,0.0,Female
Donzella,1942,6,6,0,100.0,0.0,Female
Mabry,1942,5,5,0,100.0,0.0,Female
Nyoka,1942,45,45,0,100.0,0.0,Female
Laurice,1942,19,19,0,100.0,0.0,Female
Laquetta,1942,5,5,0,100.0,0.0,Female
Rachelle,1942,39,39,0,100.0,0.0,Female
Lindia,1942,11,11,0,100.0,0.0,Female
Velna,1942,7,7,0,100.0,0.0,Female
Mariann,1942,137,137,0,100.0,0.0,Female
Lizabeth,1942,7,7,0,100.0,0.0,Female
Hulda,1942,15,15,0,100.0,0.0,Female
Georgie,1942,174,151,23,86.7816091954023,13.218390804597702,Female
Sonna,1942,8,8,0,100.0,0.0,Female
Michaelene,1942,27,27,0,100.0,0.0,Female
Cherrie,1942,29,29,0,100.0,0.0,Female
Marshia,1942,5,5,0,100.0,0.0,Female
Glady,1942,8,8,0,100.0,0.0,Female
Savilla,1942,6,6,0,100.0,0.0,Female
Miriam,1942,706,706,0,100.0,0.0,Female
Carolee,1942,159,159,0,100.0,0.0,Female
Stephani,1942,8,8,0,100.0,0.0,Female
Fredna,1942,20,20,0,100.0,0.0,Female
Rosalynn,1942,6,6,0,100.0,0.0,Female
Johnetta,1942,49,49,0,100.0,0.0,Female
Denese,1942,5,5,0,100.0,0.0,Female
Maudell,1942,9,9,0,100.0,0.0,Female
Neena,1942,7,7,0,100.0,0.0,Female
Wesley,1942,1273,19,1254,1.4925373134328357,98.50746268656717,Male
Fernand,1942,30,0,30,0.0,100.0,Male
Joachim,1942,5,0,5,0.0,100.0,Male
Carel,1942,5,0,5,0.0,100.0,Male
Erle,1942,15,0,15,0.0,100.0,Male
Graham,1942,100,0,100,0.0,100.0,Male
Charle,1942,8,0,8,0.0,100.0,Male
Brandon,1942,10,0,10,0.0,100.0,Male
Bruce,1942,5401,17,5384,0.3147565265691538,99.68524347343084,Male
Benigno,1942,10,0,10,0.0,100.0,Male
Tillman,1942,44,0,44,0.0,100.0,Male
Lillard,1942,18,0,18,0.0,100.0,Male
Noble,1942,93,0,93,0.0,100.0,Male
Stclair,1942,8,0,8,0.0,100.0,Male
Derryl,1942,7,0,7,0.0,100.0,Male
Maximilian,1942,5,0,5,0.0,100.0,Male
Roger,1942,9206,32,9174,0.3475993917010645,99.65240060829892,Male
Randal,1942,63,0,63,0.0,100.0,Male
Buddy,1942,506,5,501,0.9881422924901186,99.01185770750988,Male
Linley,1942,6,0,6,0.0,100.0,Male
Valmore,1942,5,0,5,0.0,100.0,Male
Melvis,1942,8,0,8,0.0,100.0,Male
Theodore,1942,2670,6,2664,0.2247191011235955,99.7752808988764,Male
Lucion,1942,9,0,9,0.0,100.0,Male
Royall,1942,5,0,5,0.0,100.0,Male
Ronnie,1942,3521,159,3362,4.515762567452429,95.48423743254756,Male
Jones,1942,35,0,35,0.0,100.0,Male
Stuart,1942,973,9,964,0.9249743062692704,99.07502569373074,Male
Ely,1942,9,0,9,0.0,100.0,Male
Jacinto,1942,21,0,21,0.0,100.0,Male
Ozzie,1942,30,13,17,43.333333333333336,56.66666666666666,Unisex
Lindal,1942,11,5,6,45.45454545454545,54.54545454545454,Unisex
Shannon,1942,175,126,49,72.0,28.000000000000004,Unisex
Dorsie,1942,11,5,6,45.45454545454545,54.54545454545454,Unisex
Carnell,1942,46,9,37,19.565217391304348,80.43478260869566,Unisex
Golden,1942,29,8,21,27.58620689655172,72.41379310344827,Unisex
Claudell,1942,25,13,12,52.0,48.0,Unisex
Mozell,1942,33,22,11,66.66666666666666,33.33333333333333,Unisex
Avon,1942,40,17,23,42.5,57.49999999999999,Unisex
Montie,1942,39,15,24,38.46153846153847,61.53846153846154,Unisex
Texas,1942,16,5,11,31.25,68.75,Unisex
Paige,1942,39,25,14,64.1025641025641,35.8974358974359,Unisex
Johnie,1942,279,56,223,20.07168458781362,79.92831541218638,Unisex
Maxie,1942,146,46,100,31.506849315068493,68.4931506849315,Unisex
Darcy,1942,29,14,15,48.27586206896552,51.72413793103448,Unisex
Bernell,1942,49,21,28,42.85714285714285,57.14285714285714,Unisex
Michel,1942,97,27,70,27.83505154639176,72.16494845360825,Unisex
Marlyn,1942,172,130,42,75.5813953488372,24.418604651162788,Unisex
Erie,1942,16,9,7,56.25,43.75,Unisex
Delma,1942,133,103,30,77.44360902255639,22.55639097744361,Unisex
Lorie,1942,27,22,5,81.48148148148148,18.51851851851852,Unisex
Kit,1942,43,12,31,27.906976744186046,72.09302325581395,Unisex
Farrell,1942,78,15,63,19.23076923076924,80.76923076923077,Unisex
Larrie,1942,51,11,40,21.5686274509804,78.43137254901961,Unisex
Rosario,1942,100,62,38,62.0,38.0,Unisex
Deanie,1942,19,14,5,73.68421052631578,26.31578947368421,Unisex
Page,1942,35,21,14,60.0,40.0,Unisex
Robin,1942,567,310,257,54.673721340388006,45.326278659612,Unisex
Santos,1942,152,49,103,32.23684210526316,67.76315789473685,Unisex
Tobie,1942,15,7,8,46.66666666666666,53.333333333333336,Unisex
Zellie,1943,5,5,0,100.0,0.0,Female
Romayne,1943,17,17,0,100.0,0.0,Female
Loistine,1943,9,9,0,100.0,0.0,Female
Lucie,1943,37,37,0,100.0,0.0,Female
Greta,1943,140,140,0,100.0,0.0,Female
Walta,1943,7,7,0,100.0,0.0,Female
Adel,1943,9,9,0,100.0,0.0,Female
Jewelene,1943,13,13,0,100.0,0.0,Female
Laraine,1943,163,163,0,100.0,0.0,Female
Glenys,1943,5,5,0,100.0,0.0,Female
Desiree,1943,8,8,0,100.0,0.0,Female
Percilla,1943,6,6,0,100.0,0.0,Female
Rayann,1943,6,6,0,100.0,0.0,Female
Jerrianne,1943,8,8,0,100.0,0.0,Female
Ladoris,1943,7,7,0,100.0,0.0,Female
Oliva,1943,6,6,0,100.0,0.0,Female
Janiece,1943,33,33,0,100.0,0.0,Female
Madell,1943,6,6,0,100.0,0.0,Female
Armie,1943,6,6,0,100.0,0.0,Female
Deeann,1943,22,22,0,100.0,0.0,Female
Shareen,1943,8,8,0,100.0,0.0,Female
Gwendlyn,1943,8,8,0,100.0,0.0,Female
Lynne,1943,1329,1311,18,98.64559819413093,1.3544018058690743,Female
Verlaine,1943,8,8,0,100.0,0.0,Female
Claudine,1943,143,143,0,100.0,0.0,Female
Arla,1943,58,58,0,100.0,0.0,Female
Joleen,1943,36,36,0,100.0,0.0,Female
Janita,1943,11,11,0,100.0,0.0,Female
Flor,1943,6,6,0,100.0,0.0,Female
Aleatha,1943,10,10,0,100.0,0.0,Female
Benoit,1943,5,0,5,0.0,100.0,Male
Arthur,1943,7827,42,7785,0.536604062859333,99.46339593714066,Male
Marcus,1943,282,0,282,0.0,100.0,Male
Gregg,1943,116,0,116,0.0,100.0,Male
Moody,1943,9,0,9,0.0,100.0,Male
Otho,1943,41,0,41,0.0,100.0,Male
Fitz,1943,7,0,7,0.0,100.0,Male
Gearld,1943,112,0,112,0.0,100.0,Male
Corbitt,1943,7,0,7,0.0,100.0,Male
Dewayne,1943,163,0,163,0.0,100.0,Male
Efrain,1943,23,0,23,0.0,100.0,Male
Aldon,1943,22,0,22,0.0,100.0,Male
Gillie,1943,8,0,8,0.0,100.0,Male
Duaine,1943,18,0,18,0.0,100.0,Male
Jacob,1943,476,0,476,0.0,100.0,Male
Coy,1943,217,16,201,7.373271889400922,92.62672811059907,Male
Peder,1943,8,0,8,0.0,100.0,Male
Harry,1943,5743,23,5720,0.4004875500609437,99.59951244993906,Male
Connell,1943,8,0,8,0.0,100.0,Male
Terral,1943,9,0,9,0.0,100.0,Male
Marsden,1943,7,0,7,0.0,100.0,Male
Matt,1943,63,0,63,0.0,100.0,Male
Kieth,1943,19,0,19,0.0,100.0,Male
Stancil,1943,5,0,5,0.0,100.0,Male
Gavin,1943,6,0,6,0.0,100.0,Male
Edmund,1943,666,0,666,0.0,100.0,Male
Rob,1943,21,0,21,0.0,100.0,Male
Valton,1943,5,0,5,0.0,100.0,Male
Wash,1943,10,0,10,0.0,100.0,Male
Mikal,1943,6,0,6,0.0,100.0,Male
San,1943,11,6,5,54.54545454545454,45.45454545454545,Unisex
Jimmie,1943,3207,578,2629,18.023074524477707,81.9769254755223,Unisex
Lavelle,1943,27,19,8,70.37037037037037,29.629629629629623,Unisex
Allison,1943,72,38,34,52.77777777777778,47.22222222222222,Unisex
Avery,1943,97,21,76,21.649484536082475,78.35051546391753,Unisex
Deon,1943,19,8,11,42.10526315789473,57.89473684210527,Unisex
Arlyn,1943,51,10,41,19.607843137254903,80.3921568627451,Unisex
Pernell,1943,26,11,15,42.30769230769231,57.692307692307686,Unisex
Ebbie,1943,15,9,6,60.0,40.0,Unisex
Gennie,1943,34,25,9,73.52941176470588,26.47058823529412,Unisex
Jearl,1943,20,7,13,35.0,65.0,Unisex
Lamoyne,1943,13,5,8,38.46153846153847,61.53846153846154,Unisex
Delane,1943,26,11,15,42.30769230769231,57.692307692307686,Unisex
Bernell,1943,24,7,17,29.166666666666668,70.83333333333334,Unisex
Marlyn,1943,178,138,40,77.52808988764045,22.47191011235955,Unisex
Luverne,1943,21,5,16,23.809523809523807,76.19047619047619,Unisex
Merlyn,1943,95,25,70,26.31578947368421,73.68421052631578,Unisex
Irby,1943,16,5,11,31.25,68.75,Unisex
Kit,1943,58,14,44,24.13793103448276,75.86206896551724,Unisex
Gaylen,1943,52,14,38,26.923076923076923,73.07692307692307,Unisex
Lyndall,1943,32,19,13,59.375,40.625,Unisex
Tomie,1943,16,6,10,37.5,62.5,Unisex
Weslie,1943,12,5,7,41.66666666666667,58.333333333333336,Unisex
Lupe,1943,497,353,144,71.0261569416499,28.973843058350106,Unisex
Lyndal,1943,23,9,14,39.130434782608695,60.86956521739131,Unisex
Val,1943,87,16,71,18.39080459770115,81.60919540229885,Unisex
Earlie,1943,61,24,37,39.34426229508197,60.65573770491803,Unisex
Johnie,1943,279,60,219,21.50537634408602,78.49462365591397,Unisex
Burnis,1943,24,6,18,25.0,75.0,Unisex
Michel,1943,96,19,77,19.791666666666664,80.20833333333334,Unisex
Harriett,1944,309,309,0,100.0,0.0,Female
Ellouise,1944,23,23,0,100.0,0.0,Female
Gaylynn,1944,6,6,0,100.0,0.0,Female
Vernice,1944,95,84,11,88.42105263157895,11.578947368421051,Female
Sanna,1944,10,10,0,100.0,0.0,Female
Alyce,1944,215,215,0,100.0,0.0,Female
Elaine,1944,5647,5628,19,99.66353816185584,0.3364618381441473,Female
Elsie,1944,1104,1095,9,99.18478260869566,0.8152173913043478,Female
Sula,1944,17,17,0,100.0,0.0,Female
Glennell,1944,5,5,0,100.0,0.0,Female
Bobbye,1944,66,59,7,89.39393939393939,10.606060606060606,Female
Margarite,1944,28,28,0,100.0,0.0,Female
Glenna,1944,512,512,0,100.0,0.0,Female
Cleona,1944,6,6,0,100.0,0.0,Female
Fanny,1944,36,36,0,100.0,0.0,Female
Marlaine,1944,7,7,0,100.0,0.0,Female
Arloa,1944,7,7,0,100.0,0.0,Female
Vianna,1944,5,5,0,100.0,0.0,Female
Ernesteen,1944,11,11,0,100.0,0.0,Female
Melonie,1944,8,8,0,100.0,0.0,Female
Junell,1944,5,5,0,100.0,0.0,Female
Trecia,1944,6,6,0,100.0,0.0,Female
Delorse,1944,18,18,0,100.0,0.0,Female
Liana,1944,17,17,0,100.0,0.0,Female
Madoline,1944,5,5,0,100.0,0.0,Female
Sharel,1944,8,8,0,100.0,0.0,Female
Margery,1944,242,242,0,100.0,0.0,Female
Oma,1944,72,72,0,100.0,0.0,Female
Rudene,1944,11,11,0,100.0,0.0,Female
Othella,1944,6,6,0,100.0,0.0,Female
Gunnar,1944,10,0,10,0.0,100.0,Male
Roman,1944,90,0,90,0.0,100.0,Male
Hammond,1944,5,0,5,0.0,100.0,Male
Nathaniel,1944,873,9,864,1.0309278350515465,98.96907216494846,Male
Larwence,1944,12,0,12,0.0,100.0,Male
Uvaldo,1944,10,0,10,0.0,100.0,Male
Kennth,1944,16,0,16,0.0,100.0,Male
Delbert,1944,745,0,745,0.0,100.0,Male
Gilbert,1944,1659,10,1649,0.6027727546714888,99.39722724532852,Male
Ted,1944,1174,8,1166,0.6814310051107325,99.31856899488926,Male
Miquel,1944,5,0,5,0.0,100.0,Male
Ferrell,1944,30,0,30,0.0,100.0,Male
Williard,1944,11,0,11,0.0,100.0,Male
Marquis,1944,8,0,8,0.0,100.0,Male
Branson,1944,8,0,8,0.0,100.0,Male
Dicky,1944,30,0,30,0.0,100.0,Male
Harl,1944,10,0,10,0.0,100.0,Male
Clive,1944,24,0,24,0.0,100.0,Male
Valentin,1944,17,0,17,0.0,100.0,Male
Darrel,1944,474,5,469,1.0548523206751057,98.94514767932488,Male
Odis,1944,111,7,104,6.306306306306306,93.69369369369367,Male
Adolfo,1944,64,0,64,0.0,100.0,Male
Foster,1944,107,0,107,0.0,100.0,Male
Nate,1944,6,0,6,0.0,100.0,Male
Orrin,1944,44,0,44,0.0,100.0,Male
Elvon,1944,5,0,5,0.0,100.0,Male
Carmelo,1944,17,0,17,0.0,100.0,Male
Eleno,1944,7,0,7,0.0,100.0,Male
Cliston,1944,5,0,5,0.0,100.0,Male
Rolin,1944,6,0,6,0.0,100.0,Male
Matilde,1944,29,22,7,75.86206896551724,24.13793103448276,Unisex
Rickie,1944,89,30,59,33.70786516853933,66.29213483146067,Unisex
Vester,1944,31,9,22,29.03225806451613,70.96774193548387,Unisex
Toy,1944,25,8,17,32.0,68.0,Unisex
Pilar,1944,23,12,11,52.17391304347826,47.82608695652174,Unisex
Laverne,1944,709,517,192,72.91960507757405,27.08039492242596,Unisex
Marrion,1944,17,11,6,64.70588235294117,35.294117647058826,Unisex
Luverne,1944,21,9,12,42.85714285714285,57.14285714285714,Unisex
Barrie,1944,56,28,28,50.0,50.0,Unisex
Odie,1944,27,7,20,25.925925925925924,74.07407407407408,Unisex
Artis,1944,79,23,56,29.11392405063291,70.88607594936708,Unisex
Estell,1944,37,26,11,70.27027027027027,29.72972972972973,Unisex
Lavone,1944,19,14,5,73.68421052631578,26.31578947368421,Unisex
Allie,1944,125,103,22,82.39999999999999,17.599999999999998,Unisex
Danne,1944,15,10,5,66.66666666666666,33.33333333333333,Unisex
Cordie,1944,15,8,7,53.333333333333336,46.66666666666666,Unisex
Hollis,1944,223,59,164,26.45739910313901,73.54260089686099,Unisex
Christy,1944,90,69,21,76.66666666666667,23.33333333333333,Unisex
Stacy,1944,76,21,55,27.631578947368425,72.36842105263158,Unisex
Dayle,1944,63,42,21,66.66666666666666,33.33333333333333,Unisex
Augustine,1944,147,54,93,36.734693877551024,63.26530612244898,Unisex
Michal,1944,47,26,21,55.319148936170215,44.680851063829785,Unisex
Paige,1944,32,24,8,75.0,25.0,Unisex
Lesley,1944,199,129,70,64.82412060301507,35.175879396984925,Unisex
Ocie,1944,67,39,28,58.2089552238806,41.7910447761194,Unisex
Myrle,1944,30,16,14,53.333333333333336,46.66666666666666,Unisex
Marlyn,1944,142,110,32,77.46478873239437,22.53521126760564,Unisex
Marion,1944,2758,1803,955,65.37345902828136,34.62654097171864,Unisex
Meredith,1944,392,328,64,83.6734693877551,16.3265306122449,Unisex
Robby,1944,26,8,18,30.76923076923077,69.23076923076923,Unisex
Irean,1945,7,7,0,100.0,0.0,Female
Arbutus,1945,12,12,0,100.0,0.0,Female
Gloris,1945,7,7,0,100.0,0.0,Female
Tabitha,1945,5,5,0,100.0,0.0,Female
Saralee,1945,15,15,0,100.0,0.0,Female
Bella,1945,13,13,0,100.0,0.0,Female
Bettye,1945,669,669,0,100.0,0.0,Female
Melaine,1945,7,7,0,100.0,0.0,Female
Antonette,1945,48,48,0,100.0,0.0,Female
Donnamarie,1945,11,11,0,100.0,0.0,Female
Celene,1945,5,5,0,100.0,0.0,Female
Charlice,1945,5,5,0,100.0,0.0,Female
Elona,1945,20,20,0,100.0,0.0,Female
Sherlene,1945,15,15,0,100.0,0.0,Female
Kathern,1945,42,42,0,100.0,0.0,Female
Nonie,1945,10,10,0,100.0,0.0,Female
Angle,1945,5,5,0,100.0,0.0,Female
Neida,1945,6,6,0,100.0,0.0,Female
Lauren,1945,443,381,62,86.00451467268623,13.99548532731377,Female
Mollie,1945,215,215,0,100.0,0.0,Female
Memory,1945,11,11,0,100.0,0.0,Female
Anneta,1945,9,9,0,100.0,0.0,Female
Verneta,1945,5,5,0,100.0,0.0,Female
Rilda,1945,5,5,0,100.0,0.0,Female
Manya,1945,8,8,0,100.0,0.0,Female
Pandora,1945,19,19,0,100.0,0.0,Female
Janette,1945,301,301,0,100.0,0.0,Female
Elzia,1945,5,5,0,100.0,0.0,Female
Rosalita,1945,21,21,0,100.0,0.0,Female
Jocarol,1945,8,8,0,100.0,0.0,Female
Rodrick,1945,25,0,25,0.0,100.0,Male
Norman,1945,3741,16,3725,0.4276931301790965,99.5723068698209,Male
Moshe,1945,6,0,6,0.0,100.0,Male
Starlin,1945,6,0,6,0.0,100.0,Male
Mike,1945,3609,17,3592,0.4710446106954835,99.52895538930451,Male
Benjaman,1945,10,0,10,0.0,100.0,Male
Redell,1945,6,0,6,0.0,100.0,Male
Rector,1945,5,0,5,0.0,100.0,Male
Rodger,1945,551,0,551,0.0,100.0,Male
Maxey,1945,14,0,14,0.0,100.0,Male
Harvey,1945,1989,15,1974,0.7541478129713424,99.24585218702866,Male
Prentiss,1945,19,0,19,0.0,100.0,Male
Gualberto,1945,5,0,5,0.0,100.0,Male
Orson,1945,16,0,16,0.0,100.0,Male
Jeston,1945,5,0,5,0.0,100.0,Male
Arcadio,1945,9,0,9,0.0,100.0,Male
Timm,1945,17,0,17,0.0,100.0,Male
Bartlett,1945,8,0,8,0.0,100.0,Male
Enos,1945,21,0,21,0.0,100.0,Male
Jerry,1945,15118,414,14704,2.7384574679190368,97.26154253208097,Male
Julian,1945,477,15,462,3.1446540880503147,96.85534591194968,Male
Jobie,1945,9,0,9,0.0,100.0,Male
Clemens,1945,13,0,13,0.0,100.0,Male
Rock,1945,7,0,7,0.0,100.0,Male
Dwight,1945,1753,0,1753,0.0,100.0,Male
Augusto,1945,6,0,6,0.0,100.0,Male
Billy,1945,6082,63,6019,1.035843472541927,98.96415652745809,Male
Norvel,1945,15,0,15,0.0,100.0,Male
Abelardo,1945,30,0,30,0.0,100.0,Male
Raliegh,1945,6,0,6,0.0,100.0,Male
Ellie,1945,53,42,11,79.24528301886792,20.75471698113208,Unisex
Carle,1945,18,5,13,27.77777777777778,72.22222222222221,Unisex
Artie,1945,120,60,60,50.0,50.0,Unisex
Glendale,1945,13,6,7,46.15384615384615,53.84615384615385,Unisex
Lavelle,1945,18,10,8,55.55555555555556,44.44444444444444,Unisex
Sunny,1945,71,60,11,84.50704225352112,15.492957746478872,Unisex
Oree,1945,11,5,6,45.45454545454545,54.54545454545454,Unisex
Theo,1945,101,53,48,52.47524752475248,47.52475247524752,Unisex
Hollie,1945,43,18,25,41.86046511627907,58.13953488372093,Unisex
Carrol,1945,281,173,108,61.56583629893239,38.43416370106761,Unisex
Ossie,1945,51,31,20,60.78431372549019,39.21568627450981,Unisex
Nieves,1945,13,5,8,38.46153846153847,61.53846153846154,Unisex
Levon,1945,40,9,31,22.5,77.5,Unisex
Johnnie,1945,2535,935,1600,36.883629191321496,63.1163708086785,Unisex
Golden,1945,24,7,17,29.166666666666668,70.83333333333334,Unisex
Stacey,1945,43,23,20,53.48837209302325,46.51162790697674,Unisex
Glendell,1945,16,6,10,37.5,62.5,Unisex
Frankie,1945,1087,509,578,46.82612695492181,53.1738730450782,Unisex
Kelsie,1945,12,5,7,41.66666666666667,58.333333333333336,Unisex
Niki,1945,26,21,5,80.76923076923077,19.23076923076924,Unisex
Devon,1945,53,20,33,37.735849056603776,62.264150943396224,Unisex
Marlyn,1945,119,78,41,65.54621848739495,34.45378151260504,Unisex
Lennis,1945,25,7,18,28.000000000000004,72.0,Unisex
Marvel,1945,55,44,11,80.0,20.0,Unisex
Clemmie,1945,50,35,15,70.0,30.0,Unisex
Shaun,1945,21,6,15,28.57142857142857,71.42857142857143,Unisex
Carroll,1945,810,163,647,20.123456790123456,79.87654320987654,Unisex
Ricki,1945,58,42,16,72.41379310344827,27.58620689655172,Unisex
Marcell,1945,24,15,9,62.5,37.5,Unisex
Jonnie,1945,146,99,47,67.8082191780822,32.19178082191781,Unisex
Llona,1946,9,9,0,100.0,0.0,Female
Sherrey,1946,6,6,0,100.0,0.0,Female
Noretta,1946,7,7,0,100.0,0.0,Female
Daisy,1946,579,579,0,100.0,0.0,Female
Pearl,1946,700,678,22,96.85714285714285,3.1428571428571432,Female
Teddi,1946,7,7,0,100.0,0.0,Female
Lossie,1946,5,5,0,100.0,0.0,Female
Ruthy,1946,13,13,0,100.0,0.0,Female
Vikki,1946,65,65,0,100.0,0.0,Female
Adelia,1946,40,40,0,100.0,0.0,Female
Clelia,1946,6,6,0,100.0,0.0,Female
Vernalee,1946,6,6,0,100.0,0.0,Female
Denice,1946,54,54,0,100.0,0.0,Female
Darline,1946,76,76,0,100.0,0.0,Female
Balbina,1946,5,5,0,100.0,0.0,Female
Avelina,1946,12,12,0,100.0,0.0,Female
Jennice,1946,6,6,0,100.0,0.0,Female
Reida,1946,11,11,0,100.0,0.0,Female
Sherron,1946,122,117,5,95.90163934426228,4.098360655737705,Female
Odester,1946,5,5,0,100.0,0.0,Female
Annarose,1946,5,5,0,100.0,0.0,Female
Cheralyn,1946,7,7,0,100.0,0.0,Female
Annamary,1946,7,7,0,100.0,0.0,Female
Ellouise,1946,12,12,0,100.0,0.0,Female
Cora,1946,799,799,0,100.0,0.0,Female
Orva,1946,5,5,0,100.0,0.0,Female
Arlyce,1946,13,13,0,100.0,0.0,Female
Moreen,1946,6,6,0,100.0,0.0,Female
Romana,1946,16,16,0,100.0,0.0,Female
Ponda,1946,5,5,0,100.0,0.0,Female
Chalmers,1946,16,0,16,0.0,100.0,Male
Lynnwood,1946,6,0,6,0.0,100.0,Male
Dahl,1946,5,0,5,0.0,100.0,Male
Merton,1946,35,0,35,0.0,100.0,Male
Shelton,1946,88,0,88,0.0,100.0,Male
Monte,1946,238,14,224,5.88235294117647,94.11764705882352,Male
Steward,1946,12,0,12,0.0,100.0,Male
Tellis,1946,5,0,5,0.0,100.0,Male
Lonzie,1946,7,0,7,0.0,100.0,Male
Pink,1946,7,0,7,0.0,100.0,Male
Amadeo,1946,5,0,5,0.0,100.0,Male
Felton,1946,97,0,97,0.0,100.0,Male
Rawley,1946,9,0,9,0.0,100.0,Male
Woody,1946,116,0,116,0.0,100.0,Male
Hardie,1946,6,0,6,0.0,100.0,Male
Lorin,1946,75,0,75,0.0,100.0,Male
Feliciano,1946,13,0,13,0.0,100.0,Male
Talmadge,1946,63,0,63,0.0,100.0,Male
Verland,1946,7,0,7,0.0,100.0,Male
Barre,1946,6,0,6,0.0,100.0,Male
Lowell,1946,657,7,650,1.06544901065449,98.93455098934552,Male
Burdell,1946,8,0,8,0.0,100.0,Male
Leonel,1946,36,0,36,0.0,100.0,Male
Leotis,1946,11,0,11,0.0,100.0,Male
Federico,1946,53,0,53,0.0,100.0,Male
Harrie,1946,13,0,13,0.0,100.0,Male
Julius,1946,551,7,544,1.2704174228675136,98.72958257713248,Male
Winston,1946,278,7,271,2.517985611510792,97.48201438848922,Male
Alvie,1946,67,7,60,10.44776119402985,89.55223880597015,Male
Byron,1946,786,0,786,0.0,100.0,Male
Carmel,1946,82,64,18,78.04878048780488,21.951219512195124,Unisex
Eura,1946,14,8,6,57.14285714285714,42.85714285714285,Unisex
Artie,1946,96,43,53,44.79166666666667,55.208333333333336,Unisex
Artis,1946,98,18,80,18.367346938775512,81.63265306122449,Unisex
Allyn,1946,98,27,71,27.55102040816326,72.44897959183673,Unisex
Lavon,1946,114,76,38,66.66666666666666,33.33333333333333,Unisex
Shellie,1946,34,26,8,76.47058823529412,23.52941176470588,Unisex
Ricki,1946,69,45,24,65.21739130434783,34.78260869565217,Unisex
Ivory,1946,145,52,93,35.86206896551724,64.13793103448275,Unisex
Daryle,1946,43,14,29,32.55813953488372,67.44186046511628,Unisex
Carmon,1946,20,6,14,30.0,70.0,Unisex
Vernel,1946,14,6,8,42.85714285714285,57.14285714285714,Unisex
Loris,1946,39,22,17,56.41025641025641,43.58974358974359,Unisex
Myrle,1946,36,21,15,58.333333333333336,41.66666666666667,Unisex
Lavern,1946,241,113,128,46.88796680497925,53.11203319502075,Unisex
Willie,1946,9026,1687,7339,18.69044981165522,81.30955018834479,Unisex
Davie,1946,52,11,41,21.15384615384616,78.84615384615384,Unisex
Shirl,1946,24,14,10,58.333333333333336,41.66666666666667,Unisex
Teryl,1946,25,18,7,72.0,28.000000000000004,Unisex
Leigh,1946,209,124,85,59.33014354066985,40.66985645933015,Unisex
Murl,1946,30,11,19,36.66666666666666,63.33333333333333,Unisex
Ossie,1946,48,27,21,56.25,43.75,Unisex
Tobie,1946,17,12,5,70.58823529411765,29.411764705882355,Unisex
Burnette,1946,16,8,8,50.0,50.0,Unisex
Jere,1946,121,26,95,21.487603305785125,78.51239669421489,Unisex
Raye,1946,52,42,10,80.76923076923077,19.23076923076924,Unisex
Jule,1946,40,23,17,57.49999999999999,42.5,Unisex
Mikell,1946,11,5,6,45.45454545454545,54.54545454545454,Unisex
Arie,1946,28,21,7,75.0,25.0,Unisex
Ladell,1946,17,7,10,41.17647058823529,58.82352941176471,Unisex
Melinda,1947,696,696,0,100.0,0.0,Female
Jeanna,1947,42,42,0,100.0,0.0,Female
Chessie,1947,5,5,0,100.0,0.0,Female
Florine,1947,133,133,0,100.0,0.0,Female
Lauraine,1947,13,13,0,100.0,0.0,Female
Jillene,1947,9,9,0,100.0,0.0,Female
Suszanne,1947,6,6,0,100.0,0.0,Female
Riki,1947,6,6,0,100.0,0.0,Female
Margetta,1947,5,5,0,100.0,0.0,Female
Doria,1947,25,25,0,100.0,0.0,Female
Mariette,1947,19,19,0,100.0,0.0,Female
Freddi,1947,5,5,0,100.0,0.0,Female
Ofelia,1947,122,122,0,100.0,0.0,Female
Nelsie,1947,5,5,0,100.0,0.0,Female
Avelina,1947,10,10,0,100.0,0.0,Female
Aleda,1947,16,16,0,100.0,0.0,Female
Claudia,1947,2776,2766,10,99.63976945244956,0.3602305475504322,Female
Sherley,1947,30,30,0,100.0,0.0,Female
Rexine,1947,5,5,0,100.0,0.0,Female
Isabell,1947,77,77,0,100.0,0.0,Female
Garnetta,1947,15,15,0,100.0,0.0,Female
Lillie,1947,1446,1440,6,99.5850622406639,0.4149377593360996,Female
Johna,1947,13,13,0,100.0,0.0,Female
Dorothye,1947,9,9,0,100.0,0.0,Female
Bonetta,1947,5,5,0,100.0,0.0,Female
Carolle,1947,9,9,0,100.0,0.0,Female
Annette,1947,2152,2144,8,99.62825278810408,0.3717472118959107,Female
Lucilla,1947,11,11,0,100.0,0.0,Female
Marilou,1947,79,79,0,100.0,0.0,Female
Sharleen,1947,59,59,0,100.0,0.0,Female
Renard,1947,22,0,22,0.0,100.0,Male
Reymundo,1947,35,0,35,0.0,100.0,Male
Eladio,1947,5,0,5,0.0,100.0,Male
Wadell,1947,7,0,7,0.0,100.0,Male
Rainey,1947,5,0,5,0.0,100.0,Male
Felton,1947,108,0,108,0.0,100.0,Male
Wendel,1947,29,0,29,0.0,100.0,Male
Dorman,1947,22,0,22,0.0,100.0,Male
Herbie,1947,23,0,23,0.0,100.0,Male
Carmello,1947,5,0,5,0.0,100.0,Male
Benoit,1947,8,0,8,0.0,100.0,Male
Coolidge,1947,5,0,5,0.0,100.0,Male
Leeland,1947,5,0,5,0.0,100.0,Male
Peter,1947,8610,19,8591,0.2206736353077816,99.77932636469222,Male
Bill,1947,4688,7,4681,0.1493174061433447,99.85068259385666,Male
Evans,1947,56,0,56,0.0,100.0,Male
Arnaldo,1947,8,0,8,0.0,100.0,Male
Elbert,1947,461,6,455,1.3015184381778742,98.69848156182212,Male
Johnn,1947,17,0,17,0.0,100.0,Male
Kennith,1947,194,0,194,0.0,100.0,Male
Lewis,1947,2453,14,2439,0.5707297187117816,99.4292702812882,Male
Yancey,1947,8,0,8,0.0,100.0,Male
Porter,1947,59,0,59,0.0,100.0,Male
Alphonso,1947,203,0,203,0.0,100.0,Male
Garey,1947,56,0,56,0.0,100.0,Male
Lenzie,1947,8,0,8,0.0,100.0,Male
Francisco,1947,559,0,559,0.0,100.0,Male
Raynold,1947,11,0,11,0.0,100.0,Male
Baxter,1947,40,0,40,0.0,100.0,Male
Burlon,1947,6,0,6,0.0,100.0,Male
Dayne,1947,18,5,13,27.77777777777778,72.22222222222221,Unisex
Lin,1947,38,19,19,50.0,50.0,Unisex
Richie,1947,57,9,48,15.789473684210526,84.21052631578947,Unisex
Teddie,1947,40,21,19,52.5,47.5,Unisex
Robie,1947,15,6,9,40.0,60.0,Unisex
Caroll,1947,63,53,10,84.12698412698413,15.873015873015872,Unisex
Laverne,1947,780,603,177,77.3076923076923,22.692307692307693,Unisex
Michal,1947,75,45,30,60.0,40.0,Unisex
Leslie,1947,4663,2358,2305,50.56830366716706,49.43169633283294,Unisex
Nieves,1947,19,10,9,52.63157894736842,47.368421052631575,Unisex
Verlyn,1947,34,14,20,41.17647058823529,58.82352941176471,Unisex
Merril,1947,17,8,9,47.05882352941176,52.94117647058824,Unisex
Adell,1947,81,63,18,77.77777777777779,22.22222222222222,Unisex
Garen,1947,15,5,10,33.33333333333333,66.66666666666666,Unisex
Meredith,1947,439,346,93,78.81548974943053,21.18451025056948,Unisex
Rudell,1947,10,5,5,50.0,50.0,Unisex
Dee,1947,476,356,120,74.78991596638656,25.210084033613445,Unisex
Lyndall,1947,26,19,7,73.07692307692307,26.923076923076923,Unisex
Cam,1947,10,5,5,50.0,50.0,Unisex
Artha,1947,19,11,8,57.89473684210527,42.10526315789473,Unisex
Tharon,1947,12,5,7,41.66666666666667,58.333333333333336,Unisex
Vennie,1947,18,13,5,72.22222222222221,27.77777777777778,Unisex
Elza,1947,23,7,16,30.434782608695656,69.56521739130434,Unisex
Lauris,1947,12,6,6,50.0,50.0,Unisex
Willia,1947,66,56,10,84.84848484848484,15.151515151515152,Unisex
Arlyn,1947,66,18,48,27.27272727272727,72.72727272727273,Unisex
Leverne,1947,32,14,18,43.75,56.25,Unisex
Elvie,1947,20,13,7,65.0,35.0,Unisex
Lyndell,1947,48,22,26,45.83333333333333,54.16666666666666,Unisex
Larrie,1947,34,11,23,32.35294117647059,67.64705882352942,Unisex
Odessie,1948,6,6,0,100.0,0.0,Female
Marthella,1948,6,6,0,100.0,0.0,Female
Merva,1948,5,5,0,100.0,0.0,Female
Carlota,1948,16,16,0,100.0,0.0,Female
Maggie,1948,483,483,0,100.0,0.0,Female
Shawnee,1948,5,5,0,100.0,0.0,Female
Barba,1948,7,7,0,100.0,0.0,Female
Opal,1948,260,260,0,100.0,0.0,Female
Ludie,1948,16,16,0,100.0,0.0,Female
Merrilyn,1948,30,30,0,100.0,0.0,Female
Suzy,1948,46,46,0,100.0,0.0,Female
Janae,1948,8,8,0,100.0,0.0,Female
Rosalva,1948,8,8,0,100.0,0.0,Female
Debbe,1948,9,9,0,100.0,0.0,Female
Jani,1948,7,7,0,100.0,0.0,Female
Hilarie,1948,7,7,0,100.0,0.0,Female
Cathe,1948,6,6,0,100.0,0.0,Female
Gaynel,1948,5,5,0,100.0,0.0,Female
Lounell,1948,6,6,0,100.0,0.0,Female
Marguarite,1948,7,7,0,100.0,0.0,Female
Ricarda,1948,18,18,0,100.0,0.0,Female
Karolee,1948,5,5,0,100.0,0.0,Female
Darlette,1948,5,5,0,100.0,0.0,Female
Andrea,1948,2383,2366,17,99.28661351237936,0.7133864876206463,Female
Docia,1948,8,8,0,100.0,0.0,Female
Bethe,1948,5,5,0,100.0,0.0,Female
Karna,1948,6,6,0,100.0,0.0,Female
Rosaria,1948,19,19,0,100.0,0.0,Female
Marionette,1948,6,6,0,100.0,0.0,Female
Bruna,1948,6,6,0,100.0,0.0,Female
Rockford,1948,11,0,11,0.0,100.0,Male
Jamieson,1948,5,0,5,0.0,100.0,Male
Delvin,1948,33,0,33,0.0,100.0,Male
Tyree,1948,29,0,29,0.0,100.0,Male
Reyes,1948,67,9,58,13.432835820895525,86.56716417910447,Male
Sheldon,1948,406,5,401,1.2315270935960592,98.76847290640394,Male
Sotero,1948,5,0,5,0.0,100.0,Male
Alvan,1948,10,0,10,0.0,100.0,Male
Boston,1948,7,0,7,0.0,100.0,Male
Verlon,1948,21,0,21,0.0,100.0,Male
Loy,1948,74,10,64,13.513513513513514,86.48648648648648,Male
Leemon,1948,8,0,8,0.0,100.0,Male
Redden,1948,5,0,5,0.0,100.0,Male
Ladd,1948,19,0,19,0.0,100.0,Male
Lucien,1948,78,0,78,0.0,100.0,Male
Moses,1948,316,0,316,0.0,100.0,Male
Minor,1948,18,0,18,0.0,100.0,Male
Donny,1948,216,0,216,0.0,100.0,Male
Henley,1948,10,0,10,0.0,100.0,Male
Otho,1948,28,0,28,0.0,100.0,Male
Javier,1948,106,0,106,0.0,100.0,Male
Isom,1948,17,0,17,0.0,100.0,Male
Eliga,1948,6,0,6,0.0,100.0,Male
Artemio,1948,12,0,12,0.0,100.0,Male
Melford,1948,22,0,22,0.0,100.0,Male
Clois,1948,10,0,10,0.0,100.0,Male
Henderson,1948,39,0,39,0.0,100.0,Male
Raymond,1948,11650,38,11612,0.3261802575107296,99.67381974248929,Male
Levy,1948,20,0,20,0.0,100.0,Male
Chapman,1948,8,0,8,0.0,100.0,Male
Pat,1948,1845,1249,596,67.69647696476964,32.30352303523036,Unisex
Daris,1948,19,11,8,57.89473684210527,42.10526315789473,Unisex
Waverly,1948,42,9,33,21.428571428571427,78.57142857142857,Unisex
Johnell,1948,20,6,14,30.0,70.0,Unisex
Johnnie,1948,2666,887,1779,33.27081770442611,66.72918229557389,Unisex
Lannie,1948,62,21,41,33.87096774193548,66.12903225806451,Unisex
Tommie,1948,926,274,652,29.58963282937365,70.41036717062636,Unisex
Carlie,1948,30,12,18,40.0,60.0,Unisex
Ronne,1948,15,10,5,66.66666666666666,33.33333333333333,Unisex
Marrion,1948,24,13,11,54.16666666666666,45.83333333333333,Unisex
Kennie,1948,34,9,25,26.47058823529412,73.52941176470588,Unisex
Concepcion,1948,82,69,13,84.14634146341463,15.853658536585366,Unisex
Keven,1948,15,7,8,46.66666666666666,53.333333333333336,Unisex
Augustine,1948,157,51,106,32.48407643312102,67.51592356687898,Unisex
Burnell,1948,52,9,43,17.307692307692307,82.6923076923077,Unisex
Mayo,1948,14,5,9,35.714285714285715,64.28571428571429,Unisex
Hilary,1948,102,61,41,59.80392156862745,40.19607843137255,Unisex
Sonnie,1948,13,6,7,46.15384615384615,53.84615384615385,Unisex
France,1948,20,14,6,70.0,30.0,Unisex
Marlo,1948,32,17,15,53.125,46.875,Unisex
Larrie,1948,41,7,34,17.073170731707318,82.92682926829268,Unisex
Brownie,1948,14,8,6,57.14285714285714,42.85714285714285,Unisex
Linn,1948,67,32,35,47.76119402985074,52.23880597014925,Unisex
Ricci,1948,17,6,11,35.294117647058826,64.70588235294117,Unisex
Kelsey,1948,28,9,19,32.142857142857146,67.85714285714286,Unisex
Caroll,1948,45,36,9,80.0,20.0,Unisex
Sherrel,1948,30,24,6,80.0,20.0,Unisex
Randie,1948,32,20,12,62.5,37.5,Unisex
Ardis,1948,108,90,18,83.33333333333334,16.666666666666664,Unisex
Ladon,1948,15,8,7,53.333333333333336,46.66666666666666,Unisex
Esther,1949,1801,1793,8,99.55580233203776,0.4441976679622432,Female
Aura,1949,5,5,0,100.0,0.0,Female
Janan,1949,17,17,0,100.0,0.0,Female
Ione,1949,45,45,0,100.0,0.0,Female
Mahalia,1949,18,18,0,100.0,0.0,Female
Rosaland,1949,7,7,0,100.0,0.0,Female
Georgenia,1949,9,9,0,100.0,0.0,Female
Bonnita,1949,31,31,0,100.0,0.0,Female
Magdelena,1949,5,5,0,100.0,0.0,Female
Iris,1949,931,920,11,98.81847475832438,1.1815252416756177,Female
Philomena,1949,49,49,0,100.0,0.0,Female
Netha,1949,5,5,0,100.0,0.0,Female
Dorianne,1949,5,5,0,100.0,0.0,Female
Marshalene,1949,5,5,0,100.0,0.0,Female
De,1949,5,5,0,100.0,0.0,Female
Beatris,1949,7,7,0,100.0,0.0,Female
Sherlyn,1949,55,55,0,100.0,0.0,Female
Deidre,1949,141,141,0,100.0,0.0,Female
Brenda,1949,20587,20544,43,99.79113032496235,0.2088696750376451,Female
Viviana,1949,6,6,0,100.0,0.0,Female
Vernestine,1949,10,10,0,100.0,0.0,Female
Hyla,1949,8,8,0,100.0,0.0,Female
Wanetta,1949,15,15,0,100.0,0.0,Female
Gleda,1949,5,5,0,100.0,0.0,Female
Milagros,1949,37,37,0,100.0,0.0,Female
Olinda,1949,17,17,0,100.0,0.0,Female
Janie,1949,1737,1737,0,100.0,0.0,Female
Angelia,1949,74,74,0,100.0,0.0,Female
Zadie,1949,19,19,0,100.0,0.0,Female
Evalee,1949,8,8,0,100.0,0.0,Female
Vinton,1949,12,0,12,0.0,100.0,Male
Peyton,1949,25,0,25,0.0,100.0,Male
Usher,1949,9,0,9,0.0,100.0,Male
Nick,1949,446,0,446,0.0,100.0,Male
Alphonse,1949,97,0,97,0.0,100.0,Male
Abner,1949,32,0,32,0.0,100.0,Male
Rodric,1949,8,0,8,0.0,100.0,Male
Holland,1949,13,0,13,0.0,100.0,Male
Brooks,1949,84,0,84,0.0,100.0,Male
Orlan,1949,10,0,10,0.0,100.0,Male
Eldon,1949,339,0,339,0.0,100.0,Male
Curties,1949,6,0,6,0.0,100.0,Male
Hermenegildo,1949,5,0,5,0.0,100.0,Male
Eustace,1949,7,0,7,0.0,100.0,Male
Domenic,1949,71,0,71,0.0,100.0,Male
Castulo,1949,5,0,5,0.0,100.0,Male
Delfino,1949,21,0,21,0.0,100.0,Male
Dain,1949,10,0,10,0.0,100.0,Male
Eduard,1949,8,0,8,0.0,100.0,Male
Aniceto,1949,8,0,8,0.0,100.0,Male
Thad,1949,52,0,52,0.0,100.0,Male
Rolf,1949,56,0,56,0.0,100.0,Male
Simmie,1949,21,0,21,0.0,100.0,Male
Lafayette,1949,54,0,54,0.0,100.0,Male
Maximiliano,1949,9,0,9,0.0,100.0,Male
Davy,1949,16,0,16,0.0,100.0,Male
Randon,1949,9,0,9,0.0,100.0,Male
Connor,1949,9,0,9,0.0,100.0,Male
Wayne,1949,8954,28,8926,0.3127094036184945,99.6872905963815,Male
Jonn,1949,5,0,5,0.0,100.0,Male
Willie,1949,9448,1532,7916,16.21507197290432,83.78492802709569,Unisex
Leslie,1949,4625,2417,2208,52.25945945945946,47.740540540540536,Unisex
Aldine,1949,17,12,5,70.58823529411765,29.411764705882355,Unisex
Brooke,1949,84,67,17,79.76190476190477,20.23809523809524,Unisex
Glennis,1949,79,54,25,68.35443037974683,31.64556962025317,Unisex
Casey,1949,136,21,115,15.441176470588236,84.55882352941177,Unisex
Linnie,1949,88,72,16,81.81818181818183,18.181818181818183,Unisex
Terrill,1949,100,23,77,23.0,77.0,Unisex
Carmon,1949,19,9,10,47.368421052631575,52.63157894736842,Unisex
Bennie,1949,951,143,808,15.036803364879075,84.96319663512094,Unisex
Juel,1949,16,9,7,56.25,43.75,Unisex
Jayme,1949,22,16,6,72.72727272727273,27.27272727272727,Unisex
Tommye,1949,29,24,5,82.75862068965517,17.24137931034483,Unisex
Mickey,1949,769,220,549,28.608582574772434,71.39141742522756,Unisex
Teddie,1949,47,23,24,48.93617021276596,51.06382978723404,Unisex
Barnie,1949,10,5,5,50.0,50.0,Unisex
Kriss,1949,11,5,6,45.45454545454545,54.54545454545454,Unisex
Elvie,1949,20,13,7,65.0,35.0,Unisex
Natividad,1949,47,13,34,27.659574468085108,72.3404255319149,Unisex
Rennie,1949,26,14,12,53.84615384615385,46.15384615384615,Unisex
Binnie,1949,20,15,5,75.0,25.0,Unisex
Cory,1949,43,17,26,39.53488372093023,60.46511627906976,Unisex
Billie,1949,1630,1356,274,83.19018404907975,16.809815950920246,Unisex
Jammie,1949,22,8,14,36.36363636363637,63.63636363636363,Unisex
Deon,1949,26,11,15,42.30769230769231,57.692307692307686,Unisex
Kyle,1949,181,37,144,20.441988950276244,79.55801104972376,Unisex
Vester,1949,36,9,27,25.0,75.0,Unisex
Arden,1949,97,23,74,23.711340206185564,76.28865979381443,Unisex
Arnell,1949,30,17,13,56.66666666666666,43.333333333333336,Unisex
Lindsay,1949,147,83,64,56.4625850340136,43.53741496598639,Unisex
Lovette,1950,5,5,0,100.0,0.0,Female
Lovena,1950,6,6,0,100.0,0.0,Female
Melisa,1950,6,6,0,100.0,0.0,Female
Daphney,1950,6,6,0,100.0,0.0,Female
Azalea,1950,11,11,0,100.0,0.0,Female
Jolena,1950,5,5,0,100.0,0.0,Female
Susa,1950,5,5,0,100.0,0.0,Female
Maretta,1950,25,25,0,100.0,0.0,Female
Violette,1950,12,12,0,100.0,0.0,Female
Lilli,1950,16,16,0,100.0,0.0,Female
Lurline,1950,13,13,0,100.0,0.0,Female
Valaria,1950,5,5,0,100.0,0.0,Female
Melvenia,1950,13,13,0,100.0,0.0,Female
Lovella,1950,15,15,0,100.0,0.0,Female
Dorna,1950,7,7,0,100.0,0.0,Female
Katheryn,1950,178,178,0,100.0,0.0,Female
Kathie,1950,634,634,0,100.0,0.0,Female
Dorma,1950,9,9,0,100.0,0.0,Female
Shelva,1950,18,18,0,100.0,0.0,Female
Theadora,1950,12,12,0,100.0,0.0,Female
Marissa,1950,7,7,0,100.0,0.0,Female
Vada,1950,47,47,0,100.0,0.0,Female
Emmaline,1950,11,11,0,100.0,0.0,Female
Zenia,1950,5,5,0,100.0,0.0,Female
Tanya,1950,354,354,0,100.0,0.0,Female
Nadean,1950,16,16,0,100.0,0.0,Female
Katrinka,1950,7,7,0,100.0,0.0,Female
Evelyne,1950,16,16,0,100.0,0.0,Female
Evelena,1950,19,19,0,100.0,0.0,Female
Stacia,1950,35,35,0,100.0,0.0,Female
Greig,1950,14,0,14,0.0,100.0,Male
Chapman,1950,5,0,5,0.0,100.0,Male
Clearance,1950,7,0,7,0.0,100.0,Male
Sheldon,1950,410,6,404,1.4634146341463417,98.53658536585364,Male
Mal,1950,13,0,13,0.0,100.0,Male
Domenick,1950,47,0,47,0.0,100.0,Male
Godfrey,1950,39,0,39,0.0,100.0,Male
Kerwin,1950,24,0,24,0.0,100.0,Male
Monroe,1950,125,0,125,0.0,100.0,Male
Apolinar,1950,14,0,14,0.0,100.0,Male
Girard,1950,29,0,29,0.0,100.0,Male
Chauncey,1950,48,0,48,0.0,100.0,Male
Ashton,1950,10,0,10,0.0,100.0,Male
Wayland,1950,32,0,32,0.0,100.0,Male
Smitty,1950,14,0,14,0.0,100.0,Male
Abel,1950,170,0,170,0.0,100.0,Male
Herbie,1950,17,0,17,0.0,100.0,Male
Price,1950,27,0,27,0.0,100.0,Male
Samual,1950,52,0,52,0.0,100.0,Male
Jerald,1950,515,6,509,1.1650485436893203,98.83495145631068,Male
Gilbert,1950,1888,7,1881,0.3707627118644068,99.6292372881356,Male
Serafin,1950,13,0,13,0.0,100.0,Male
Franciso,1950,6,0,6,0.0,100.0,Male
Arbie,1950,8,0,8,0.0,100.0,Male
Salem,1950,6,0,6,0.0,100.0,Male
Cipriano,1950,23,0,23,0.0,100.0,Male
Amado,1950,33,0,33,0.0,100.0,Male
Bertis,1950,6,0,6,0.0,100.0,Male
Eleazar,1950,17,0,17,0.0,100.0,Male
Elton,1950,209,0,209,0.0,100.0,Male
Young,1950,26,8,18,30.76923076923077,69.23076923076923,Unisex
Tory,1950,12,7,5,58.333333333333336,41.66666666666667,Unisex
Clovis,1950,36,9,27,25.0,75.0,Unisex
Lannie,1950,114,23,91,20.175438596491222,79.82456140350878,Unisex
Carle,1950,16,5,11,31.25,68.75,Unisex
Cam,1950,16,7,9,43.75,56.25,Unisex
Marlyn,1950,116,88,28,75.86206896551724,24.13793103448276,Unisex
Floy,1950,34,26,8,76.47058823529412,23.52941176470588,Unisex
Quincy,1950,56,9,47,16.071428571428573,83.92857142857143,Unisex
Marvis,1950,47,33,14,70.2127659574468,29.78723404255319,Unisex
Laray,1950,12,5,7,41.66666666666667,58.333333333333336,Unisex
Danne,1950,16,7,9,43.75,56.25,Unisex
Deon,1950,16,8,8,50.0,50.0,Unisex
Dail,1950,16,8,8,50.0,50.0,Unisex
Shane,1950,34,6,28,17.647058823529413,82.35294117647058,Unisex
Shaun,1950,74,16,58,21.62162162162162,78.37837837837837,Unisex
Tandy,1950,21,8,13,38.095238095238095,61.90476190476191,Unisex
Lenn,1950,21,6,15,28.57142857142857,71.42857142857143,Unisex
Lugene,1950,28,10,18,35.714285714285715,64.28571428571429,Unisex
Carley,1950,17,10,7,58.82352941176471,41.17647058823529,Unisex
Artie,1950,107,44,63,41.1214953271028,58.87850467289719,Unisex
Johnie,1950,179,30,149,16.75977653631285,83.24022346368714,Unisex
Layne,1950,78,26,52,33.33333333333333,66.66666666666666,Unisex
Del,1950,93,21,72,22.58064516129032,77.41935483870968,Unisex
Carman,1950,31,18,13,58.06451612903226,41.935483870967744,Unisex
Earnie,1950,38,8,30,21.052631578947366,78.94736842105263,Unisex
Michal,1950,78,41,37,52.56410256410257,47.43589743589743,Unisex
Wynne,1950,26,20,6,76.92307692307693,23.07692307692308,Unisex
Richie,1950,53,9,44,16.9811320754717,83.01886792452831,Unisex
Cameron,1950,109,22,87,20.18348623853211,79.81651376146789,Unisex
Junnie,1951,6,6,0,100.0,0.0,Female
Zeda,1951,8,8,0,100.0,0.0,Female
Kitty,1951,228,228,0,100.0,0.0,Female
Floy,1951,27,27,0,100.0,0.0,Female
Jarilyn,1951,5,5,0,100.0,0.0,Female
Myna,1951,6,6,0,100.0,0.0,Female
Pamella,1951,93,93,0,100.0,0.0,Female
Susanna,1951,123,123,0,100.0,0.0,Female
Minda,1951,38,38,0,100.0,0.0,Female
Mari,1951,224,224,0,100.0,0.0,Female
Brenda,1951,21760,21716,44,99.79779411764706,0.2022058823529412,Female
Sharian,1951,5,5,0,100.0,0.0,Female
Cherrilynn,1951,5,5,0,100.0,0.0,Female
Dea,1951,16,16,0,100.0,0.0,Female
Lili,1951,17,17,0,100.0,0.0,Female
Marcy,1951,375,375,0,100.0,0.0,Female
Janith,1951,9,9,0,100.0,0.0,Female
Lessie,1951,124,113,11,91.12903225806453,8.870967741935484,Female
Denna,1951,23,23,0,100.0,0.0,Female
Gigi,1951,33,33,0,100.0,0.0,Female
Acquanette,1951,8,8,0,100.0,0.0,Female
Carin,1951,52,52,0,100.0,0.0,Female
Lael,1951,19,19,0,100.0,0.0,Female
Wyona,1951,7,7,0,100.0,0.0,Female
Cyndie,1951,10,10,0,100.0,0.0,Female
Sally,1951,5149,5138,11,99.78636628471548,0.2136337152845212,Female
Alvita,1951,6,6,0,100.0,0.0,Female
Arvella,1951,11,11,0,100.0,0.0,Female
Carmelia,1951,8,8,0,100.0,0.0,Female
Deana,1951,124,124,0,100.0,0.0,Female
Kirt,1951,36,0,36,0.0,100.0,Male
Laymond,1951,9,0,9,0.0,100.0,Male
Creed,1951,11,0,11,0.0,100.0,Male
Hermann,1951,6,0,6,0.0,100.0,Male
Darral,1951,5,0,5,0.0,100.0,Male
Blain,1951,16,0,16,0.0,100.0,Male
Jerrol,1951,11,0,11,0.0,100.0,Male
Autrey,1951,6,0,6,0.0,100.0,Male
Pasqual,1951,5,0,5,0.0,100.0,Male
Rober,1951,8,0,8,0.0,100.0,Male
Cliffton,1951,13,0,13,0.0,100.0,Male
Eual,1951,5,0,5,0.0,100.0,Male
Gabino,1951,8,0,8,0.0,100.0,Male
Rayborn,1951,6,0,6,0.0,100.0,Male
Wardell,1951,75,0,75,0.0,100.0,Male
Brennan,1951,5,0,5,0.0,100.0,Male
Alban,1951,6,0,6,0.0,100.0,Male
Stanley,1951,6223,18,6205,0.2892495580909529,99.71075044190904,Male
Cresencio,1951,9,0,9,0.0,100.0,Male
Leocadio,1951,5,0,5,0.0,100.0,Male
Bruce,1951,14124,35,14089,0.2478051543472104,99.75219484565278,Male
Clem,1951,35,0,35,0.0,100.0,Male
Filiberto,1951,14,0,14,0.0,100.0,Male
Kearney,1951,6,0,6,0.0,100.0,Male
General,1951,39,0,39,0.0,100.0,Male
Bedford,1951,12,0,12,0.0,100.0,Male
Delano,1951,18,0,18,0.0,100.0,Male
Silvio,1951,17,0,17,0.0,100.0,Male
Ranny,1951,17,0,17,0.0,100.0,Male
Nolen,1951,17,0,17,0.0,100.0,Male
Robby,1951,42,7,35,16.666666666666664,83.33333333333334,Unisex
Bernell,1951,38,11,27,28.94736842105264,71.05263157894737,Unisex
Dennie,1951,100,20,80,20.0,80.0,Unisex
Terrill,1951,83,21,62,25.301204819277107,74.69879518072288,Unisex
Odean,1951,13,6,7,46.15384615384615,53.84615384615385,Unisex
Lacey,1951,16,6,10,37.5,62.5,Unisex
Arie,1951,21,14,7,66.66666666666666,33.33333333333333,Unisex
Maxie,1951,94,31,63,32.97872340425532,67.02127659574468,Unisex
Shirl,1951,22,14,8,63.63636363636363,36.36363636363637,Unisex
Lexie,1951,38,31,7,81.57894736842105,18.421052631578945,Unisex
Lanis,1951,19,9,10,47.368421052631575,52.63157894736842,Unisex
Courtney,1951,115,38,77,33.04347826086956,66.95652173913044,Unisex
Ozzie,1951,38,9,29,23.684210526315788,76.31578947368422,Unisex
Kelly,1951,865,164,701,18.95953757225433,81.04046242774567,Unisex
Hillary,1951,58,40,18,68.96551724137932,31.03448275862069,Unisex
Mackie,1951,28,5,23,17.857142857142858,82.14285714285714,Unisex
Hilary,1951,131,103,28,78.62595419847328,21.37404580152672,Unisex
Jewel,1951,343,291,52,84.8396501457726,15.160349854227404,Unisex
Mallie,1951,14,6,8,42.85714285714285,57.14285714285714,Unisex
Stacey,1951,156,102,54,65.38461538461539,34.61538461538461,Unisex
Alpha,1951,48,35,13,72.91666666666666,27.08333333333333,Unisex
Arlis,1951,36,12,24,33.33333333333333,66.66666666666666,Unisex
Drue,1951,15,10,5,66.66666666666666,33.33333333333333,Unisex
Lacy,1951,92,17,75,18.47826086956521,81.52173913043478,Unisex
Cheyenne,1951,19,13,6,68.42105263157895,31.57894736842105,Unisex
Marvine,1951,20,12,8,60.0,40.0,Unisex
Teryl,1951,32,26,6,81.25,18.75,Unisex
Kennie,1951,27,8,19,29.629629629629623,70.37037037037037,Unisex
Cory,1951,83,20,63,24.09638554216868,75.90361445783132,Unisex
Ivory,1951,213,55,158,25.821596244131456,74.17840375586854,Unisex
Evyonne,1952,5,5,0,100.0,0.0,Female
Nona,1952,259,259,0,100.0,0.0,Female
Elisse,1952,5,5,0,100.0,0.0,Female
Sophia,1952,110,110,0,100.0,0.0,Female
Terressa,1952,5,5,0,100.0,0.0,Female
Enda,1952,9,9,0,100.0,0.0,Female
Lynne,1952,2272,2265,7,99.6919014084507,0.3080985915492957,Female
Lillian,1952,1733,1733,0,100.0,0.0,Female
Laurelle,1952,9,9,0,100.0,0.0,Female
Tammie,1952,20,20,0,100.0,0.0,Female
Loura,1952,8,8,0,100.0,0.0,Female
Wava,1952,18,18,0,100.0,0.0,Female
Jeanna,1952,40,40,0,100.0,0.0,Female
Babs,1952,8,8,0,100.0,0.0,Female
Leitha,1952,11,11,0,100.0,0.0,Female
Rocio,1952,9,9,0,100.0,0.0,Female
Cherie,1952,453,453,0,100.0,0.0,Female
Lalani,1952,5,5,0,100.0,0.0,Female
Terresa,1952,30,30,0,100.0,0.0,Female
Kristal,1952,8,8,0,100.0,0.0,Female
Esthela,1952,5,5,0,100.0,0.0,Female
Laveta,1952,22,22,0,100.0,0.0,Female
Roselle,1952,20,20,0,100.0,0.0,Female
Martena,1952,6,6,0,100.0,0.0,Female
Carlette,1952,23,23,0,100.0,0.0,Female
Sunshine,1952,8,8,0,100.0,0.0,Female
Mable,1952,323,323,0,100.0,0.0,Female
Marylene,1952,6,6,0,100.0,0.0,Female
Cally,1952,8,8,0,100.0,0.0,Female
Bettyjane,1952,5,5,0,100.0,0.0,Female
Alexandro,1952,14,0,14,0.0,100.0,Male
Humbert,1952,5,0,5,0.0,100.0,Male
Stanford,1952,126,0,126,0.0,100.0,Male
Teofilo,1952,8,0,8,0.0,100.0,Male
Eduardo,1952,174,0,174,0.0,100.0,Male
Franklyn,1952,53,0,53,0.0,100.0,Male
Rockford,1952,10,0,10,0.0,100.0,Male
Benjaman,1952,18,0,18,0.0,100.0,Male
Jaime,1952,228,23,205,10.087719298245611,89.91228070175438,Male
Gavin,1952,38,0,38,0.0,100.0,Male
Delfin,1952,6,0,6,0.0,100.0,Male
Leif,1952,34,0,34,0.0,100.0,Male
Carlous,1952,7,0,7,0.0,100.0,Male
Roland,1952,1280,5,1275,0.390625,99.609375,Male
Martin,1952,4750,14,4736,0.2947368421052632,99.70526315789472,Male
Eriberto,1952,13,0,13,0.0,100.0,Male
Jackey,1952,17,0,17,0.0,100.0,Male
Kenard,1952,7,0,7,0.0,100.0,Male
Courtland,1952,23,0,23,0.0,100.0,Male
Bland,1952,5,0,5,0.0,100.0,Male
Ferman,1952,14,0,14,0.0,100.0,Male
Lindberg,1952,5,0,5,0.0,100.0,Male
Stanton,1952,109,0,109,0.0,100.0,Male
Glen,1952,2515,23,2492,0.9145129224652088,99.0854870775348,Male
Odie,1952,40,5,35,12.5,87.5,Male
Talmage,1952,15,0,15,0.0,100.0,Male
Winfrey,1952,8,0,8,0.0,100.0,Male
Ronold,1952,23,0,23,0.0,100.0,Male
Lanier,1952,19,0,19,0.0,100.0,Male
Bartholomew,1952,40,0,40,0.0,100.0,Male
Caroll,1952,53,31,22,58.490566037735846,41.50943396226416,Unisex
Shell,1952,12,7,5,58.333333333333336,41.66666666666667,Unisex
Sammie,1952,451,96,355,21.2860310421286,78.7139689578714,Unisex
Arlyn,1952,47,13,34,27.659574468085108,72.3404255319149,Unisex
Darby,1952,33,20,13,60.60606060606061,39.39393939393939,Unisex
Donie,1952,15,9,6,60.0,40.0,Unisex
Mickey,1952,675,173,502,25.62962962962963,74.37037037037038,Unisex
Arie,1952,30,19,11,63.33333333333333,36.66666666666666,Unisex
Ossie,1952,43,23,20,53.48837209302325,46.51162790697674,Unisex
Mackie,1952,24,5,19,20.833333333333336,79.16666666666666,Unisex
Delynn,1952,17,11,6,64.70588235294117,35.294117647058826,Unisex
Roe,1952,18,9,9,50.0,50.0,Unisex
Lupe,1952,277,200,77,72.20216606498195,27.79783393501805,Unisex
Ronnell,1952,14,5,9,35.714285714285715,64.28571428571429,Unisex
Dru,1952,40,31,9,77.5,22.5,Unisex
Michal,1952,97,38,59,39.175257731958766,60.824742268041234,Unisex
Marice,1952,21,16,5,76.19047619047619,23.809523809523807,Unisex
Cam,1952,14,6,8,42.85714285714285,57.14285714285714,Unisex
Ardell,1952,77,37,40,48.05194805194805,51.94805194805194,Unisex
Montie,1952,56,15,41,26.785714285714285,73.21428571428571,Unisex
Jayme,1952,43,33,10,76.74418604651163,23.25581395348837,Unisex
Kevan,1952,62,11,51,17.741935483870968,82.25806451612904,Unisex
Young,1952,30,16,14,53.333333333333336,46.66666666666666,Unisex
Jeryl,1952,66,43,23,65.15151515151516,34.84848484848485,Unisex
Dene,1952,15,6,9,40.0,60.0,Unisex
Ozie,1952,13,7,6,53.84615384615385,46.15384615384615,Unisex
Jaye,1952,43,34,9,79.06976744186046,20.930232558139537,Unisex
Carlie,1952,30,13,17,43.333333333333336,56.66666666666666,Unisex
Lyndel,1952,15,10,5,66.66666666666666,33.33333333333333,Unisex
Merle,1952,474,134,340,28.270042194092827,71.72995780590718,Unisex
Genine,1953,5,5,0,100.0,0.0,Female
Yvonnie,1953,10,10,0,100.0,0.0,Female
Gwenda,1953,84,84,0,100.0,0.0,Female
Marvia,1953,9,9,0,100.0,0.0,Female
Etha,1953,14,14,0,100.0,0.0,Female
Vidette,1953,5,5,0,100.0,0.0,Female
Donnamaria,1953,6,6,0,100.0,0.0,Female
Dalinda,1953,11,11,0,100.0,0.0,Female
Jerelene,1953,8,8,0,100.0,0.0,Female
Cherylann,1953,8,8,0,100.0,0.0,Female
Endia,1953,5,5,0,100.0,0.0,Female
Jeane,1953,54,54,0,100.0,0.0,Female
Rebbecca,1953,27,27,0,100.0,0.0,Female
Euna,1953,8,8,0,100.0,0.0,Female
Irean,1953,11,11,0,100.0,0.0,Female
Gloria,1953,9718,9679,39,99.59868285655484,0.4013171434451533,Female
Loma,1953,23,23,0,100.0,0.0,Female
Cookie,1953,23,23,0,100.0,0.0,Female
Dalia,1953,70,70,0,100.0,0.0,Female
Liesa,1953,8,8,0,100.0,0.0,Female
Joann,1953,3175,3170,5,99.84251968503936,0.1574803149606299,Female
Elise,1953,352,352,0,100.0,0.0,Female
Melda,1953,15,15,0,100.0,0.0,Female
Simone,1953,50,50,0,100.0,0.0,Female
June,1953,2291,2264,27,98.82147533828022,1.1785246617197729,Female
Ilse,1953,12,12,0,100.0,0.0,Female
Ronetta,1953,8,8,0,100.0,0.0,Female
Glennda,1953,20,20,0,100.0,0.0,Female
Maple,1953,31,31,0,100.0,0.0,Female
Mischelle,1953,8,8,0,100.0,0.0,Female
Enoch,1953,52,0,52,0.0,100.0,Male
Monroe,1953,149,0,149,0.0,100.0,Male
Branch,1953,8,0,8,0.0,100.0,Male
Roddy,1953,48,0,48,0.0,100.0,Male
Orest,1953,14,0,14,0.0,100.0,Male
Jefferson,1953,155,0,155,0.0,100.0,Male
Cordell,1953,49,0,49,0.0,100.0,Male
Dayne,1953,15,0,15,0.0,100.0,Male
Hurbert,1953,8,0,8,0.0,100.0,Male
Evans,1953,60,0,60,0.0,100.0,Male
Jens,1953,20,0,20,0.0,100.0,Male
Jaime,1953,291,35,256,12.027491408934708,87.97250859106529,Male
Wilmer,1953,95,0,95,0.0,100.0,Male
Garrette,1953,5,0,5,0.0,100.0,Male
Dyke,1953,7,0,7,0.0,100.0,Male
Willy,1953,32,0,32,0.0,100.0,Male
Ivan,1953,463,0,463,0.0,100.0,Male
Ruperto,1953,13,0,13,0.0,100.0,Male
Lemmie,1953,7,0,7,0.0,100.0,Male
Irl,1953,13,0,13,0.0,100.0,Male
Victoriano,1953,7,0,7,0.0,100.0,Male
Rhys,1953,11,0,11,0.0,100.0,Male
Glennon,1953,24,0,24,0.0,100.0,Male
Preston,1953,521,5,516,0.9596928982725528,99.04030710172744,Male
Palmer,1953,44,0,44,0.0,100.0,Male
Michaell,1953,6,0,6,0.0,100.0,Male
Vaughn,1953,246,7,239,2.845528455284553,97.15447154471543,Male
Durant,1953,7,0,7,0.0,100.0,Male
Merl,1953,31,0,31,0.0,100.0,Male
Ruddy,1953,8,0,8,0.0,100.0,Male
Claudell,1953,19,9,10,47.368421052631575,52.63157894736842,Unisex
Johnnie,1953,2124,720,1404,33.89830508474576,66.10169491525424,Unisex
Holley,1953,24,15,9,62.5,37.5,Unisex
Aundra,1953,18,10,8,55.55555555555556,44.44444444444444,Unisex
Hilary,1953,153,114,39,74.50980392156863,25.49019607843137,Unisex
Terrill,1953,72,22,50,30.55555555555556,69.44444444444444,Unisex
Trini,1953,13,6,7,46.15384615384615,53.84615384615385,Unisex
Osie,1953,21,9,12,42.85714285714285,57.14285714285714,Unisex
Arliss,1953,23,13,10,56.52173913043478,43.47826086956522,Unisex
Deane,1953,58,18,40,31.03448275862069,68.96551724137932,Unisex
Matilde,1953,19,13,6,68.42105263157895,31.57894736842105,Unisex
Mickey,1953,788,168,620,21.31979695431472,78.68020304568529,Unisex
Wynne,1953,33,26,7,78.78787878787878,21.21212121212121,Unisex
Ardell,1953,53,19,34,35.84905660377358,64.15094339622641,Unisex
Allyn,1953,98,52,46,53.06122448979592,46.93877551020408,Unisex
Bernell,1953,36,11,25,30.55555555555556,69.44444444444444,Unisex
Evone,1953,19,14,5,73.68421052631578,26.31578947368421,Unisex
Gaylan,1953,17,6,11,35.294117647058826,64.70588235294117,Unisex
Carry,1953,10,5,5,50.0,50.0,Unisex
Ottie,1953,17,8,9,47.05882352941176,52.94117647058824,Unisex
Ossie,1953,42,23,19,54.761904761904766,45.23809523809524,Unisex
Johnell,1953,24,5,19,20.833333333333336,79.16666666666666,Unisex
Marty,1953,454,95,359,20.92511013215859,79.07488986784142,Unisex
Artice,1953,13,5,8,38.46153846153847,61.53846153846154,Unisex
Audry,1953,30,25,5,83.33333333333334,16.666666666666664,Unisex
Arlyn,1953,42,10,32,23.809523809523807,76.19047619047619,Unisex
Larrie,1953,25,6,19,24.0,76.0,Unisex
Kevan,1953,60,13,47,21.666666666666668,78.33333333333333,Unisex
Lane,1953,220,39,181,17.727272727272727,82.27272727272728,Unisex
Ellie,1953,70,59,11,84.28571428571429,15.714285714285714,Unisex
Ylonda,1954,5,5,0,100.0,0.0,Female
Angie,1954,261,261,0,100.0,0.0,Female
Steffanie,1954,9,9,0,100.0,0.0,Female
Dorena,1954,17,17,0,100.0,0.0,Female
Joellen,1954,141,141,0,100.0,0.0,Female
Lareta,1954,6,6,0,100.0,0.0,Female
Keva,1954,6,6,0,100.0,0.0,Female
Nada,1954,46,46,0,100.0,0.0,Female
Pecolia,1954,5,5,0,100.0,0.0,Female
Melia,1954,11,11,0,100.0,0.0,Female
Vincenza,1954,21,21,0,100.0,0.0,Female
Dessie,1954,67,62,5,92.53731343283582,7.462686567164178,Female
Mammie,1954,29,29,0,100.0,0.0,Female
Dawna,1954,79,79,0,100.0,0.0,Female
Pamila,1954,23,23,0,100.0,0.0,Female
Waynette,1954,12,12,0,100.0,0.0,Female
Jonda,1954,10,10,0,100.0,0.0,Female
Gustavia,1954,7,7,0,100.0,0.0,Female
Janie,1954,1492,1492,0,100.0,0.0,Female
Annamae,1954,9,9,0,100.0,0.0,Female
Redia,1954,8,8,0,100.0,0.0,Female
Noreen,1954,476,476,0,100.0,0.0,Female
Elsa,1954,248,248,0,100.0,0.0,Female
Kathleen,1954,22496,22455,41,99.8177453769559,0.1822546230440967,Female
Tandra,1954,13,13,0,100.0,0.0,Female
Tenia,1954,6,6,0,100.0,0.0,Female
Mathilda,1954,9,9,0,100.0,0.0,Female
Dulce,1954,13,13,0,100.0,0.0,Female
Winnifred,1954,24,24,0,100.0,0.0,Female
Camella,1954,9,9,0,100.0,0.0,Female
Fenton,1954,18,0,18,0.0,100.0,Male
Dinnis,1954,5,0,5,0.0,100.0,Male
Murrel,1954,5,0,5,0.0,100.0,Male
Grayson,1954,28,0,28,0.0,100.0,Male
Tedd,1954,38,0,38,0.0,100.0,Male
Kenner,1954,6,0,6,0.0,100.0,Male
Valentino,1954,25,0,25,0.0,100.0,Male
Dannye,1954,8,0,8,0.0,100.0,Male
Andrei,1954,13,0,13,0.0,100.0,Male
Arnold,1954,1292,10,1282,0.7739938080495357,99.22600619195046,Male
Efraim,1954,8,0,8,0.0,100.0,Male
Windell,1954,55,0,55,0.0,100.0,Male
Brooks,1954,110,9,101,8.181818181818182,91.81818181818184,Male
Kai,1954,14,0,14,0.0,100.0,Male
Wade,1954,755,0,755,0.0,100.0,Male
Ignacio,1954,117,0,117,0.0,100.0,Male
Logan,1954,59,0,59,0.0,100.0,Male
Durk,1954,17,0,17,0.0,100.0,Male
Sholom,1954,5,0,5,0.0,100.0,Male
Heyward,1954,32,0,32,0.0,100.0,Male
Dodd,1954,5,0,5,0.0,100.0,Male
Morty,1954,5,0,5,0.0,100.0,Male
Lawayne,1954,6,0,6,0.0,100.0,Male
Prentice,1954,50,0,50,0.0,100.0,Male
Vestal,1954,5,0,5,0.0,100.0,Male
Grover,1954,217,0,217,0.0,100.0,Male
Alpheus,1954,5,0,5,0.0,100.0,Male
Charles,1954,37590,126,37464,0.3351955307262569,99.66480446927372,Male
Nicklos,1954,6,0,6,0.0,100.0,Male
Collins,1954,42,0,42,0.0,100.0,Male
Curley,1954,46,8,38,17.391304347826086,82.6086956521739,Unisex
Marlo,1954,51,20,31,39.21568627450981,60.78431372549019,Unisex
Linden,1954,48,8,40,16.666666666666664,83.33333333333334,Unisex
Lindsey,1954,240,71,169,29.58333333333333,70.41666666666667,Unisex
Jae,1954,21,10,11,47.61904761904761,52.38095238095239,Unisex
Dorian,1954,105,50,55,47.61904761904761,52.38095238095239,Unisex
Redell,1954,13,6,7,46.15384615384615,53.84615384615385,Unisex
Guadalupe,1954,963,623,340,64.69366562824507,35.306334371754936,Unisex
Climmie,1954,16,10,6,62.5,37.5,Unisex
Farris,1954,33,6,27,18.181818181818183,81.81818181818183,Unisex
Larue,1954,48,27,21,56.25,43.75,Unisex
Devin,1954,43,8,35,18.6046511627907,81.3953488372093,Unisex
Vennie,1954,10,5,5,50.0,50.0,Unisex
Linell,1954,12,7,5,58.333333333333336,41.66666666666667,Unisex
Vinnie,1954,39,28,11,71.7948717948718,28.205128205128204,Unisex
Martie,1954,22,16,6,72.72727272727273,27.27272727272727,Unisex
Clemmie,1954,28,11,17,39.285714285714285,60.71428571428571,Unisex
Raven,1954,11,5,6,45.45454545454545,54.54545454545454,Unisex
Jeffie,1954,27,15,12,55.55555555555556,44.44444444444444,Unisex
Monnie,1954,28,22,6,78.57142857142857,21.428571428571427,Unisex
Earlie,1954,44,21,23,47.72727272727273,52.27272727272727,Unisex
Joie,1954,19,11,8,57.89473684210527,42.10526315789473,Unisex
Jan,1954,3759,2992,767,79.59563713753658,20.404362862463422,Unisex
Irish,1954,24,19,5,79.16666666666666,20.833333333333336,Unisex
Wynne,1954,41,33,8,80.48780487804879,19.51219512195122,Unisex
Lenell,1954,26,13,13,50.0,50.0,Unisex
Marshell,1954,22,11,11,50.0,50.0,Unisex
Stormy,1954,25,19,6,76.0,24.0,Unisex
Gean,1954,17,10,7,58.82352941176471,41.17647058823529,Unisex
Jene,1954,31,21,10,67.74193548387096,32.25806451612903,Unisex
Emilee,1955,5,5,0,100.0,0.0,Female
Janyce,1955,44,44,0,100.0,0.0,Female
Spring,1955,41,41,0,100.0,0.0,Female
Arabella,1955,8,8,0,100.0,0.0,Female
Nidia,1955,20,20,0,100.0,0.0,Female
Gemma,1955,24,24,0,100.0,0.0,Female
Carmina,1955,11,11,0,100.0,0.0,Female
Lowanda,1955,6,6,0,100.0,0.0,Female
Beatris,1955,5,5,0,100.0,0.0,Female
Mika,1955,6,6,0,100.0,0.0,Female
Camela,1955,5,5,0,100.0,0.0,Female
Idella,1955,46,46,0,100.0,0.0,Female
Lindi,1955,12,12,0,100.0,0.0,Female
Cylinda,1955,6,6,0,100.0,0.0,Female
Omega,1955,15,15,0,100.0,0.0,Female
Sherian,1955,39,39,0,100.0,0.0,Female
Adriene,1955,18,18,0,100.0,0.0,Female
Nola,1955,195,195,0,100.0,0.0,Female
Laurelle,1955,9,9,0,100.0,0.0,Female
Ruthel,1955,5,5,0,100.0,0.0,Female
Maritha,1955,7,7,0,100.0,0.0,Female
Vicke,1955,10,10,0,100.0,0.0,Female
Arlys,1955,15,15,0,100.0,0.0,Female
Lenora,1955,429,429,0,100.0,0.0,Female
Stacie,1955,85,85,0,100.0,0.0,Female
Cathy,1955,8679,8664,15,99.82716902868994,0.1728309713100587,Female
Starr,1955,87,87,0,100.0,0.0,Female
Dorita,1955,30,30,0,100.0,0.0,Female
Hope,1955,552,552,0,100.0,0.0,Female
Gearline,1955,6,6,0,100.0,0.0,Female
Erwin,1955,175,0,175,0.0,100.0,Male
Randall,1955,6713,25,6688,0.3724117384179949,99.627588261582,Male
Fidelio,1955,6,0,6,0.0,100.0,Male
Jessy,1955,8,0,8,0.0,100.0,Male
Adam,1955,354,0,354,0.0,100.0,Male
Julien,1955,17,0,17,0.0,100.0,Male
Conn,1955,5,0,5,0.0,100.0,Male
Lenton,1955,11,0,11,0.0,100.0,Male
Little,1955,14,0,14,0.0,100.0,Male
Pierre,1955,160,5,155,3.125,96.875,Male
Christ,1955,20,0,20,0.0,100.0,Male
Joseph,1955,31667,84,31583,0.2652603656803612,99.73473963431964,Male
Cornell,1955,225,7,218,3.111111111111111,96.88888888888889,Male
Alejandro,1955,155,0,155,0.0,100.0,Male
Berney,1955,6,0,6,0.0,100.0,Male
Guilbert,1955,5,0,5,0.0,100.0,Male
Mitchael,1955,8,0,8,0.0,100.0,Male
Benjamin,1955,2458,10,2448,0.4068348250610252,99.59316517493896,Male
Liborio,1955,6,0,6,0.0,100.0,Male
Domenic,1955,77,0,77,0.0,100.0,Male
Rod,1955,156,0,156,0.0,100.0,Male
Arvid,1955,18,0,18,0.0,100.0,Male
Terrol,1955,5,0,5,0.0,100.0,Male
Hervey,1955,14,0,14,0.0,100.0,Male
Pleas,1955,7,0,7,0.0,100.0,Male
Harper,1955,10,0,10,0.0,100.0,Male
Caldwell,1955,6,0,6,0.0,100.0,Male
Manual,1955,15,0,15,0.0,100.0,Male
Dorsey,1955,70,7,63,10.0,90.0,Male
Art,1955,59,0,59,0.0,100.0,Male
Shannon,1955,800,643,157,80.375,19.625,Unisex
Dimitri,1955,29,5,24,17.24137931034483,82.75862068965517,Unisex
Marvel,1955,43,35,8,81.3953488372093,18.6046511627907,Unisex
Nevada,1955,17,12,5,70.58823529411765,29.411764705882355,Unisex
Tye,1955,15,5,10,33.33333333333333,66.66666666666666,Unisex
Bernell,1955,39,12,27,30.76923076923077,69.23076923076923,Unisex
Lesley,1955,402,333,69,82.83582089552239,17.16417910447761,Unisex
Stacey,1955,462,376,86,81.38528138528139,18.61471861471861,Unisex
Gean,1955,16,8,8,50.0,50.0,Unisex
Avon,1955,43,23,20,53.48837209302325,46.51162790697674,Unisex
Clemmie,1955,33,18,15,54.54545454545454,45.45454545454545,Unisex
Tonnie,1955,27,16,11,59.25925925925925,40.74074074074074,Unisex
Ronell,1955,17,7,10,41.17647058823529,58.82352941176471,Unisex
Karey,1955,35,21,14,60.0,40.0,Unisex
Ozzie,1955,39,10,29,25.64102564102564,74.35897435897436,Unisex
Deane,1955,52,22,30,42.30769230769231,57.692307692307686,Unisex
Norah,1955,31,25,6,80.64516129032258,19.35483870967742,Unisex
Salome,1955,15,10,5,66.66666666666666,33.33333333333333,Unisex
Robbie,1955,625,395,230,63.2,36.8,Unisex
Lyndel,1955,16,6,10,37.5,62.5,Unisex
Johann,1955,19,11,8,57.89473684210527,42.10526315789473,Unisex
Lacy,1955,89,18,71,20.2247191011236,79.7752808988764,Unisex
Burdette,1955,16,8,8,50.0,50.0,Unisex
Lindsey,1955,197,43,154,21.82741116751269,78.1725888324873,Unisex
Delaney,1955,18,7,11,38.88888888888889,61.11111111111112,Unisex
Lin,1955,51,31,20,60.78431372549019,39.21568627450981,Unisex
Guadlupe,1955,12,6,6,50.0,50.0,Unisex
Maryland,1955,17,10,7,58.82352941176471,41.17647058823529,Unisex
Loy,1955,49,16,33,32.6530612244898,67.3469387755102,Unisex
Cleo,1955,243,147,96,60.49382716049383,39.50617283950617,Unisex
Sheran,1956,12,12,0,100.0,0.0,Female
Chryl,1956,11,11,0,100.0,0.0,Female
Phyliss,1956,50,50,0,100.0,0.0,Female
Margarett,1956,51,51,0,100.0,0.0,Female
Angelene,1956,26,26,0,100.0,0.0,Female
Glennda,1956,17,17,0,100.0,0.0,Female
Oneda,1956,10,10,0,100.0,0.0,Female
Tawanna,1956,28,28,0,100.0,0.0,Female
Margueritte,1956,8,8,0,100.0,0.0,Female
Timothea,1956,7,7,0,100.0,0.0,Female
Hermelinda,1956,41,41,0,100.0,0.0,Female
Zonda,1956,5,5,0,100.0,0.0,Female
Marnette,1956,7,7,0,100.0,0.0,Female
Arlina,1956,5,5,0,100.0,0.0,Female
Delphia,1956,22,22,0,100.0,0.0,Female
Nancie,1956,91,91,0,100.0,0.0,Female
Marilu,1956,25,25,0,100.0,0.0,Female
Michaeleen,1956,10,10,0,100.0,0.0,Female
Julieanne,1956,5,5,0,100.0,0.0,Female
Norina,1956,9,9,0,100.0,0.0,Female
Janann,1956,9,9,0,100.0,0.0,Female
Gailyn,1956,6,6,0,100.0,0.0,Female
Renetta,1956,30,30,0,100.0,0.0,Female
Evone,1956,13,13,0,100.0,0.0,Female
Pamila,1956,36,36,0,100.0,0.0,Female
Cleotilde,1956,6,6,0,100.0,0.0,Female
Delphine,1956,154,154,0,100.0,0.0,Female
Adrea,1956,5,5,0,100.0,0.0,Female
Grayce,1956,12,12,0,100.0,0.0,Female
Kerri,1956,194,194,0,100.0,0.0,Female
Orin,1956,38,0,38,0.0,100.0,Male
Augie,1956,22,0,22,0.0,100.0,Male
Mayer,1956,11,0,11,0.0,100.0,Male
Clayborn,1956,10,0,10,0.0,100.0,Male
Vencil,1956,5,0,5,0.0,100.0,Male
Washington,1956,16,0,16,0.0,100.0,Male
Arbie,1956,8,0,8,0.0,100.0,Male
Reynolds,1956,15,0,15,0.0,100.0,Male
Conrad,1956,348,0,348,0.0,100.0,Male
Rodrick,1956,66,0,66,0.0,100.0,Male
Harvard,1956,8,0,8,0.0,100.0,Male
Purnell,1956,10,0,10,0.0,100.0,Male
Shedrick,1956,25,0,25,0.0,100.0,Male
Matthias,1956,15,0,15,0.0,100.0,Male
Efraim,1956,7,0,7,0.0,100.0,Male
Bernardino,1956,12,0,12,0.0,100.0,Male
Harper,1956,17,0,17,0.0,100.0,Male
Delmont,1956,5,0,5,0.0,100.0,Male
Obediah,1956,5,0,5,0.0,100.0,Male
Refugio,1956,37,0,37,0.0,100.0,Male
Rinaldo,1956,10,0,10,0.0,100.0,Male
Jeffory,1956,46,0,46,0.0,100.0,Male
Kody,1956,5,0,5,0.0,100.0,Male
Nolen,1956,23,0,23,0.0,100.0,Male
Karlos,1956,5,0,5,0.0,100.0,Male
Herchel,1956,9,0,9,0.0,100.0,Male
Paul,1956,26969,70,26899,0.2595572694575253,99.74044273054248,Male
Callen,1956,8,0,8,0.0,100.0,Male
Fausto,1956,10,0,10,0.0,100.0,Male
Cleofas,1956,6,0,6,0.0,100.0,Male
Michal,1956,105,34,71,32.38095238095238,67.61904761904762,Unisex
Daren,1956,23,5,18,21.73913043478261,78.26086956521739,Unisex
Gale,1956,1270,1077,193,84.80314960629921,15.196850393700789,Unisex
Arlyn,1956,54,10,44,18.51851851851852,81.48148148148148,Unisex
Tandy,1956,27,15,12,55.55555555555556,44.44444444444444,Unisex
Marlen,1956,20,10,10,50.0,50.0,Unisex
Kimber,1956,62,52,10,83.87096774193549,16.129032258064516,Unisex
Dana,1956,3707,2074,1633,55.94820609657405,44.05179390342595,Unisex
Val,1956,253,85,168,33.59683794466403,66.40316205533597,Unisex
Willia,1956,31,24,7,77.41935483870968,22.58064516129032,Unisex
Laine,1956,35,19,16,54.285714285714285,45.71428571428572,Unisex
Sheridan,1956,34,21,13,61.76470588235294,38.23529411764706,Unisex
Carman,1956,52,39,13,75.0,25.0,Unisex
Leith,1956,11,5,6,45.45454545454545,54.54545454545454,Unisex
Jeryl,1956,92,69,23,75.0,25.0,Unisex
Blythe,1956,29,24,5,82.75862068965517,17.24137931034483,Unisex
Tyree,1956,36,8,28,22.22222222222222,77.77777777777779,Unisex
Rue,1956,15,10,5,66.66666666666666,33.33333333333333,Unisex
Elvie,1956,18,12,6,66.66666666666666,33.33333333333333,Unisex
Ozie,1956,13,7,6,53.84615384615385,46.15384615384615,Unisex
Theo,1956,50,11,39,22.0,78.0,Unisex
Augusta,1956,83,48,35,57.831325301204814,42.16867469879519,Unisex
Hollis,1956,246,103,143,41.86991869918699,58.13008130081301,Unisex
Earlie,1956,38,12,26,31.57894736842105,68.42105263157895,Unisex
Augustine,1956,146,44,102,30.136986301369863,69.86301369863014,Unisex
Reagan,1956,21,7,14,33.33333333333333,66.66666666666666,Unisex
Tory,1956,25,13,12,52.0,48.0,Unisex
Ozzie,1956,37,11,26,29.72972972972973,70.27027027027027,Unisex
Terrace,1956,14,5,9,35.714285714285715,64.28571428571429,Unisex
Vernie,1956,42,16,26,38.095238095238095,61.90476190476191,Unisex
Judy,1957,10576,10545,31,99.7068835098336,0.2931164901664145,Female
Joell,1957,9,9,0,100.0,0.0,Female
Luellen,1957,17,17,0,100.0,0.0,Female
Renai,1957,5,5,0,100.0,0.0,Female
Roena,1957,12,12,0,100.0,0.0,Female
Christinia,1957,10,10,0,100.0,0.0,Female
Gwynne,1957,27,27,0,100.0,0.0,Female
Lucie,1957,58,58,0,100.0,0.0,Female
Eufemia,1957,9,9,0,100.0,0.0,Female
Deberah,1957,24,24,0,100.0,0.0,Female
Dimitria,1957,5,5,0,100.0,0.0,Female
Denae,1957,10,10,0,100.0,0.0,Female
Jennine,1957,20,20,0,100.0,0.0,Female
Leilani,1957,86,86,0,100.0,0.0,Female
Teena,1957,263,263,0,100.0,0.0,Female
Sanjuana,1957,34,34,0,100.0,0.0,Female
Karina,1957,9,9,0,100.0,0.0,Female
Milta,1957,6,6,0,100.0,0.0,Female
Debora,1957,2371,2371,0,100.0,0.0,Female
Melene,1957,7,7,0,100.0,0.0,Female
Addie,1957,181,172,9,95.02762430939228,4.972375690607735,Female
Brendia,1957,11,11,0,100.0,0.0,Female
Sindee,1957,33,33,0,100.0,0.0,Female
Robecca,1957,7,7,0,100.0,0.0,Female
Kandyce,1957,9,9,0,100.0,0.0,Female
Oleta,1957,27,27,0,100.0,0.0,Female
Twila,1957,213,213,0,100.0,0.0,Female
Earla,1957,8,8,0,100.0,0.0,Female
Conchetta,1957,5,5,0,100.0,0.0,Female
Charlet,1957,14,14,0,100.0,0.0,Female
Bjorn,1957,5,0,5,0.0,100.0,Male
Gaspare,1957,7,0,7,0.0,100.0,Male
Micahel,1957,7,0,7,0.0,100.0,Male
Danie,1957,10,0,10,0.0,100.0,Male
Logan,1957,44,0,44,0.0,100.0,Male
Alfonse,1957,12,0,12,0.0,100.0,Male
Mikell,1957,10,0,10,0.0,100.0,Male
Costa,1957,5,0,5,0.0,100.0,Male
Enrico,1957,34,0,34,0.0,100.0,Male
Ambrosio,1957,11,0,11,0.0,100.0,Male
Alcario,1957,7,0,7,0.0,100.0,Male
Herschel,1957,98,0,98,0.0,100.0,Male
Ronson,1957,5,0,5,0.0,100.0,Male
Girard,1957,35,0,35,0.0,100.0,Male
Herald,1957,7,0,7,0.0,100.0,Male
Woodson,1957,12,0,12,0.0,100.0,Male
Nestor,1957,56,0,56,0.0,100.0,Male
Elige,1957,6,0,6,0.0,100.0,Male
Oneal,1957,38,0,38,0.0,100.0,Male
Adolf,1957,11,0,11,0.0,100.0,Male
Linzy,1957,8,0,8,0.0,100.0,Male
Undra,1957,7,0,7,0.0,100.0,Male
Hoy,1957,13,0,13,0.0,100.0,Male
Earl,1957,3155,16,3139,0.5071315372424723,99.49286846275751,Male
Donato,1957,26,0,26,0.0,100.0,Male
Keven,1957,135,8,127,5.925925925925927,94.07407407407408,Male
Costello,1957,6,0,6,0.0,100.0,Male
Sylvester,1957,605,0,605,0.0,100.0,Male
Irvine,1957,6,0,6,0.0,100.0,Male
Philippe,1957,36,0,36,0.0,100.0,Male
Kelsey,1957,31,12,19,38.70967741935484,61.29032258064516,Unisex
Tonnie,1957,33,18,15,54.54545454545454,45.45454545454545,Unisex
Ivery,1957,18,5,13,27.77777777777778,72.22222222222221,Unisex
Tarry,1957,26,9,17,34.61538461538461,65.38461538461539,Unisex
Caroll,1957,34,24,10,70.58823529411765,29.411764705882355,Unisex
Chriss,1957,17,5,12,29.411764705882355,70.58823529411765,Unisex
Billie,1957,1209,990,219,81.88585607940446,18.11414392059553,Unisex
Lin,1957,50,34,16,68.0,32.0,Unisex
Augusta,1957,57,41,16,71.9298245614035,28.07017543859649,Unisex
Arden,1957,91,26,65,28.57142857142857,71.42857142857143,Unisex
Pearly,1957,17,12,5,70.58823529411765,29.411764705882355,Unisex
Scottie,1957,117,27,90,23.07692307692308,76.92307692307693,Unisex
Michal,1957,84,22,62,26.1904761904762,73.80952380952381,Unisex
Farris,1957,33,5,28,15.151515151515152,84.84848484848484,Unisex
Liberty,1957,10,5,5,50.0,50.0,Unisex
Vandy,1957,11,6,5,54.54545454545454,45.45454545454545,Unisex
Allie,1957,62,44,18,70.96774193548387,29.03225806451613,Unisex
Glendell,1957,21,9,12,42.85714285714285,57.14285714285714,Unisex
Deven,1957,12,7,5,58.333333333333336,41.66666666666667,Unisex
Karry,1957,35,15,20,42.85714285714285,57.14285714285714,Unisex
Marley,1957,12,7,5,58.333333333333336,41.66666666666667,Unisex
Toby,1957,339,89,250,26.253687315634217,73.74631268436578,Unisex
Aundra,1957,31,8,23,25.806451612903224,74.19354838709677,Unisex
Leslie,1957,8201,6101,2100,74.39336666260212,25.60663333739788,Unisex
Dennie,1957,79,18,61,22.78481012658228,77.21518987341773,Unisex
Sami,1957,23,13,10,56.52173913043478,43.47826086956522,Unisex
Donie,1957,17,6,11,35.294117647058826,64.70588235294117,Unisex
Sydney,1957,169,117,52,69.23076923076923,30.76923076923077,Unisex
Delynn,1957,35,25,10,71.42857142857143,28.57142857142857,Unisex
Earlie,1957,31,5,26,16.129032258064516,83.87096774193549,Unisex
Aquanetta,1958,11,11,0,100.0,0.0,Female
Alina,1958,11,11,0,100.0,0.0,Female
Mora,1958,6,6,0,100.0,0.0,Female
Brookie,1958,6,6,0,100.0,0.0,Female
Syliva,1958,14,14,0,100.0,0.0,Female
Carlena,1958,5,5,0,100.0,0.0,Female
Amiee,1958,6,6,0,100.0,0.0,Female
Anglea,1958,7,7,0,100.0,0.0,Female
Theresia,1958,41,41,0,100.0,0.0,Female
Kandis,1958,24,24,0,100.0,0.0,Female
Trude,1958,14,14,0,100.0,0.0,Female
Leissa,1958,5,5,0,100.0,0.0,Female
Leaanne,1958,5,5,0,100.0,0.0,Female
Julieanne,1958,13,13,0,100.0,0.0,Female
Bethany,1958,146,146,0,100.0,0.0,Female
Ann,1958,8875,8852,23,99.74084507042254,0.2591549295774648,Female
Dona,1958,331,331,0,100.0,0.0,Female
Darnise,1958,6,6,0,100.0,0.0,Female
Debborah,1958,28,28,0,100.0,0.0,Female
Georgette,1958,242,242,0,100.0,0.0,Female
Anamaria,1958,11,11,0,100.0,0.0,Female
Berta,1958,66,66,0,100.0,0.0,Female
Machele,1958,8,8,0,100.0,0.0,Female
Krisann,1958,12,12,0,100.0,0.0,Female
Zora,1958,19,19,0,100.0,0.0,Female
Fae,1958,10,10,0,100.0,0.0,Female
Oneta,1958,7,7,0,100.0,0.0,Female
Darcia,1958,20,20,0,100.0,0.0,Female
Ladine,1958,5,5,0,100.0,0.0,Female
Nicholette,1958,9,9,0,100.0,0.0,Female
Prentice,1958,39,0,39,0.0,100.0,Male
Spencer,1958,285,0,285,0.0,100.0,Male
Lorence,1958,7,0,7,0.0,100.0,Male
Sal,1958,114,0,114,0.0,100.0,Male
Ellis,1958,369,14,355,3.794037940379404,96.2059620596206,Male
Geron,1958,5,0,5,0.0,100.0,Male
Mell,1958,11,0,11,0.0,100.0,Male
Michail,1958,9,0,9,0.0,100.0,Male
Simpson,1958,5,0,5,0.0,100.0,Male
Silvester,1958,16,0,16,0.0,100.0,Male
Primitivo,1958,14,0,14,0.0,100.0,Male
Alen,1958,12,0,12,0.0,100.0,Male
Reilly,1958,7,0,7,0.0,100.0,Male
Lamont,1958,234,0,234,0.0,100.0,Male
Candelario,1958,20,0,20,0.0,100.0,Male
Stephenson,1958,9,0,9,0.0,100.0,Male
Abelardo,1958,25,0,25,0.0,100.0,Male
Nathaniel,1958,1123,15,1108,1.335707925200356,98.66429207479965,Male
Reynold,1958,60,0,60,0.0,100.0,Male
Americo,1958,16,0,16,0.0,100.0,Male
Eddy,1958,234,5,229,2.1367521367521367,97.86324786324786,Male
Porfirio,1958,33,0,33,0.0,100.0,Male
Alonso,1958,13,0,13,0.0,100.0,Male
Evan,1958,338,9,329,2.6627218934911245,97.33727810650888,Male
Darryn,1958,8,0,8,0.0,100.0,Male
Tyler,1958,145,0,145,0.0,100.0,Male
Manuel,1958,1667,8,1659,0.4799040191961607,99.52009598080384,Male
Matthews,1958,11,0,11,0.0,100.0,Male
Climmie,1958,6,0,6,0.0,100.0,Male
Watson,1958,17,0,17,0.0,100.0,Male
Frankie,1958,1105,353,752,31.94570135746606,68.05429864253394,Unisex
Rande,1958,27,7,20,25.925925925925924,74.07407407407408,Unisex
Bliss,1958,10,5,5,50.0,50.0,Unisex
Ronell,1958,18,8,10,44.44444444444444,55.55555555555556,Unisex
Kem,1958,65,21,44,32.30769230769231,67.6923076923077,Unisex
Marvis,1958,30,21,9,70.0,30.0,Unisex
Marcel,1958,121,19,102,15.702479338842975,84.29752066115702,Unisex
Marlo,1958,33,6,27,18.181818181818183,81.81818181818183,Unisex
Raynell,1958,19,12,7,63.1578947368421,36.84210526315789,Unisex
Keena,1958,52,41,11,78.84615384615384,21.15384615384616,Unisex
Vinnie,1958,28,21,7,75.0,25.0,Unisex
Kit,1958,112,44,68,39.285714285714285,60.71428571428571,Unisex
Lennis,1958,29,8,21,27.58620689655172,72.41379310344827,Unisex
Jule,1958,38,26,12,68.42105263157895,31.57894736842105,Unisex
Danne,1958,21,14,7,66.66666666666666,33.33333333333333,Unisex
Dariel,1958,15,5,10,33.33333333333333,66.66666666666666,Unisex
Randie,1958,53,31,22,58.490566037735846,41.50943396226416,Unisex
Jene,1958,24,19,5,79.16666666666666,20.833333333333336,Unisex
Adrian,1958,541,98,443,18.11460258780037,81.88539741219964,Unisex
Tandy,1958,37,17,20,45.94594594594595,54.054054054054056,Unisex
Demetris,1958,13,6,7,46.15384615384615,53.84615384615385,Unisex
Avon,1958,28,10,18,35.714285714285715,64.28571428571429,Unisex
Natividad,1958,29,11,18,37.93103448275862,62.06896551724138,Unisex
Dwan,1958,21,14,7,66.66666666666666,33.33333333333333,Unisex
Deane,1958,60,17,43,28.33333333333333,71.66666666666667,Unisex
Marion,1958,1637,1055,582,64.44715943799633,35.55284056200366,Unisex
Kendal,1958,52,13,39,25.0,75.0,Unisex
Concepcion,1958,61,48,13,78.68852459016394,21.311475409836063,Unisex
Drue,1958,13,5,8,38.46153846153847,61.53846153846154,Unisex
Lindsay,1958,170,81,89,47.647058823529406,52.352941176470594,Unisex
Sabrena,1959,32,32,0,100.0,0.0,Female
Eliza,1959,86,86,0,100.0,0.0,Female
Margareta,1959,6,6,0,100.0,0.0,Female
Brita,1959,12,12,0,100.0,0.0,Female
Glady,1959,5,5,0,100.0,0.0,Female
Bonnita,1959,16,16,0,100.0,0.0,Female
Leola,1959,113,113,0,100.0,0.0,Female
Olympia,1959,11,11,0,100.0,0.0,Female
Debroah,1959,65,65,0,100.0,0.0,Female
Deneice,1959,12,12,0,100.0,0.0,Female
Rebba,1959,5,5,0,100.0,0.0,Female
Ressa,1959,7,7,0,100.0,0.0,Female
Katheleen,1959,23,23,0,100.0,0.0,Female
Manuela,1959,66,66,0,100.0,0.0,Female
Belita,1959,7,7,0,100.0,0.0,Female
Lylia,1959,6,6,0,100.0,0.0,Female
Loida,1959,13,13,0,100.0,0.0,Female
Sherle,1959,5,5,0,100.0,0.0,Female
Amye,1959,7,7,0,100.0,0.0,Female
Carin,1959,91,91,0,100.0,0.0,Female
Bettyjean,1959,8,8,0,100.0,0.0,Female
Tai,1959,7,7,0,100.0,0.0,Female
Chyrel,1959,14,14,0,100.0,0.0,Female
Merrianne,1959,5,5,0,100.0,0.0,Female
Maida,1959,16,16,0,100.0,0.0,Female
Rosenda,1959,8,8,0,100.0,0.0,Female
Kimber,1959,83,74,9,89.1566265060241,10.843373493975903,Female
Harolyn,1959,18,18,0,100.0,0.0,Female
Marsi,1959,10,10,0,100.0,0.0,Female
Marybeth,1959,377,377,0,100.0,0.0,Female
Raymound,1959,7,0,7,0.0,100.0,Male
Abie,1959,9,0,9,0.0,100.0,Male
Carlisle,1959,12,0,12,0.0,100.0,Male
Revis,1959,11,0,11,0.0,100.0,Male
Derold,1959,6,0,6,0.0,100.0,Male
Halbert,1959,19,0,19,0.0,100.0,Male
Dallen,1959,5,0,5,0.0,100.0,Male
Lehman,1959,11,0,11,0.0,100.0,Male
Raydell,1959,5,0,5,0.0,100.0,Male
Ronzel,1959,6,0,6,0.0,100.0,Male
Gordie,1959,10,0,10,0.0,100.0,Male
Frank,1959,10991,48,10943,0.4367209535074151,99.56327904649258,Male
Barth,1959,11,0,11,0.0,100.0,Male
Harman,1959,5,0,5,0.0,100.0,Male
Lorrin,1959,6,0,6,0.0,100.0,Male
Pressley,1959,5,0,5,0.0,100.0,Male
Donal,1959,51,0,51,0.0,100.0,Male
Millard,1959,110,0,110,0.0,100.0,Male
Carlton,1959,820,8,812,0.975609756097561,99.02439024390245,Male
Pasqual,1959,5,0,5,0.0,100.0,Male
Keven,1959,110,9,101,8.181818181818182,91.81818181818184,Male
Celestino,1959,28,0,28,0.0,100.0,Male
Avelino,1959,10,0,10,0.0,100.0,Male
Hannibal,1959,9,0,9,0.0,100.0,Male
Sameul,1959,18,0,18,0.0,100.0,Male
Avrohom,1959,7,0,7,0.0,100.0,Male
Hillard,1959,9,0,9,0.0,100.0,Male
Hurley,1959,17,0,17,0.0,100.0,Male
Rhett,1959,61,0,61,0.0,100.0,Male
Ed,1959,696,0,696,0.0,100.0,Male
Paris,1959,94,45,49,47.87234042553192,52.12765957446809,Unisex
Barri,1959,21,16,5,76.19047619047619,23.809523809523807,Unisex
Darian,1959,18,7,11,38.88888888888889,61.11111111111112,Unisex
Willia,1959,30,16,14,53.333333333333336,46.66666666666666,Unisex
Kerin,1959,36,28,8,77.77777777777779,22.22222222222222,Unisex
Arliss,1959,13,7,6,53.84615384615385,46.15384615384615,Unisex
Kalen,1959,18,10,8,55.55555555555556,44.44444444444444,Unisex
Ardis,1959,59,36,23,61.01694915254237,38.983050847457626,Unisex
Carrell,1959,10,5,5,50.0,50.0,Unisex
Arden,1959,93,25,68,26.881720430107524,73.11827956989248,Unisex
Marcell,1959,40,23,17,57.49999999999999,42.5,Unisex
Donnis,1959,32,18,14,56.25,43.75,Unisex
Devon,1959,93,38,55,40.86021505376344,59.13978494623656,Unisex
Kris,1959,1059,590,469,55.71293673276677,44.28706326723324,Unisex
Hildred,1959,11,6,5,54.54545454545454,45.45454545454545,Unisex
Beryl,1959,97,82,15,84.5360824742268,15.463917525773196,Unisex
Lovie,1959,39,30,9,76.92307692307693,23.07692307692308,Unisex
Sydney,1959,198,136,62,68.68686868686868,31.313131313131315,Unisex
Tris,1959,21,9,12,42.85714285714285,57.14285714285714,Unisex
Gean,1959,14,6,8,42.85714285714285,57.14285714285714,Unisex
Chris,1959,7084,1408,5676,19.875776397515526,80.12422360248446,Unisex
Vernell,1959,137,88,49,64.23357664233576,35.76642335766424,Unisex
Sheridan,1959,46,24,22,52.17391304347826,47.82608695652174,Unisex
Lee,1959,5055,1548,3507,30.623145400593472,69.37685459940653,Unisex
Ossie,1959,30,17,13,56.66666666666666,43.333333333333336,Unisex
Darcey,1959,37,31,6,83.78378378378379,16.216216216216218,Unisex
Ollie,1959,252,143,109,56.74603174603175,43.25396825396825,Unisex
Linnie,1959,56,45,11,80.35714285714286,19.642857142857142,Unisex
Jonnie,1959,111,80,31,72.07207207207207,27.927927927927925,Unisex
Clair,1959,114,42,72,36.84210526315789,63.1578947368421,Unisex
Kaylyn,1960,7,7,0,100.0,0.0,Female
Apryl,1960,24,24,0,100.0,0.0,Female
Franca,1960,11,11,0,100.0,0.0,Female
Milana,1960,6,6,0,100.0,0.0,Female
Nelma,1960,7,7,0,100.0,0.0,Female
Aracely,1960,10,10,0,100.0,0.0,Female
Luana,1960,96,96,0,100.0,0.0,Female
Lindie,1960,12,12,0,100.0,0.0,Female
Lacinda,1960,19,19,0,100.0,0.0,Female
Meghan,1960,33,33,0,100.0,0.0,Female
Ismelda,1960,5,5,0,100.0,0.0,Female
Rogene,1960,7,7,0,100.0,0.0,Female
Josefine,1960,6,6,0,100.0,0.0,Female
Alvena,1960,8,8,0,100.0,0.0,Female
Geanna,1960,5,5,0,100.0,0.0,Female
Juleen,1960,13,13,0,100.0,0.0,Female
Lenise,1960,17,17,0,100.0,0.0,Female
Kristina,1960,424,424,0,100.0,0.0,Female
Beverlie,1960,5,5,0,100.0,0.0,Female
Colene,1960,24,24,0,100.0,0.0,Female
Angelina,1960,237,237,0,100.0,0.0,Female
Pansy,1960,60,60,0,100.0,0.0,Female
Elmarie,1960,5,5,0,100.0,0.0,Female
Julietta,1960,11,11,0,100.0,0.0,Female
Natali,1960,6,6,0,100.0,0.0,Female
Kennita,1960,6,6,0,100.0,0.0,Female
Elecia,1960,7,7,0,100.0,0.0,Female
Sherine,1960,8,8,0,100.0,0.0,Female
Maryjean,1960,34,34,0,100.0,0.0,Female
Sula,1960,5,5,0,100.0,0.0,Female
Roel,1960,68,0,68,0.0,100.0,Male
Selwyn,1960,23,0,23,0.0,100.0,Male
Norwood,1960,29,0,29,0.0,100.0,Male
Ezell,1960,34,0,34,0.0,100.0,Male
Clinton,1960,1101,5,1096,0.4541326067211626,99.54586739327884,Male
Harlee,1960,5,0,5,0.0,100.0,Male
Brick,1960,8,0,8,0.0,100.0,Male
Durward,1960,18,0,18,0.0,100.0,Male
Homero,1960,30,0,30,0.0,100.0,Male
Randey,1960,5,0,5,0.0,100.0,Male
Ysidro,1960,11,0,11,0.0,100.0,Male
Seamon,1960,5,0,5,0.0,100.0,Male
Algie,1960,12,0,12,0.0,100.0,Male
Jennings,1960,33,0,33,0.0,100.0,Male
Hershell,1960,25,0,25,0.0,100.0,Male
Andrei,1960,17,0,17,0.0,100.0,Male
Reed,1960,214,0,214,0.0,100.0,Male
Larance,1960,5,0,5,0.0,100.0,Male
Francisco,1960,791,12,779,1.5170670037926677,98.48293299620732,Male
Hebert,1960,9,0,9,0.0,100.0,Male
Jerold,1960,129,0,129,0.0,100.0,Male
Oral,1960,23,0,23,0.0,100.0,Male
Fidel,1960,109,0,109,0.0,100.0,Male
Kennis,1960,8,0,8,0.0,100.0,Male
Conway,1960,23,0,23,0.0,100.0,Male
Milton,1960,1191,10,1181,0.8396305625524769,99.16036943744751,Male
Aristeo,1960,6,0,6,0.0,100.0,Male
Jeff,1960,8529,20,8509,0.2344940790245046,99.7655059209755,Male
Raymie,1960,8,0,8,0.0,100.0,Male
Jonah,1960,28,0,28,0.0,100.0,Male
Danie,1960,16,5,11,31.25,68.75,Unisex
Leslie,1960,6915,5240,1675,75.77729573391179,24.22270426608821,Unisex
Otha,1960,63,10,53,15.873015873015872,84.12698412698413,Unisex
Lavelle,1960,34,13,21,38.23529411764706,61.76470588235294,Unisex
Alpha,1960,26,17,9,65.38461538461539,34.61538461538461,Unisex
Donis,1960,19,12,7,63.1578947368421,36.84210526315789,Unisex
Deon,1960,76,22,54,28.94736842105264,71.05263157894737,Unisex
Marlen,1960,16,7,9,43.75,56.25,Unisex
Tiny,1960,28,21,7,75.0,25.0,Unisex
Shanon,1960,27,20,7,74.07407407407408,25.925925925925924,Unisex
Adrien,1960,15,7,8,46.66666666666666,53.333333333333336,Unisex
Zan,1960,16,6,10,37.5,62.5,Unisex
Kym,1960,98,78,20,79.59183673469387,20.40816326530612,Unisex
Parris,1960,41,11,30,26.82926829268293,73.17073170731707,Unisex
Johnell,1960,23,5,18,21.73913043478261,78.26086956521739,Unisex
Kriss,1960,46,17,29,36.95652173913043,63.04347826086957,Unisex
Jeryl,1960,35,23,12,65.71428571428571,34.285714285714285,Unisex
Kendal,1960,54,16,38,29.629629629629623,70.37037037037037,Unisex
Holley,1960,33,28,5,84.84848484848484,15.151515151515152,Unisex
Rosario,1960,207,173,34,83.57487922705315,16.425120772946862,Unisex
Lyndall,1960,23,8,15,34.78260869565217,65.21739130434783,Unisex
Randee,1960,55,44,11,80.0,20.0,Unisex
Dorian,1960,143,88,55,61.53846153846154,38.46153846153847,Unisex
Arlyn,1960,38,9,29,23.684210526315788,76.31578947368422,Unisex
Dondi,1960,27,10,17,37.03703703703704,62.96296296296296,Unisex
Vinnie,1960,44,26,18,59.09090909090909,40.909090909090914,Unisex
Lacey,1960,35,19,16,54.285714285714285,45.71428571428572,Unisex
Regan,1960,72,13,59,18.05555555555556,81.94444444444444,Unisex
Adell,1960,35,26,9,74.28571428571429,25.71428571428571,Unisex
Dennie,1960,72,11,61,15.27777777777778,84.72222222222221,Unisex
Rhonna,1961,9,9,0,100.0,0.0,Female
Jillene,1961,19,19,0,100.0,0.0,Female
Jayne,1961,986,981,5,99.49290060851928,0.5070993914807302,Female
Pansy,1961,70,70,0,100.0,0.0,Female
Rosa,1961,1658,1649,9,99.45717732207478,0.5428226779252111,Female
Meegan,1961,10,10,0,100.0,0.0,Female
Lucile,1961,35,35,0,100.0,0.0,Female
Dorothey,1961,9,9,0,100.0,0.0,Female
Revonda,1961,28,28,0,100.0,0.0,Female
Quanda,1961,9,9,0,100.0,0.0,Female
Rachell,1961,35,35,0,100.0,0.0,Female
Drucilla,1961,45,45,0,100.0,0.0,Female
Latisha,1961,26,26,0,100.0,0.0,Female
Berna,1961,16,16,0,100.0,0.0,Female
Jaynie,1961,14,14,0,100.0,0.0,Female
Marcelina,1961,10,10,0,100.0,0.0,Female
Terra,1961,51,51,0,100.0,0.0,Female
Carmelia,1961,12,12,0,100.0,0.0,Female
Capucine,1961,5,5,0,100.0,0.0,Female
Yuvette,1961,8,8,0,100.0,0.0,Female
Johnna,1961,489,489,0,100.0,0.0,Female
Neisha,1961,5,5,0,100.0,0.0,Female
Krislyn,1961,5,5,0,100.0,0.0,Female
Marshella,1961,6,6,0,100.0,0.0,Female
Crista,1961,26,26,0,100.0,0.0,Female
Suzana,1961,12,12,0,100.0,0.0,Female
Jelayne,1961,5,5,0,100.0,0.0,Female
Soraida,1961,14,14,0,100.0,0.0,Female
Gayleen,1961,19,19,0,100.0,0.0,Female
Lela,1961,195,195,0,100.0,0.0,Female
Hosie,1961,7,0,7,0.0,100.0,Male
Domenic,1961,82,0,82,0.0,100.0,Male
Stephan,1961,440,6,434,1.3636363636363635,98.63636363636364,Male
Overton,1961,6,0,6,0.0,100.0,Male
Bascom,1961,5,0,5,0.0,100.0,Male
Alwyn,1961,5,0,5,0.0,100.0,Male
Mansfield,1961,5,0,5,0.0,100.0,Male
Secundino,1961,5,0,5,0.0,100.0,Male
Humphrey,1961,6,0,6,0.0,100.0,Male
Desmond,1961,92,0,92,0.0,100.0,Male
Roddy,1961,85,0,85,0.0,100.0,Male
Charleston,1961,12,0,12,0.0,100.0,Male
Obed,1961,11,0,11,0.0,100.0,Male
Richar,1961,6,0,6,0.0,100.0,Male
Darol,1961,8,0,8,0.0,100.0,Male
Herry,1961,5,0,5,0.0,100.0,Male
Burrell,1961,10,0,10,0.0,100.0,Male
Duane,1961,2749,14,2735,0.5092761004001455,99.49072389959986,Male
Seth,1961,329,0,329,0.0,100.0,Male
Demetrious,1961,6,0,6,0.0,100.0,Male
Crispin,1961,17,0,17,0.0,100.0,Male
Hunter,1961,70,0,70,0.0,100.0,Male
Rolla,1961,10,0,10,0.0,100.0,Male
Antone,1961,47,0,47,0.0,100.0,Male
Carlton,1961,777,7,770,0.9009009009009008,99.09909909909908,Male
Berton,1961,18,0,18,0.0,100.0,Male
Darrie,1961,9,0,9,0.0,100.0,Male
Daven,1961,7,0,7,0.0,100.0,Male
Rodric,1961,5,0,5,0.0,100.0,Male
Fredie,1961,10,0,10,0.0,100.0,Male
Kellen,1961,16,9,7,56.25,43.75,Unisex
Tonnie,1961,41,23,18,56.09756097560976,43.90243902439025,Unisex
Glendale,1961,16,7,9,43.75,56.25,Unisex
Merlyn,1961,24,7,17,29.166666666666668,70.83333333333334,Unisex
Torrey,1961,27,10,17,37.03703703703704,62.96296296296296,Unisex
Alva,1961,119,54,65,45.37815126050421,54.6218487394958,Unisex
Juel,1961,18,13,5,72.22222222222221,27.77777777777778,Unisex
Roben,1961,30,21,9,70.0,30.0,Unisex
Dana,1961,5237,3544,1693,67.67233148749284,32.32766851250716,Unisex
Frankie,1961,1101,295,806,26.7938237965486,73.2061762034514,Unisex
Tandy,1961,53,34,19,64.15094339622641,35.84905660377358,Unisex
Victory,1961,16,5,11,31.25,68.75,Unisex
Del,1961,116,26,90,22.41379310344828,77.58620689655173,Unisex
Lennie,1961,97,24,73,24.742268041237114,75.25773195876289,Unisex
Earlie,1961,27,10,17,37.03703703703704,62.96296296296296,Unisex
Ronie,1961,17,10,7,58.82352941176471,41.17647058823529,Unisex
Ardis,1961,53,40,13,75.47169811320755,24.52830188679245,Unisex
Lavaughn,1961,11,5,6,45.45454545454545,54.54545454545454,Unisex
Kem,1961,53,16,37,30.18867924528302,69.81132075471697,Unisex
Leith,1961,13,8,5,61.53846153846154,38.46153846153847,Unisex
Stacy,1961,1998,1675,323,83.83383383383384,16.166166166166164,Unisex
Marvel,1961,27,17,10,62.96296296296296,37.03703703703704,Unisex
Troye,1961,18,12,6,66.66666666666666,33.33333333333333,Unisex
Jackey,1961,20,6,14,30.0,70.0,Unisex
Dani,1961,76,64,12,84.21052631578947,15.789473684210526,Unisex
San,1961,50,42,8,84.0,16.0,Unisex
Dondi,1961,69,19,50,27.536231884057973,72.46376811594203,Unisex
Gerry,1961,449,74,375,16.481069042316257,83.51893095768375,Unisex
Kelsey,1961,33,18,15,54.54545454545454,45.45454545454545,Unisex
Khris,1961,11,5,6,45.45454545454545,54.54545454545454,Unisex
Dora,1962,841,841,0,100.0,0.0,Female
Meagan,1962,11,11,0,100.0,0.0,Female
Antonetta,1962,13,13,0,100.0,0.0,Female
Shawanda,1962,7,7,0,100.0,0.0,Female
Terresa,1962,73,73,0,100.0,0.0,Female
Estrelita,1962,7,7,0,100.0,0.0,Female
Quintina,1962,5,5,0,100.0,0.0,Female
Towana,1962,32,32,0,100.0,0.0,Female
Mitzy,1962,11,11,0,100.0,0.0,Female
June,1962,1470,1454,16,98.91156462585036,1.0884353741496595,Female
Suella,1962,6,6,0,100.0,0.0,Female
Meri,1962,76,76,0,100.0,0.0,Female
Rosyln,1962,5,5,0,100.0,0.0,Female
Sandrea,1962,6,6,0,100.0,0.0,Female
Beckie,1962,83,83,0,100.0,0.0,Female
Dominga,1962,26,26,0,100.0,0.0,Female
Dinorah,1962,5,5,0,100.0,0.0,Female
Christyne,1962,7,7,0,100.0,0.0,Female
Daisey,1962,11,11,0,100.0,0.0,Female
Kathyann,1962,10,10,0,100.0,0.0,Female
Janise,1962,34,34,0,100.0,0.0,Female
Gregoria,1962,9,9,0,100.0,0.0,Female
Develyn,1962,6,6,0,100.0,0.0,Female
Anamaria,1962,19,19,0,100.0,0.0,Female
Lashanda,1962,7,7,0,100.0,0.0,Female
Lucrecia,1962,17,17,0,100.0,0.0,Female
Marcianne,1962,13,13,0,100.0,0.0,Female
Deborh,1962,7,7,0,100.0,0.0,Female
Mya,1962,8,8,0,100.0,0.0,Female
Etta,1962,200,200,0,100.0,0.0,Female
Denzil,1962,38,0,38,0.0,100.0,Male
Milford,1962,46,0,46,0.0,100.0,Male
Aristedes,1962,5,0,5,0.0,100.0,Male
Harmon,1962,44,0,44,0.0,100.0,Male
Berkley,1962,12,0,12,0.0,100.0,Male
Benjamine,1962,19,0,19,0.0,100.0,Male
Thorne,1962,6,0,6,0.0,100.0,Male
Johnn,1962,15,0,15,0.0,100.0,Male
Serafino,1962,5,0,5,0.0,100.0,Male
Bonifacio,1962,12,0,12,0.0,100.0,Male
Ariel,1962,27,0,27,0.0,100.0,Male
Darwyn,1962,12,0,12,0.0,100.0,Male
Jules,1962,52,0,52,0.0,100.0,Male
Quentin,1962,139,0,139,0.0,100.0,Male
Alfonsa,1962,6,0,6,0.0,100.0,Male
Dan,1962,3119,6,3113,0.1923693491503687,99.80763065084965,Male
Braxton,1962,14,0,14,0.0,100.0,Male
Delmar,1962,92,0,92,0.0,100.0,Male
Dub,1962,5,0,5,0.0,100.0,Male
Erasmo,1962,41,0,41,0.0,100.0,Male
Jasper,1962,159,0,159,0.0,100.0,Male
Antony,1962,96,0,96,0.0,100.0,Male
Wessley,1962,7,0,7,0.0,100.0,Male
Clemente,1962,37,0,37,0.0,100.0,Male
Jairo,1962,6,0,6,0.0,100.0,Male
Barnett,1962,14,0,14,0.0,100.0,Male
Kelson,1962,5,0,5,0.0,100.0,Male
Jayce,1962,7,0,7,0.0,100.0,Male
Dag,1962,12,0,12,0.0,100.0,Male
Dionicio,1962,26,0,26,0.0,100.0,Male
Alva,1962,127,75,52,59.055118110236215,40.94488188976378,Unisex
Kacy,1962,17,12,5,70.58823529411765,29.411764705882355,Unisex
Carlon,1962,16,7,9,43.75,56.25,Unisex
Carrol,1962,71,54,17,76.05633802816901,23.943661971830984,Unisex
Larue,1962,40,19,21,47.5,52.5,Unisex
Rebel,1962,27,16,11,59.25925925925925,40.74074074074074,Unisex
Stacy,1962,2643,2227,416,84.26031025349981,15.739689746500188,Unisex
Orlanda,1962,15,5,10,33.33333333333333,66.66666666666666,Unisex
Adrain,1962,53,14,39,26.41509433962264,73.58490566037736,Unisex
Kris,1962,1103,590,513,53.49048050770625,46.50951949229374,Unisex
Elisha,1962,74,40,34,54.054054054054056,45.94594594594595,Unisex
Wynn,1962,41,14,27,34.14634146341464,65.85365853658537,Unisex
Laurin,1962,21,12,9,57.14285714285714,42.85714285714285,Unisex
Jae,1962,20,12,8,60.0,40.0,Unisex
Dandrea,1962,19,13,6,68.42105263157895,31.57894736842105,Unisex
Garnett,1962,39,10,29,25.64102564102564,74.35897435897436,Unisex
Jade,1962,44,33,11,75.0,25.0,Unisex
Garcia,1962,14,6,8,42.85714285714285,57.14285714285714,Unisex
Rikki,1962,22,17,5,77.27272727272727,22.727272727272727,Unisex
Jaye,1962,94,76,18,80.85106382978722,19.148936170212767,Unisex
Lavern,1962,174,108,66,62.06896551724138,37.93103448275862,Unisex
Antonia,1962,289,239,50,82.69896193771626,17.301038062283737,Unisex
Jewell,1962,150,126,24,84.0,16.0,Unisex
Claudie,1962,20,8,12,40.0,60.0,Unisex
Concepcion,1962,62,50,12,80.64516129032258,19.35483870967742,Unisex
Ricci,1962,18,7,11,38.88888888888889,61.11111111111112,Unisex
Dana,1962,5757,3961,1796,68.8031961090846,31.196803890915408,Unisex
Lin,1962,40,22,18,55.00000000000001,45.0,Unisex
Allie,1962,44,24,20,54.54545454545454,45.45454545454545,Unisex
Carlen,1962,15,8,7,53.333333333333336,46.66666666666666,Unisex
Suzy,1963,199,199,0,100.0,0.0,Female
Lamona,1963,15,15,0,100.0,0.0,Female
Jaylyn,1963,5,5,0,100.0,0.0,Female
Shonia,1963,6,6,0,100.0,0.0,Female
Arlee,1963,5,5,0,100.0,0.0,Female
Kamille,1963,9,9,0,100.0,0.0,Female
Willene,1963,28,28,0,100.0,0.0,Female
Noelia,1963,44,44,0,100.0,0.0,Female
Donia,1963,9,9,0,100.0,0.0,Female
Marijke,1963,5,5,0,100.0,0.0,Female
Kati,1963,14,14,0,100.0,0.0,Female
Alexandra,1963,236,236,0,100.0,0.0,Female
Emmer,1963,5,5,0,100.0,0.0,Female
Hilary,1963,273,249,24,91.2087912087912,8.791208791208792,Female
Durenda,1963,10,10,0,100.0,0.0,Female
Bernardine,1963,21,21,0,100.0,0.0,Female
Chequita,1963,9,9,0,100.0,0.0,Female
Julieann,1963,55,55,0,100.0,0.0,Female
Chante,1963,10,10,0,100.0,0.0,Female
Averil,1963,16,16,0,100.0,0.0,Female
Florentina,1963,7,7,0,100.0,0.0,Female
Voula,1963,6,6,0,100.0,0.0,Female
Kiki,1963,15,15,0,100.0,0.0,Female
Sharan,1963,13,13,0,100.0,0.0,Female
Gracemarie,1963,7,7,0,100.0,0.0,Female
Valery,1963,34,34,0,100.0,0.0,Female
Lendy,1963,5,5,0,100.0,0.0,Female
Emelie,1963,5,5,0,100.0,0.0,Female
Romy,1963,40,40,0,100.0,0.0,Female
Tasha,1963,47,47,0,100.0,0.0,Female
Loring,1963,13,0,13,0.0,100.0,Male
Devry,1963,7,0,7,0.0,100.0,Male
Archibald,1963,11,0,11,0.0,100.0,Male
Durwood,1963,23,0,23,0.0,100.0,Male
Daivd,1963,16,0,16,0.0,100.0,Male
Salvatore,1963,565,0,565,0.0,100.0,Male
Thadd,1963,6,0,6,0.0,100.0,Male
Placido,1963,7,0,7,0.0,100.0,Male
Johnn,1963,7,0,7,0.0,100.0,Male
Levan,1963,6,0,6,0.0,100.0,Male
Detrick,1963,5,0,5,0.0,100.0,Male
Lamoyne,1963,5,0,5,0.0,100.0,Male
Verner,1963,14,0,14,0.0,100.0,Male
Alvin,1963,1516,14,1502,0.9234828496042216,99.0765171503958,Male
Zachariah,1963,5,0,5,0.0,100.0,Male
Andrew,1963,9552,34,9518,0.3559463986599664,99.64405360134003,Male
Adelbert,1963,9,0,9,0.0,100.0,Male
Dale,1963,6064,368,5696,6.068601583113456,93.93139841688657,Male
Clete,1963,14,0,14,0.0,100.0,Male
Abelino,1963,6,0,6,0.0,100.0,Male
Link,1963,29,0,29,0.0,100.0,Male
Sumner,1963,8,0,8,0.0,100.0,Male
Emerson,1963,89,0,89,0.0,100.0,Male
Kale,1963,14,0,14,0.0,100.0,Male
Heraldo,1963,6,0,6,0.0,100.0,Male
Melvin,1963,2574,27,2547,1.048951048951049,98.95104895104896,Male
Kerman,1963,7,0,7,0.0,100.0,Male
Benedetto,1963,8,0,8,0.0,100.0,Male
Ponce,1963,6,0,6,0.0,100.0,Male
Loren,1963,776,83,693,10.695876288659791,89.30412371134021,Male
Larrie,1963,15,7,8,46.66666666666666,53.333333333333336,Unisex
Martie,1963,42,28,14,66.66666666666666,33.33333333333333,Unisex
Lennie,1963,78,17,61,21.7948717948718,78.2051282051282,Unisex
Frenchie,1963,16,11,5,68.75,31.25,Unisex
Jamy,1963,16,10,6,62.5,37.5,Unisex
Criss,1963,26,14,12,53.84615384615385,46.15384615384615,Unisex
Carle,1963,15,6,9,40.0,60.0,Unisex
Lindsey,1963,181,57,124,31.49171270718232,68.50828729281768,Unisex
Aundra,1963,37,9,28,24.324324324324326,75.67567567567568,Unisex
Dorris,1963,34,28,6,82.35294117647058,17.647058823529413,Unisex
Beni,1963,10,5,5,50.0,50.0,Unisex
Vernell,1963,105,68,37,64.76190476190476,35.23809523809524,Unisex
Jene,1963,19,12,7,63.1578947368421,36.84210526315789,Unisex
Clovis,1963,28,8,20,28.57142857142857,71.42857142857143,Unisex
Jackie,1963,3883,2821,1062,72.65001287664177,27.349987123358225,Unisex
Dannell,1963,11,6,5,54.54545454545454,45.45454545454545,Unisex
Andrae,1963,12,5,7,41.66666666666667,58.333333333333336,Unisex
Dany,1963,14,6,8,42.85714285714285,57.14285714285714,Unisex
Kit,1963,77,35,42,45.45454545454545,54.54545454545454,Unisex
Nikita,1963,45,26,19,57.77777777777777,42.22222222222222,Unisex
Temple,1963,23,18,5,78.26086956521739,21.73913043478261,Unisex
Storm,1963,12,7,5,58.333333333333336,41.66666666666667,Unisex
Audry,1963,26,21,5,80.76923076923077,19.23076923076924,Unisex
Tobie,1963,33,28,5,84.84848484848484,15.151515151515152,Unisex
Georgie,1963,60,41,19,68.33333333333333,31.666666666666664,Unisex
Kai,1963,43,8,35,18.6046511627907,81.3953488372093,Unisex
Haley,1963,30,23,7,76.66666666666667,23.33333333333333,Unisex
Lenell,1963,16,8,8,50.0,50.0,Unisex
Demetrious,1963,18,7,11,38.88888888888889,61.11111111111112,Unisex
Eden,1963,42,29,13,69.04761904761905,30.95238095238096,Unisex
Kandice,1964,20,20,0,100.0,0.0,Female
Solita,1964,7,7,0,100.0,0.0,Female
Ruth,1964,3657,3640,17,99.53513809133167,0.4648619086683073,Female
Letetia,1964,10,10,0,100.0,0.0,Female
Zoila,1964,9,9,0,100.0,0.0,Female
Juana,1964,167,167,0,100.0,0.0,Female
Amity,1964,6,6,0,100.0,0.0,Female
Lawonda,1964,10,10,0,100.0,0.0,Female
Ghislaine,1964,5,5,0,100.0,0.0,Female
Franceen,1964,7,7,0,100.0,0.0,Female
Mellissa,1964,49,49,0,100.0,0.0,Female
Ramonia,1964,14,14,0,100.0,0.0,Female
Marleah,1964,5,5,0,100.0,0.0,Female
Anjeanette,1964,17,17,0,100.0,0.0,Female
Simone,1964,248,248,0,100.0,0.0,Female
Audrey,1964,1883,1868,15,99.20339883165164,0.7966011683483802,Female
Katonya,1964,5,5,0,100.0,0.0,Female
Shanette,1964,5,5,0,100.0,0.0,Female
Anita,1964,4921,4908,13,99.73582605161552,0.2641739483844747,Female
Nellie,1964,262,262,0,100.0,0.0,Female
Suzanna,1964,105,105,0,100.0,0.0,Female
Brooksie,1964,5,5,0,100.0,0.0,Female
Keitha,1964,27,27,0,100.0,0.0,Female
Dorcas,1964,87,87,0,100.0,0.0,Female
Sanna,1964,6,6,0,100.0,0.0,Female
Licia,1964,30,30,0,100.0,0.0,Female
Carmell,1964,9,9,0,100.0,0.0,Female
Rita,1964,3481,3470,11,99.68399885090491,0.3160011490950876,Female
Marylu,1964,8,8,0,100.0,0.0,Female
Adline,1964,6,6,0,100.0,0.0,Female
Jeremy,1964,213,0,213,0.0,100.0,Male
Lenon,1964,6,0,6,0.0,100.0,Male
Hipolito,1964,18,0,18,0.0,100.0,Male
Artis,1964,64,9,55,14.0625,85.9375,Male
Conley,1964,17,0,17,0.0,100.0,Male
Burley,1964,14,0,14,0.0,100.0,Male
Craig,1964,7771,20,7751,0.2573671342169604,99.74263286578304,Male
Clayburn,1964,7,0,7,0.0,100.0,Male
Uriel,1964,19,0,19,0.0,100.0,Male
Charle,1964,20,0,20,0.0,100.0,Male
Waldemar,1964,8,0,8,0.0,100.0,Male
Deion,1964,9,0,9,0.0,100.0,Male
Dearl,1964,9,0,9,0.0,100.0,Male
Darvin,1964,51,0,51,0.0,100.0,Male
Jarrett,1964,32,0,32,0.0,100.0,Male
Demorris,1964,6,0,6,0.0,100.0,Male
Detrick,1964,6,0,6,0.0,100.0,Male
Leonel,1964,75,0,75,0.0,100.0,Male
Alvan,1964,5,0,5,0.0,100.0,Male
Garren,1964,13,0,13,0.0,100.0,Male
Werner,1964,43,0,43,0.0,100.0,Male
Decarlos,1964,5,0,5,0.0,100.0,Male
Rudie,1964,5,0,5,0.0,100.0,Male
Shedrick,1964,22,0,22,0.0,100.0,Male
Patrick,1964,14754,58,14696,0.3931137318693235,99.60688626813068,Male
Lavert,1964,5,0,5,0.0,100.0,Male
Brodie,1964,5,0,5,0.0,100.0,Male
Delfred,1964,5,0,5,0.0,100.0,Male
Slyvester,1964,9,0,9,0.0,100.0,Male
Steven,1964,29809,95,29714,0.3186956959307591,99.68130430406924,Male
Shawne,1964,51,41,10,80.3921568627451,19.607843137254903,Unisex
Ardell,1964,27,12,15,44.44444444444444,55.55555555555556,Unisex
Lavelle,1964,31,7,24,22.58064516129032,77.41935483870968,Unisex
Arden,1964,59,19,40,32.20338983050847,67.79661016949152,Unisex
Elza,1964,12,5,7,41.66666666666667,58.333333333333336,Unisex
Isa,1964,20,14,6,70.0,30.0,Unisex
Bryn,1964,25,13,12,52.0,48.0,Unisex
Shon,1964,75,17,58,22.666666666666664,77.33333333333333,Unisex
Danie,1964,17,6,11,35.294117647058826,64.70588235294117,Unisex
Georgie,1964,53,39,14,73.58490566037736,26.41509433962264,Unisex
Aundrey,1964,12,5,7,41.66666666666667,58.333333333333336,Unisex
Vada,1964,45,25,20,55.55555555555556,44.44444444444444,Unisex
Tyree,1964,33,8,25,24.24242424242424,75.75757575757575,Unisex
Lesley,1964,481,403,78,83.78378378378379,16.216216216216218,Unisex
Sasha,1964,14,9,5,64.28571428571429,35.714285714285715,Unisex
Shawnn,1964,11,6,5,54.54545454545454,45.45454545454545,Unisex
Glendale,1964,13,5,8,38.46153846153847,61.53846153846154,Unisex
Jerre,1964,14,7,7,50.0,50.0,Unisex
Courtenay,1964,17,12,5,70.58823529411765,29.411764705882355,Unisex
Mackie,1964,14,6,8,42.85714285714285,57.14285714285714,Unisex
Whitney,1964,453,331,122,73.06843267108167,26.93156732891832,Unisex
Michale,1964,63,11,52,17.46031746031746,82.53968253968253,Unisex
Stephane,1964,19,12,7,63.1578947368421,36.84210526315789,Unisex
Karry,1964,46,25,21,54.34782608695652,45.65217391304348,Unisex
Tonnie,1964,43,27,16,62.7906976744186,37.2093023255814,Unisex
Trinidad,1964,61,30,31,49.18032786885246,50.81967213114754,Unisex
Lael,1964,19,13,6,68.42105263157895,31.57894736842105,Unisex
Carmon,1964,34,26,8,76.47058823529412,23.52941176470588,Unisex
Shelby,1964,434,317,117,73.04147465437788,26.95852534562212,Unisex
Natividad,1964,33,17,16,51.51515151515152,48.48484848484848,Unisex
Jolanda,1965,55,55,0,100.0,0.0,Female
Amina,1965,12,12,0,100.0,0.0,Female
Delita,1965,6,6,0,100.0,0.0,Female
Melessia,1965,12,12,0,100.0,0.0,Female
Gaylene,1965,71,71,0,100.0,0.0,Female
Monic,1965,8,8,0,100.0,0.0,Female
Raynelle,1965,6,6,0,100.0,0.0,Female
Rogena,1965,7,7,0,100.0,0.0,Female
Mariaelena,1965,31,31,0,100.0,0.0,Female
Areta,1965,8,8,0,100.0,0.0,Female
Nanci,1965,129,129,0,100.0,0.0,Female
Ronya,1965,6,6,0,100.0,0.0,Female
Emely,1965,8,8,0,100.0,0.0,Female
Petra,1965,155,155,0,100.0,0.0,Female
Tajuana,1965,16,16,0,100.0,0.0,Female
Alanna,1965,39,39,0,100.0,0.0,Female
Yuette,1965,6,6,0,100.0,0.0,Female
Alise,1965,33,33,0,100.0,0.0,Female
Rox,1965,9,9,0,100.0,0.0,Female
Sylvana,1965,5,5,0,100.0,0.0,Female
Laverne,1965,341,291,50,85.33724340175954,14.66275659824047,Female
Ulanda,1965,11,11,0,100.0,0.0,Female
Sharen,1965,49,49,0,100.0,0.0,Female
Vallie,1965,9,9,0,100.0,0.0,Female
Torri,1965,30,30,0,100.0,0.0,Female
Talli,1965,5,5,0,100.0,0.0,Female
Jil,1965,13,13,0,100.0,0.0,Female
Shaaron,1965,6,6,0,100.0,0.0,Female
Ida,1965,523,518,5,99.04397705544932,0.9560229445506692,Female
Merlene,1965,19,19,0,100.0,0.0,Female
Jolly,1965,5,0,5,0.0,100.0,Male
Sanjay,1965,14,0,14,0.0,100.0,Male
Bacilio,1965,5,0,5,0.0,100.0,Male
Demitrius,1965,6,0,6,0.0,100.0,Male
Yves,1965,14,0,14,0.0,100.0,Male
Timmey,1965,5,0,5,0.0,100.0,Male
Bud,1965,73,0,73,0.0,100.0,Male
Norvell,1965,16,0,16,0.0,100.0,Male
Nero,1965,5,0,5,0.0,100.0,Male
Michaeal,1965,6,0,6,0.0,100.0,Male
Linus,1965,21,0,21,0.0,100.0,Male
Beecher,1965,7,0,7,0.0,100.0,Male
Milan,1965,48,0,48,0.0,100.0,Male
Lonny,1965,159,0,159,0.0,100.0,Male
Roberto,1965,1079,17,1062,1.5755329008341057,98.4244670991659,Male
Everett,1965,660,7,653,1.0606060606060608,98.93939393939394,Male
Mikeal,1965,31,0,31,0.0,100.0,Male
Mac,1965,73,0,73,0.0,100.0,Male
Quenten,1965,5,0,5,0.0,100.0,Male
Tyson,1965,46,0,46,0.0,100.0,Male
Wyatt,1965,78,0,78,0.0,100.0,Male
Artemio,1965,16,0,16,0.0,100.0,Male
Grabiel,1965,7,0,7,0.0,100.0,Male
Zackery,1965,21,0,21,0.0,100.0,Male
Darion,1965,26,0,26,0.0,100.0,Male
Froilan,1965,5,0,5,0.0,100.0,Male
Linzy,1965,6,0,6,0.0,100.0,Male
Tarik,1965,7,0,7,0.0,100.0,Male
Ballard,1965,9,0,9,0.0,100.0,Male
Obie,1965,24,0,24,0.0,100.0,Male
Nikita,1965,42,24,18,57.14285714285714,42.85714285714285,Unisex
Storm,1965,11,5,6,45.45454545454545,54.54545454545454,Unisex
Victory,1965,17,9,8,52.94117647058824,47.05882352941176,Unisex
Carey,1965,434,150,284,34.56221198156682,65.43778801843318,Unisex
Temple,1965,48,26,22,54.16666666666666,45.83333333333333,Unisex
Young,1965,20,8,12,40.0,60.0,Unisex
Rossie,1965,14,6,8,42.85714285714285,57.14285714285714,Unisex
Layne,1965,100,15,85,15.0,85.0,Unisex
Augusta,1965,37,25,12,67.56756756756756,32.432432432432435,Unisex
Raymie,1965,18,7,11,38.88888888888889,61.11111111111112,Unisex
Vernell,1965,108,60,48,55.55555555555556,44.44444444444444,Unisex
Marion,1965,997,567,430,56.87061183550652,43.12938816449349,Unisex
Terran,1965,11,6,5,54.54545454545454,45.45454545454545,Unisex
Teal,1965,23,17,6,73.91304347826086,26.08695652173913,Unisex
Cortney,1965,22,10,12,45.45454545454545,54.54545454545454,Unisex
Dorian,1965,92,34,58,36.95652173913043,63.04347826086957,Unisex
Val,1965,98,24,74,24.489795918367346,75.51020408163265,Unisex
Ardell,1965,21,7,14,33.33333333333333,66.66666666666666,Unisex
Joie,1965,26,19,7,73.07692307692307,26.923076923076923,Unisex
Carmon,1965,32,24,8,75.0,25.0,Unisex
Lupe,1965,244,184,60,75.40983606557377,24.59016393442623,Unisex
Krishna,1965,12,6,6,50.0,50.0,Unisex
Kimmy,1965,53,43,10,81.13207547169812,18.867924528301888,Unisex
Holland,1965,20,5,15,25.0,75.0,Unisex
Laine,1965,20,8,12,40.0,60.0,Unisex
Carroll,1965,226,49,177,21.68141592920354,78.31858407079646,Unisex
Marin,1965,14,8,6,57.14285714285714,42.85714285714285,Unisex
Ocie,1965,31,6,25,19.35483870967742,80.64516129032258,Unisex
Jeffrie,1965,30,7,23,23.33333333333333,76.66666666666667,Unisex
Lee,1965,4073,1300,2773,31.91750552418365,68.08249447581635,Unisex
Merlinda,1966,18,18,0,100.0,0.0,Female
Ardith,1966,22,22,0,100.0,0.0,Female
Araceli,1966,68,68,0,100.0,0.0,Female
Catrice,1966,12,12,0,100.0,0.0,Female
Romonda,1966,7,7,0,100.0,0.0,Female
Dollie,1966,45,45,0,100.0,0.0,Female
Cozette,1966,16,16,0,100.0,0.0,Female
Theodosia,1966,7,7,0,100.0,0.0,Female
Candra,1966,11,11,0,100.0,0.0,Female
Camile,1966,7,7,0,100.0,0.0,Female
Retonia,1966,6,6,0,100.0,0.0,Female
Mariaelena,1966,25,25,0,100.0,0.0,Female
Corrine,1966,187,187,0,100.0,0.0,Female
Cassie,1966,151,151,0,100.0,0.0,Female
Sherby,1966,5,5,0,100.0,0.0,Female
Concha,1966,5,5,0,100.0,0.0,Female
Delbra,1966,5,5,0,100.0,0.0,Female
Malissa,1966,183,183,0,100.0,0.0,Female
Lynann,1966,10,10,0,100.0,0.0,Female
Francies,1966,6,6,0,100.0,0.0,Female
Mirenda,1966,7,7,0,100.0,0.0,Female
Maryellen,1966,226,226,0,100.0,0.0,Female
Gerianne,1966,18,18,0,100.0,0.0,Female
Loretha,1966,21,21,0,100.0,0.0,Female
Nancey,1966,9,9,0,100.0,0.0,Female
Annita,1966,21,21,0,100.0,0.0,Female
Verlena,1966,7,7,0,100.0,0.0,Female
Elanda,1966,14,14,0,100.0,0.0,Female
Mariea,1966,18,18,0,100.0,0.0,Female
Keila,1966,10,10,0,100.0,0.0,Female
Ian,1966,621,0,621,0.0,100.0,Male
Jerrid,1966,7,0,7,0.0,100.0,Male
Giacomo,1966,11,0,11,0.0,100.0,Male
Arcadio,1966,13,0,13,0.0,100.0,Male
Giancarlo,1966,6,0,6,0.0,100.0,Male
Reynard,1966,7,0,7,0.0,100.0,Male
Marshall,1966,674,15,659,2.225519287833828,97.77448071216617,Male
Rober,1966,7,0,7,0.0,100.0,Male
Kye,1966,5,0,5,0.0,100.0,Male
Montey,1966,5,0,5,0.0,100.0,Male
Marque,1966,9,0,9,0.0,100.0,Male
Kennis,1966,6,0,6,0.0,100.0,Male
Giovanni,1966,64,0,64,0.0,100.0,Male
Darron,1966,295,0,295,0.0,100.0,Male
Daymond,1966,11,0,11,0.0,100.0,Male
Rakesh,1966,5,0,5,0.0,100.0,Male
Lonne,1966,6,0,6,0.0,100.0,Male
Johnpaul,1966,10,0,10,0.0,100.0,Male
Eril,1966,6,0,6,0.0,100.0,Male
Hayes,1966,15,0,15,0.0,100.0,Male
Tray,1966,14,0,14,0.0,100.0,Male
Deray,1966,5,0,5,0.0,100.0,Male
Parks,1966,7,0,7,0.0,100.0,Male
Corky,1966,9,0,9,0.0,100.0,Male
Lynward,1966,5,0,5,0.0,100.0,Male
Cesar,1966,212,0,212,0.0,100.0,Male
Anand,1966,5,0,5,0.0,100.0,Male
Luiz,1966,17,0,17,0.0,100.0,Male
Kirtus,1966,5,0,5,0.0,100.0,Male
Mickal,1966,8,0,8,0.0,100.0,Male
Carlee,1966,13,8,5,61.53846153846154,38.46153846153847,Unisex
Gabriele,1966,28,22,6,78.57142857142857,21.428571428571427,Unisex
Quinn,1966,134,24,110,17.91044776119403,82.08955223880598,Unisex
Dominique,1966,139,116,23,83.45323741007195,16.546762589928058,Unisex
Kellen,1966,13,6,7,46.15384615384615,53.84615384615385,Unisex
Jessie,1966,1377,475,902,34.49527959331881,65.50472040668119,Unisex
Jaimie,1966,42,27,15,64.28571428571429,35.714285714285715,Unisex
Adell,1966,24,16,8,66.66666666666666,33.33333333333333,Unisex
Estel,1966,18,5,13,27.77777777777778,72.22222222222221,Unisex
Jonnie,1966,71,43,28,60.56338028169014,39.436619718309856,Unisex
Caroll,1966,20,10,10,50.0,50.0,Unisex
Joie,1966,24,17,7,70.83333333333334,29.166666666666668,Unisex
Angel,1966,1205,438,767,36.34854771784232,63.65145228215767,Unisex
Desi,1966,26,5,21,19.23076923076924,80.76923076923077,Unisex
Raynell,1966,24,18,6,75.0,25.0,Unisex
Deshon,1966,15,9,6,60.0,40.0,Unisex
Brandy,1966,121,100,21,82.64462809917356,17.355371900826448,Unisex
Marvis,1966,22,10,12,45.45454545454545,54.54545454545454,Unisex
Wynne,1966,29,19,10,65.51724137931035,34.48275862068966,Unisex
Shelby,1966,460,304,156,66.08695652173913,33.91304347826087,Unisex
Sydney,1966,209,167,42,79.90430622009569,20.095693779904305,Unisex
Lee,1966,4175,1211,2964,29.005988023952096,70.9940119760479,Unisex
London,1966,39,11,28,28.205128205128204,71.7948717948718,Unisex
Donis,1966,12,6,6,50.0,50.0,Unisex
Dana,1966,6295,5277,1018,83.82843526608418,16.171564733915805,Unisex
Laverne,1966,332,282,50,84.93975903614458,15.060240963855422,Unisex
Kasey,1966,105,73,32,69.52380952380952,30.47619047619048,Unisex
Marvel,1966,24,12,12,50.0,50.0,Unisex
Delon,1966,21,5,16,23.809523809523807,76.19047619047619,Unisex
Gale,1966,299,234,65,78.26086956521739,21.73913043478261,Unisex
Laurie,1967,4940,4924,16,99.67611336032388,0.3238866396761133,Female
Roshawn,1967,6,6,0,100.0,0.0,Female
Loralei,1967,6,6,0,100.0,0.0,Female
Aletia,1967,8,8,0,100.0,0.0,Female
Donice,1967,7,7,0,100.0,0.0,Female
Chanelle,1967,15,15,0,100.0,0.0,Female
Monice,1967,12,12,0,100.0,0.0,Female
Jamela,1967,5,5,0,100.0,0.0,Female
Fatima,1967,74,74,0,100.0,0.0,Female
Sheryll,1967,12,12,0,100.0,0.0,Female
Sebrena,1967,32,32,0,100.0,0.0,Female
Judee,1967,11,11,0,100.0,0.0,Female
Janele,1967,5,5,0,100.0,0.0,Female
Taressa,1967,6,6,0,100.0,0.0,Female
Kay,1967,720,710,10,98.61111111111111,1.3888888888888888,Female
Isa,1967,15,15,0,100.0,0.0,Female
Karlyn,1967,24,24,0,100.0,0.0,Female
Renada,1967,9,9,0,100.0,0.0,Female
Danene,1967,27,27,0,100.0,0.0,Female
Bambie,1967,5,5,0,100.0,0.0,Female
Salome,1967,13,13,0,100.0,0.0,Female
Solveig,1967,7,7,0,100.0,0.0,Female
Marlaina,1967,6,6,0,100.0,0.0,Female
Reine,1967,8,8,0,100.0,0.0,Female
Marykate,1967,8,8,0,100.0,0.0,Female
Peni,1967,5,5,0,100.0,0.0,Female
Lorijo,1967,7,7,0,100.0,0.0,Female
Alonda,1967,19,19,0,100.0,0.0,Female
Natarsha,1967,5,5,0,100.0,0.0,Female
Georgann,1967,16,16,0,100.0,0.0,Female
Cristian,1967,8,0,8,0.0,100.0,Male
Edouard,1967,7,0,7,0.0,100.0,Male
Gerrick,1967,5,0,5,0.0,100.0,Male
Mitchel,1967,107,0,107,0.0,100.0,Male
Lawernce,1967,8,0,8,0.0,100.0,Male
Lamark,1967,12,0,12,0.0,100.0,Male
Arnulfo,1967,51,0,51,0.0,100.0,Male
Rodolfo,1967,331,0,331,0.0,100.0,Male
Noal,1967,10,0,10,0.0,100.0,Male
Isidro,1967,50,0,50,0.0,100.0,Male
Harrel,1967,5,0,5,0.0,100.0,Male
Jerrick,1967,6,0,6,0.0,100.0,Male
Merrick,1967,14,0,14,0.0,100.0,Male
Alegandro,1967,5,0,5,0.0,100.0,Male
Johan,1967,10,0,10,0.0,100.0,Male
Taft,1967,12,0,12,0.0,100.0,Male
Emmitt,1967,50,0,50,0.0,100.0,Male
Donaciano,1967,9,0,9,0.0,100.0,Male
Terril,1967,9,0,9,0.0,100.0,Male
Gian,1967,15,0,15,0.0,100.0,Male
Darl,1967,16,0,16,0.0,100.0,Male
Andrius,1967,6,0,6,0.0,100.0,Male
Arlan,1967,27,0,27,0.0,100.0,Male
Baltazar,1967,15,0,15,0.0,100.0,Male
Duane,1967,2128,17,2111,0.7988721804511277,99.20112781954889,Male
Yosef,1967,7,0,7,0.0,100.0,Male
Kalani,1967,9,0,9,0.0,100.0,Male
Jerrid,1967,5,0,5,0.0,100.0,Male
Edgard,1967,10,0,10,0.0,100.0,Male
Shedrick,1967,47,0,47,0.0,100.0,Male
Shayne,1967,135,25,110,18.51851851851852,81.48148148148148,Unisex
Temple,1967,44,30,14,68.18181818181817,31.818181818181817,Unisex
Blair,1967,244,42,202,17.21311475409836,82.78688524590164,Unisex
Leslie,1967,6380,5318,1062,83.35423197492163,16.645768025078368,Unisex
Ivey,1967,22,12,10,54.54545454545454,45.45454545454545,Unisex
Robi,1967,10,5,5,50.0,50.0,Unisex
Nicola,1967,106,87,19,82.0754716981132,17.92452830188679,Unisex
Davi,1967,13,7,6,53.84615384615385,46.15384615384615,Unisex
Lindsey,1967,142,54,88,38.0281690140845,61.97183098591549,Unisex
Merle,1967,110,19,91,17.272727272727273,82.72727272727273,Unisex
Sunny,1967,55,44,11,80.0,20.0,Unisex
Barrie,1967,46,37,9,80.43478260869566,19.565217391304348,Unisex
Lavon,1967,69,37,32,53.62318840579711,46.3768115942029,Unisex
Rennie,1967,15,5,10,33.33333333333333,66.66666666666666,Unisex
Arie,1967,23,14,9,60.86956521739131,39.130434782608695,Unisex
Daniell,1967,19,14,5,73.68421052631578,26.31578947368421,Unisex
Garrie,1967,10,5,5,50.0,50.0,Unisex
Undra,1967,38,10,28,26.31578947368421,73.68421052631578,Unisex
Lorenza,1967,65,22,43,33.84615384615385,66.15384615384615,Unisex
Carmon,1967,34,23,11,67.64705882352942,32.35294117647059,Unisex
Kristian,1967,102,39,63,38.23529411764706,61.76470588235294,Unisex
Allie,1967,32,19,13,59.375,40.625,Unisex
Marin,1967,20,11,9,55.00000000000001,45.0,Unisex
Cris,1967,91,35,56,38.46153846153847,61.53846153846154,Unisex
Illya,1967,66,10,56,15.151515151515152,84.84848484848484,Unisex
Hollis,1967,98,31,67,31.63265306122449,68.36734693877551,Unisex
Adell,1967,18,8,10,44.44444444444444,55.55555555555556,Unisex
Dorsey,1967,29,7,22,24.13793103448276,75.86206896551724,Unisex
Lavern,1967,119,70,49,58.82352941176471,41.17647058823529,Unisex
Terryl,1967,24,8,16,33.33333333333333,66.66666666666666,Unisex
Marjory,1968,21,21,0,100.0,0.0,Female
Glorianna,1968,5,5,0,100.0,0.0,Female
Melannie,1968,9,9,0,100.0,0.0,Female
Jeanell,1968,9,9,0,100.0,0.0,Female
Artemis,1968,12,12,0,100.0,0.0,Female
Davina,1968,156,156,0,100.0,0.0,Female
Sorena,1968,5,5,0,100.0,0.0,Female
Genea,1968,11,11,0,100.0,0.0,Female
Librada,1968,8,8,0,100.0,0.0,Female
Uneeda,1968,5,5,0,100.0,0.0,Female
Dorla,1968,6,6,0,100.0,0.0,Female
Janeene,1968,7,7,0,100.0,0.0,Female
Liana,1968,106,106,0,100.0,0.0,Female
Peggysue,1968,5,5,0,100.0,0.0,Female
Tamra,1968,463,458,5,98.92008639308855,1.079913606911447,Female
Stephany,1968,87,87,0,100.0,0.0,Female
Bozena,1968,8,8,0,100.0,0.0,Female
Lenise,1968,17,17,0,100.0,0.0,Female
Caralee,1968,13,13,0,100.0,0.0,Female
Velissa,1968,6,6,0,100.0,0.0,Female
Marisella,1968,6,6,0,100.0,0.0,Female
Kristee,1968,14,14,0,100.0,0.0,Female
Kimberlin,1968,12,12,0,100.0,0.0,Female
Doraine,1968,7,7,0,100.0,0.0,Female
Cheryll,1968,41,41,0,100.0,0.0,Female
Phyliss,1968,17,17,0,100.0,0.0,Female
Saralyn,1968,12,12,0,100.0,0.0,Female
Chrisanne,1968,14,14,0,100.0,0.0,Female
Dorothey,1968,5,5,0,100.0,0.0,Female
Allisa,1968,20,20,0,100.0,0.0,Female
Jonas,1968,58,0,58,0.0,100.0,Male
Mckinley,1968,45,0,45,0.0,100.0,Male
Atul,1968,5,0,5,0.0,100.0,Male
Corley,1968,8,0,8,0.0,100.0,Male
Claude,1968,535,5,530,0.9345794392523364,99.06542056074768,Male
Conell,1968,6,0,6,0.0,100.0,Male
Antoine,1968,252,7,245,2.7777777777777777,97.2222222222222,Male
Melford,1968,6,0,6,0.0,100.0,Male
Aryeh,1968,7,0,7,0.0,100.0,Male
Tod,1968,302,0,302,0.0,100.0,Male
Harwood,1968,5,0,5,0.0,100.0,Male
Ilan,1968,7,0,7,0.0,100.0,Male
Alvaro,1968,63,0,63,0.0,100.0,Male
Lawrance,1968,33,0,33,0.0,100.0,Male
Aarron,1968,7,0,7,0.0,100.0,Male
Merlin,1968,65,0,65,0.0,100.0,Male
Okey,1968,5,0,5,0.0,100.0,Male
Correy,1968,6,0,6,0.0,100.0,Male
Ryland,1968,16,0,16,0.0,100.0,Male
Esequiel,1968,26,0,26,0.0,100.0,Male
Alejandro,1968,426,5,421,1.1737089201877933,98.8262910798122,Male
Hermes,1968,8,0,8,0.0,100.0,Male
Zeb,1968,8,0,8,0.0,100.0,Male
Redginald,1968,6,0,6,0.0,100.0,Male
Jeramy,1968,7,0,7,0.0,100.0,Male
Terran,1968,8,0,8,0.0,100.0,Male
Hale,1968,5,0,5,0.0,100.0,Male
Imre,1968,6,0,6,0.0,100.0,Male
Meliton,1968,5,0,5,0.0,100.0,Male
Jud,1968,11,0,11,0.0,100.0,Male
Danie,1968,14,6,8,42.85714285714285,57.14285714285714,Unisex
Loy,1968,24,6,18,25.0,75.0,Unisex
Maris,1968,12,5,7,41.66666666666667,58.333333333333336,Unisex
Aundra,1968,42,16,26,38.095238095238095,61.90476190476191,Unisex
Tyree,1968,33,7,26,21.21212121212121,78.78787878787878,Unisex
Lavelle,1968,28,5,23,17.857142857142858,82.14285714285714,Unisex
Concepcion,1968,51,41,10,80.3921568627451,19.607843137254903,Unisex
Corrie,1968,73,58,15,79.45205479452055,20.54794520547945,Unisex
Donne,1968,12,6,6,50.0,50.0,Unisex
Marlowe,1968,24,10,14,41.66666666666667,58.333333333333336,Unisex
Jacque,1968,105,70,35,66.66666666666666,33.33333333333333,Unisex
Nevada,1968,17,12,5,70.58823529411765,29.411764705882355,Unisex
Martie,1968,29,16,13,55.172413793103445,44.82758620689656,Unisex
Tandy,1968,43,35,8,81.3953488372093,18.6046511627907,Unisex
Shannon,1968,8108,6402,1706,78.9590527873705,21.0409472126295,Unisex
Dashawn,1968,13,8,5,61.53846153846154,38.46153846153847,Unisex
Demetri,1968,17,5,12,29.411764705882355,70.58823529411765,Unisex
Shean,1968,21,6,15,28.57142857142857,71.42857142857143,Unisex
Adrain,1968,70,26,44,37.142857142857146,62.85714285714285,Unisex
Elisha,1968,92,70,22,76.08695652173914,23.91304347826087,Unisex
Christan,1968,19,11,8,57.89473684210527,42.10526315789473,Unisex
Tally,1968,13,8,5,61.53846153846154,38.46153846153847,Unisex
Lacy,1968,112,44,68,39.285714285714285,60.71428571428571,Unisex
Doni,1968,26,19,7,73.07692307692307,26.923076923076923,Unisex
Tracy,1968,15397,12742,2655,82.75638111320387,17.24361888679613,Unisex
Ardell,1968,12,6,6,50.0,50.0,Unisex
Caroll,1968,18,13,5,72.22222222222221,27.77777777777778,Unisex
Carlas,1968,10,5,5,50.0,50.0,Unisex
Lacey,1968,72,55,17,76.38888888888889,23.61111111111111,Unisex
Jody,1968,3210,1912,1298,59.56386292834891,40.43613707165109,Unisex
Char,1969,8,8,0,100.0,0.0,Female
Dafna,1969,5,5,0,100.0,0.0,Female
Francisca,1969,118,118,0,100.0,0.0,Female
Lucina,1969,5,5,0,100.0,0.0,Female
Lynanne,1969,5,5,0,100.0,0.0,Female
Denys,1969,13,13,0,100.0,0.0,Female
Feliciana,1969,7,7,0,100.0,0.0,Female
Wendye,1969,5,5,0,100.0,0.0,Female
Carmelle,1969,5,5,0,100.0,0.0,Female
Janette,1969,479,479,0,100.0,0.0,Female
Mishel,1969,5,5,0,100.0,0.0,Female
Ashlea,1969,10,10,0,100.0,0.0,Female
Brigida,1969,17,17,0,100.0,0.0,Female
Shiela,1969,132,132,0,100.0,0.0,Female
Resha,1969,6,6,0,100.0,0.0,Female
Charie,1969,10,10,0,100.0,0.0,Female
Delania,1969,11,11,0,100.0,0.0,Female
Tamijo,1969,5,5,0,100.0,0.0,Female
Anissia,1969,14,14,0,100.0,0.0,Female
Paquita,1969,7,7,0,100.0,0.0,Female
Jinnie,1969,7,7,0,100.0,0.0,Female
Mry,1969,5,5,0,100.0,0.0,Female
Raquelle,1969,12,12,0,100.0,0.0,Female
Cathlene,1969,13,13,0,100.0,0.0,Female
Kawanda,1969,7,7,0,100.0,0.0,Female
Melanee,1969,26,26,0,100.0,0.0,Female
Torie,1969,13,13,0,100.0,0.0,Female
Bernardine,1969,12,12,0,100.0,0.0,Female
Joannie,1969,26,26,0,100.0,0.0,Female
Silke,1969,8,8,0,100.0,0.0,Female
Cain,1969,9,0,9,0.0,100.0,Male
Declan,1969,9,0,9,0.0,100.0,Male
Ryan,1969,2266,16,2250,0.706090026478376,99.29390997352162,Male
Hardie,1969,6,0,6,0.0,100.0,Male
Tyson,1969,108,0,108,0.0,100.0,Male
Fidencio,1969,27,0,27,0.0,100.0,Male
Fernando,1969,685,5,680,0.7299270072992701,99.27007299270072,Male
Santana,1969,5,0,5,0.0,100.0,Male
Sedgwick,1969,5,0,5,0.0,100.0,Male
Kenderick,1969,7,0,7,0.0,100.0,Male
Calogero,1969,7,0,7,0.0,100.0,Male
Wardell,1969,37,0,37,0.0,100.0,Male
Cornelius,1969,274,0,274,0.0,100.0,Male
Deano,1969,10,0,10,0.0,100.0,Male
Orenthal,1969,23,0,23,0.0,100.0,Male
Martel,1969,10,0,10,0.0,100.0,Male
Ulyesses,1969,5,0,5,0.0,100.0,Male
Adolph,1969,51,0,51,0.0,100.0,Male
Julian,1969,543,19,524,3.4990791896869244,96.50092081031308,Male
Eryck,1969,5,0,5,0.0,100.0,Male
Anibal,1969,59,0,59,0.0,100.0,Male
Harless,1969,8,0,8,0.0,100.0,Male
Tomasz,1969,7,0,7,0.0,100.0,Male
Verlyn,1969,6,0,6,0.0,100.0,Male
Reginald,1969,2446,23,2423,0.9403107113654948,99.0596892886345,Male
Les,1969,57,0,57,0.0,100.0,Male
Ricardo,1969,1589,15,1574,0.9439899307740718,99.05601006922592,Male
Seon,1969,7,0,7,0.0,100.0,Male
Fredrich,1969,11,0,11,0.0,100.0,Male
Renardo,1969,11,0,11,0.0,100.0,Male
Chriss,1969,13,6,7,46.15384615384615,53.84615384615385,Unisex
Alpha,1969,21,11,10,52.38095238095239,47.61904761904761,Unisex
Devon,1969,253,84,169,33.201581027667984,66.79841897233202,Unisex
Daneil,1969,24,6,18,25.0,75.0,Unisex
Vernell,1969,78,41,37,52.56410256410257,47.43589743589743,Unisex
Deyon,1969,10,5,5,50.0,50.0,Unisex
Val,1969,75,13,62,17.333333333333336,82.66666666666667,Unisex
Dusty,1969,184,71,113,38.58695652173913,61.41304347826087,Unisex
Johnell,1969,24,7,17,29.166666666666668,70.83333333333334,Unisex
Bernell,1969,21,5,16,23.809523809523807,76.19047619047619,Unisex
Allyn,1969,47,12,35,25.53191489361702,74.46808510638297,Unisex
Torrey,1969,109,17,92,15.59633027522936,84.40366972477065,Unisex
Krishna,1969,35,26,9,74.28571428571429,25.71428571428571,Unisex
Demian,1969,42,7,35,16.666666666666664,83.33333333333334,Unisex
Delaney,1969,13,5,8,38.46153846153847,61.53846153846154,Unisex
Clair,1969,49,18,31,36.734693877551024,63.26530612244898,Unisex
Rainey,1969,12,7,5,58.333333333333336,41.66666666666667,Unisex
Augusta,1969,40,27,13,67.5,32.5,Unisex
Jamey,1969,225,55,170,24.444444444444443,75.55555555555556,Unisex
Elisha,1969,120,95,25,79.16666666666666,20.833333333333336,Unisex
Dwan,1969,36,17,19,47.22222222222222,52.77777777777778,Unisex
Regan,1969,77,39,38,50.64935064935064,49.35064935064935,Unisex
Lin,1969,21,10,11,47.61904761904761,52.38095238095239,Unisex
Michal,1969,78,32,46,41.02564102564102,58.97435897435898,Unisex
Shawnn,1969,14,7,7,50.0,50.0,Unisex
Jacque,1969,117,82,35,70.08547008547008,29.914529914529915,Unisex
Alexis,1969,338,204,134,60.35502958579882,39.64497041420118,Unisex
La,1969,25,19,6,76.0,24.0,Unisex
Tory,1969,126,30,96,23.809523809523807,76.19047619047619,Unisex
Christen,1969,152,126,26,82.89473684210526,17.105263157894736,Unisex
Sherry,1970,5943,5917,26,99.56251051657412,0.4374894834258792,Female
Joeleen,1970,5,5,0,100.0,0.0,Female
Kyri,1970,12,12,0,100.0,0.0,Female
Kimbly,1970,11,11,0,100.0,0.0,Female
Jeanna,1970,299,299,0,100.0,0.0,Female
Raelynn,1970,24,24,0,100.0,0.0,Female
Tempie,1970,8,8,0,100.0,0.0,Female
Shevonda,1970,5,5,0,100.0,0.0,Female
Tressy,1970,8,8,0,100.0,0.0,Female
Darcel,1970,29,29,0,100.0,0.0,Female
Kenia,1970,15,15,0,100.0,0.0,Female
Lissette,1970,218,218,0,100.0,0.0,Female
Classie,1970,5,5,0,100.0,0.0,Female
Ursula,1970,335,335,0,100.0,0.0,Female
Kalee,1970,5,5,0,100.0,0.0,Female
Diana,1970,4391,4375,16,99.63561831017992,0.3643816898200865,Female
Michaele,1970,41,41,0,100.0,0.0,Female
Lainie,1970,91,91,0,100.0,0.0,Female
Ramonica,1970,6,6,0,100.0,0.0,Female
Ilissa,1970,5,5,0,100.0,0.0,Female
Maritza,1970,320,320,0,100.0,0.0,Female
Hellen,1970,21,21,0,100.0,0.0,Female
Kandi,1970,198,198,0,100.0,0.0,Female
Tandi,1970,17,17,0,100.0,0.0,Female
Ashely,1970,8,8,0,100.0,0.0,Female
Mylissa,1970,11,11,0,100.0,0.0,Female
Deshawna,1970,5,5,0,100.0,0.0,Female
Waleska,1970,13,13,0,100.0,0.0,Female
Nydia,1970,51,51,0,100.0,0.0,Female
Melody,1970,1182,1176,6,99.49238578680205,0.5076142131979695,Female
Dennis,1970,7349,33,7316,0.4490406858075929,99.5509593141924,Male
Massimo,1970,12,0,12,0.0,100.0,Male
Dangelo,1970,12,0,12,0.0,100.0,Male
Willie,1970,3306,167,3139,5.051421657592257,94.94857834240774,Male
Briant,1970,19,0,19,0.0,100.0,Male
Tal,1970,15,0,15,0.0,100.0,Male
Saleem,1970,5,0,5,0.0,100.0,Male
Harvy,1970,6,0,6,0.0,100.0,Male
Paolo,1970,43,0,43,0.0,100.0,Male
Sherod,1970,7,0,7,0.0,100.0,Male
Erskine,1970,25,0,25,0.0,100.0,Male
Steffon,1970,6,0,6,0.0,100.0,Male
Jonas,1970,193,0,193,0.0,100.0,Male
Daemon,1970,9,0,9,0.0,100.0,Male
Ezekial,1970,7,0,7,0.0,100.0,Male
Efren,1970,72,0,72,0.0,100.0,Male
Jamaal,1970,6,0,6,0.0,100.0,Male
Christobal,1970,9,0,9,0.0,100.0,Male
Sabas,1970,11,0,11,0.0,100.0,Male
Dodd,1970,14,0,14,0.0,100.0,Male
Daran,1970,21,0,21,0.0,100.0,Male
Mckenzie,1970,5,0,5,0.0,100.0,Male
Jermy,1970,7,0,7,0.0,100.0,Male
Jin,1970,6,0,6,0.0,100.0,Male
Alvin,1970,1104,17,1087,1.5398550724637683,98.46014492753623,Male
Jerardo,1970,16,0,16,0.0,100.0,Male
Timmy,1970,655,9,646,1.3740458015267176,98.62595419847328,Male
Dow,1970,8,0,8,0.0,100.0,Male
Leander,1970,46,0,46,0.0,100.0,Male
Fernie,1970,6,0,6,0.0,100.0,Male
Kenyatta,1970,147,67,80,45.57823129251701,54.421768707483,Unisex
Terrell,1970,417,63,354,15.107913669064748,84.89208633093526,Unisex
Andree,1970,42,27,15,64.28571428571429,35.714285714285715,Unisex
Marshell,1970,43,31,12,72.09302325581395,27.906976744186046,Unisex
Artie,1970,53,9,44,16.9811320754717,83.01886792452831,Unisex
Sol,1970,39,14,25,35.8974358974359,64.1025641025641,Unisex
Page,1970,93,77,16,82.79569892473118,17.20430107526882,Unisex
Cam,1970,32,8,24,25.0,75.0,Unisex
Day,1970,12,7,5,58.333333333333336,41.66666666666667,Unisex
Kalen,1970,13,5,8,38.46153846153847,61.53846153846154,Unisex
Jonnie,1970,63,36,27,57.14285714285714,42.85714285714285,Unisex
Marcelle,1970,71,55,16,77.46478873239437,22.53521126760564,Unisex
Robbie,1970,897,225,672,25.08361204013378,74.91638795986621,Unisex
Parris,1970,43,9,34,20.930232558139537,79.06976744186046,Unisex
Ariel,1970,121,38,83,31.40495867768595,68.59504132231406,Unisex
Trini,1970,29,18,11,62.06896551724138,37.93103448275862,Unisex
Dell,1970,74,17,57,22.97297297297297,77.02702702702703,Unisex
Lesly,1970,34,25,9,73.52941176470588,26.47058823529412,Unisex
Tobie,1970,56,39,17,69.64285714285714,30.35714285714285,Unisex
Bethel,1970,20,15,5,75.0,25.0,Unisex
Rennie,1970,24,9,15,37.5,62.5,Unisex
Kendall,1970,545,112,433,20.55045871559633,79.44954128440367,Unisex
Jan,1970,661,498,163,75.34039334341907,24.659606656580937,Unisex
Errin,1970,40,27,13,67.5,32.5,Unisex
Cheyenne,1970,54,29,25,53.70370370370371,46.2962962962963,Unisex
Delane,1970,24,13,11,54.16666666666666,45.83333333333333,Unisex
Sheridan,1970,52,23,29,44.230769230769226,55.76923076923077,Unisex
Reagan,1970,52,20,32,38.46153846153847,61.53846153846154,Unisex
Kobi,1970,12,7,5,58.333333333333336,41.66666666666667,Unisex
Hillery,1970,17,12,5,70.58823529411765,29.411764705882355,Unisex
Asma,1971,6,6,0,100.0,0.0,Female
Shauntel,1971,23,23,0,100.0,0.0,Female
Danica,1971,58,58,0,100.0,0.0,Female
Janet,1971,3409,3394,15,99.55998826635376,0.4400117336462305,Female
Trese,1971,5,5,0,100.0,0.0,Female
Patirica,1971,6,6,0,100.0,0.0,Female
Saudah,1971,5,5,0,100.0,0.0,Female
Kathrine,1971,173,173,0,100.0,0.0,Female
Pnina,1971,5,5,0,100.0,0.0,Female
Alberta,1971,118,118,0,100.0,0.0,Female
Tiana,1971,41,41,0,100.0,0.0,Female
Shirl,1971,20,20,0,100.0,0.0,Female
Paulette,1971,680,680,0,100.0,0.0,Female
Alicea,1971,19,19,0,100.0,0.0,Female
Tina,1971,13313,13266,47,99.64696161646512,0.3530383835348907,Female
Kiara,1971,5,5,0,100.0,0.0,Female
Pilar,1971,90,79,11,87.77777777777777,12.22222222222222,Female
Afeni,1971,6,6,0,100.0,0.0,Female
Doriann,1971,13,13,0,100.0,0.0,Female
Janell,1971,280,280,0,100.0,0.0,Female
Parul,1971,5,5,0,100.0,0.0,Female
Tamiko,1971,179,171,8,95.53072625698324,4.46927374301676,Female
Julianna,1971,128,128,0,100.0,0.0,Female
Lena,1971,495,495,0,100.0,0.0,Female
Gwyneth,1971,18,18,0,100.0,0.0,Female
Madelyn,1971,69,69,0,100.0,0.0,Female
Bridget,1971,1718,1712,6,99.65075669383005,0.3492433061699651,Female
Tava,1971,10,10,0,100.0,0.0,Female
Bertha,1971,351,351,0,100.0,0.0,Female
Charnette,1971,10,10,0,100.0,0.0,Female
Deward,1971,9,0,9,0.0,100.0,Male
Cavan,1971,9,0,9,0.0,100.0,Male
Slater,1971,5,0,5,0.0,100.0,Male
Laderrick,1971,5,0,5,0.0,100.0,Male
Evangelos,1971,16,0,16,0.0,100.0,Male
Dietrick,1971,6,0,6,0.0,100.0,Male
Therron,1971,5,0,5,0.0,100.0,Male
Manual,1971,9,0,9,0.0,100.0,Male
Kennith,1971,135,0,135,0.0,100.0,Male
Glen,1971,1544,11,1533,0.7124352331606217,99.28756476683938,Male
Fletcher,1971,69,0,69,0.0,100.0,Male
Giorgio,1971,11,0,11,0.0,100.0,Male
Franklyn,1971,38,0,38,0.0,100.0,Male
Jacinto,1971,33,0,33,0.0,100.0,Male
Jerardo,1971,19,0,19,0.0,100.0,Male
Isidoro,1971,15,0,15,0.0,100.0,Male
Earley,1971,6,0,6,0.0,100.0,Male
Brentt,1971,6,0,6,0.0,100.0,Male
Barney,1971,100,0,100,0.0,100.0,Male
Herbert,1971,962,11,951,1.1434511434511436,98.85654885654886,Male
Varick,1971,11,0,11,0.0,100.0,Male
Antoino,1971,10,0,10,0.0,100.0,Male
Jerzy,1971,5,0,5,0.0,100.0,Male
Antron,1971,16,0,16,0.0,100.0,Male
Tristram,1971,8,0,8,0.0,100.0,Male
Arik,1971,20,0,20,0.0,100.0,Male
Donney,1971,5,0,5,0.0,100.0,Male
Theodore,1971,1676,11,1665,0.6563245823389021,99.34367541766107,Male
Javon,1971,23,0,23,0.0,100.0,Male
Creed,1971,13,0,13,0.0,100.0,Male
Alva,1971,81,45,36,55.55555555555556,44.44444444444444,Unisex
Lavelle,1971,52,12,40,23.07692307692308,76.92307692307693,Unisex
Jona,1971,39,32,7,82.05128205128204,17.94871794871795,Unisex
Tawan,1971,11,6,5,54.54545454545454,45.45454545454545,Unisex
Shan,1971,88,24,64,27.27272727272727,72.72727272727273,Unisex
Rome,1971,23,5,18,21.73913043478261,78.26086956521739,Unisex
Page,1971,77,61,16,79.22077922077922,20.77922077922078,Unisex
Shannen,1971,37,29,8,78.37837837837837,21.62162162162162,Unisex
Tonnie,1971,22,12,10,54.54545454545454,45.45454545454545,Unisex
Marque,1971,14,6,8,42.85714285714285,57.14285714285714,Unisex
Jae,1971,23,14,9,60.86956521739131,39.130434782608695,Unisex
Glennis,1971,20,12,8,60.0,40.0,Unisex
Torey,1971,40,8,32,20.0,80.0,Unisex
Charon,1971,28,23,5,82.14285714285714,17.857142857142858,Unisex
Montrell,1971,24,6,18,25.0,75.0,Unisex
Danel,1971,12,7,5,58.333333333333336,41.66666666666667,Unisex
Andrian,1971,14,8,6,57.14285714285714,42.85714285714285,Unisex
Reagan,1971,58,23,35,39.6551724137931,60.3448275862069,Unisex
Jimi,1971,66,20,46,30.303030303030305,69.6969696969697,Unisex
Carlis,1971,19,5,14,26.31578947368421,73.68421052631578,Unisex
Gabriele,1971,22,12,10,54.54545454545454,45.45454545454545,Unisex
Jaimie,1971,78,54,24,69.23076923076923,30.76923076923077,Unisex
Delane,1971,36,17,19,47.22222222222222,52.77777777777778,Unisex
Nate,1971,36,11,25,30.55555555555556,69.44444444444444,Unisex
Daniele,1971,84,70,14,83.33333333333334,16.666666666666664,Unisex
Maury,1971,34,6,28,17.647058823529413,82.35294117647058,Unisex
Shonte,1971,31,26,5,83.87096774193549,16.129032258064516,Unisex
London,1971,50,13,37,26.0,74.0,Unisex
Donnelle,1971,19,10,9,52.63157894736842,47.368421052631575,Unisex
Jewell,1971,71,57,14,80.28169014084507,19.718309859154928,Unisex
Natlie,1972,7,7,0,100.0,0.0,Female
Diedra,1972,35,35,0,100.0,0.0,Female
Lena,1972,478,478,0,100.0,0.0,Female
Leesha,1972,7,7,0,100.0,0.0,Female
Tarisa,1972,9,9,0,100.0,0.0,Female
Gweneth,1972,5,5,0,100.0,0.0,Female
Priti,1972,9,9,0,100.0,0.0,Female
Conchita,1972,12,12,0,100.0,0.0,Female
Vina,1972,13,13,0,100.0,0.0,Female
Serita,1972,16,16,0,100.0,0.0,Female
Shirley,1972,1348,1335,13,99.03560830860532,0.9643916913946587,Female
Rifka,1972,8,8,0,100.0,0.0,Female
Dionna,1972,51,51,0,100.0,0.0,Female
Chrystal,1972,330,330,0,100.0,0.0,Female
Dollie,1972,38,38,0,100.0,0.0,Female
Lynnelle,1972,7,7,0,100.0,0.0,Female
Jamela,1972,11,11,0,100.0,0.0,Female
Adrianne,1972,184,184,0,100.0,0.0,Female
Quentina,1972,7,7,0,100.0,0.0,Female
Taneesha,1972,5,5,0,100.0,0.0,Female
Terese,1972,75,75,0,100.0,0.0,Female
Sarra,1972,5,5,0,100.0,0.0,Female
Sharry,1972,17,17,0,100.0,0.0,Female
Brea,1972,11,11,0,100.0,0.0,Female
Kristin,1972,4663,4586,77,98.34870255200516,1.6512974479948532,Female
Elizbeth,1972,11,11,0,100.0,0.0,Female
Sondra,1972,339,339,0,100.0,0.0,Female
Teesha,1972,15,15,0,100.0,0.0,Female
Taka,1972,5,5,0,100.0,0.0,Female
Judyann,1972,5,5,0,100.0,0.0,Female
Ames,1972,12,0,12,0.0,100.0,Male
Forbes,1972,5,0,5,0.0,100.0,Male
Demetruis,1972,23,0,23,0.0,100.0,Male
Shadron,1972,6,0,6,0.0,100.0,Male
Bronson,1972,61,0,61,0.0,100.0,Male
Adnan,1972,6,0,6,0.0,100.0,Male
Cleophas,1972,5,0,5,0.0,100.0,Male
Jack,1972,1923,17,1906,0.8840353614144566,99.11596463858554,Male
Sanford,1972,77,0,77,0.0,100.0,Male
Juwan,1972,7,0,7,0.0,100.0,Male
Enoc,1972,9,0,9,0.0,100.0,Male
Erric,1972,12,0,12,0.0,100.0,Male
Teddy,1972,341,8,333,2.346041055718475,97.65395894428153,Male
Jeremi,1972,18,0,18,0.0,100.0,Male
Lysander,1972,13,0,13,0.0,100.0,Male
Levy,1972,17,0,17,0.0,100.0,Male
Refugio,1972,33,0,33,0.0,100.0,Male
Lerone,1972,27,0,27,0.0,100.0,Male
Raymond,1972,5488,41,5447,0.7470845481049563,99.25291545189503,Male
Denard,1972,13,0,13,0.0,100.0,Male
Cord,1972,14,0,14,0.0,100.0,Male
Kane,1972,30,0,30,0.0,100.0,Male
Warrick,1972,9,0,9,0.0,100.0,Male
Alias,1972,6,0,6,0.0,100.0,Male
Fanon,1972,5,0,5,0.0,100.0,Male
Orville,1972,74,0,74,0.0,100.0,Male
Dax,1972,99,0,99,0.0,100.0,Male
Antuan,1972,19,0,19,0.0,100.0,Male
Joachim,1972,11,0,11,0.0,100.0,Male
Chritopher,1972,12,0,12,0.0,100.0,Male
Carmon,1972,52,42,10,80.76923076923077,19.23076923076924,Unisex
Merrill,1972,58,17,41,29.310344827586203,70.6896551724138,Unisex
Angel,1972,2901,1946,955,67.08031713202344,32.919682867976555,Unisex
Shanti,1972,55,45,10,81.81818181818183,18.181818181818183,Unisex
Demetric,1972,53,19,34,35.84905660377358,64.15094339622641,Unisex
Dennie,1972,53,14,39,26.41509433962264,73.58490566037736,Unisex
Lesly,1972,20,11,9,55.00000000000001,45.0,Unisex
Lou,1972,126,101,25,80.15873015873017,19.84126984126984,Unisex
Channon,1972,32,22,10,68.75,31.25,Unisex
Daniell,1972,31,25,6,80.64516129032258,19.35483870967742,Unisex
Mitchelle,1972,19,12,7,63.1578947368421,36.84210526315789,Unisex
Danel,1972,15,10,5,66.66666666666666,33.33333333333333,Unisex
Rami,1972,16,7,9,43.75,56.25,Unisex
Merritt,1972,46,21,25,45.65217391304348,54.34782608695652,Unisex
Aries,1972,11,6,5,54.54545454545454,45.45454545454545,Unisex
Jacque,1972,93,63,30,67.74193548387096,32.25806451612903,Unisex
Loran,1972,31,8,23,25.806451612903224,74.19354838709677,Unisex
Donel,1972,11,6,5,54.54545454545454,45.45454545454545,Unisex
Jacy,1972,31,25,6,80.64516129032258,19.35483870967742,Unisex
Lashaun,1972,81,65,16,80.24691358024691,19.753086419753085,Unisex
Shamar,1972,13,6,7,46.15384615384615,53.84615384615385,Unisex
Kasey,1972,299,232,67,77.59197324414716,22.40802675585284,Unisex
Jamie,1972,6490,2810,3680,43.29738058551618,56.70261941448382,Unisex
Demetri,1972,36,16,20,44.44444444444444,55.55555555555556,Unisex
Deane,1972,40,16,24,40.0,60.0,Unisex
Davi,1972,13,8,5,61.53846153846154,38.46153846153847,Unisex
Regan,1972,101,72,29,71.28712871287128,28.71287128712871,Unisex
Pat,1972,121,27,94,22.31404958677686,77.68595041322314,Unisex
Lindsey,1972,137,75,62,54.74452554744526,45.25547445255474,Unisex
Shayne,1972,269,71,198,26.394052044609666,73.60594795539033,Unisex
Natascha,1973,35,35,0,100.0,0.0,Female
Cecile,1973,35,35,0,100.0,0.0,Female
Monee,1973,12,12,0,100.0,0.0,Female
Blossom,1973,13,13,0,100.0,0.0,Female
Lina,1973,96,96,0,100.0,0.0,Female
Karleen,1973,30,30,0,100.0,0.0,Female
Beatrice,1973,327,327,0,100.0,0.0,Female
Antionette,1973,154,154,0,100.0,0.0,Female
Renda,1973,17,17,0,100.0,0.0,Female
Nadege,1973,7,7,0,100.0,0.0,Female
Mildred,1973,311,311,0,100.0,0.0,Female
Jolee,1973,23,23,0,100.0,0.0,Female
Maylene,1973,7,7,0,100.0,0.0,Female
Mitsy,1973,11,11,0,100.0,0.0,Female
Pari,1973,5,5,0,100.0,0.0,Female
Chiffon,1973,20,20,0,100.0,0.0,Female
Doretta,1973,12,12,0,100.0,0.0,Female
Jannette,1973,80,80,0,100.0,0.0,Female
Loletta,1973,5,5,0,100.0,0.0,Female
Rolinda,1973,10,10,0,100.0,0.0,Female
Larae,1973,36,36,0,100.0,0.0,Female
Aime,1973,23,23,0,100.0,0.0,Female
Lenice,1973,9,9,0,100.0,0.0,Female
Joyann,1973,7,7,0,100.0,0.0,Female
Rosanne,1973,119,119,0,100.0,0.0,Female
Tanyeka,1973,7,7,0,100.0,0.0,Female
Alesandra,1973,6,6,0,100.0,0.0,Female
Malika,1973,58,58,0,100.0,0.0,Female
Nekita,1973,14,14,0,100.0,0.0,Female
Latayna,1973,15,15,0,100.0,0.0,Female
Osborne,1973,5,0,5,0.0,100.0,Male
Lenard,1973,76,0,76,0.0,100.0,Male
Rosalio,1973,16,0,16,0.0,100.0,Male
Toriano,1973,80,0,80,0.0,100.0,Male
Burnie,1973,9,0,9,0.0,100.0,Male
Timon,1973,5,0,5,0.0,100.0,Male
Romone,1973,5,0,5,0.0,100.0,Male
Delante,1973,9,0,9,0.0,100.0,Male
Teague,1973,18,0,18,0.0,100.0,Male
Garin,1973,15,0,15,0.0,100.0,Male
Atlee,1973,10,0,10,0.0,100.0,Male
Clarenc,1973,5,0,5,0.0,100.0,Male
Ryker,1973,5,0,5,0.0,100.0,Male
Dj,1973,7,0,7,0.0,100.0,Male
Tommy,1973,1773,41,1732,2.3124647490129724,97.68753525098704,Male
Shaundell,1973,6,0,6,0.0,100.0,Male
Elden,1973,27,0,27,0.0,100.0,Male
Huey,1973,31,0,31,0.0,100.0,Male
Taraus,1973,6,0,6,0.0,100.0,Male
Coby,1973,108,14,94,12.962962962962962,87.03703703703704,Male
Dartagnan,1973,7,0,7,0.0,100.0,Male
Json,1973,8,0,8,0.0,100.0,Male
Doran,1973,31,0,31,0.0,100.0,Male
Regginal,1973,5,0,5,0.0,100.0,Male
Shohn,1973,6,0,6,0.0,100.0,Male
Cranston,1973,7,0,7,0.0,100.0,Male
Hanif,1973,5,0,5,0.0,100.0,Male
Melville,1973,12,0,12,0.0,100.0,Male
Idris,1973,29,0,29,0.0,100.0,Male
Kwadwo,1973,5,0,5,0.0,100.0,Male
Sky,1973,38,13,25,34.21052631578947,65.78947368421053,Unisex
Lindsey,1973,171,101,70,59.06432748538012,40.93567251461988,Unisex
Ardis,1973,28,18,10,64.28571428571429,35.714285714285715,Unisex
Jayme,1973,204,121,83,59.31372549019608,40.68627450980392,Unisex
Ladon,1973,32,9,23,28.125,71.875,Unisex
Jody,1973,2930,1687,1243,57.57679180887372,42.423208191126285,Unisex
August,1973,113,22,91,19.469026548672566,80.53097345132744,Unisex
Allie,1973,28,20,8,71.42857142857143,28.57142857142857,Unisex
Lin,1973,13,6,7,46.15384615384615,53.84615384615385,Unisex
Robi,1973,15,9,6,60.0,40.0,Unisex
Marlo,1973,329,251,78,76.29179331306992,23.70820668693009,Unisex
Laine,1973,23,18,5,78.26086956521739,21.73913043478261,Unisex
Demetri,1973,28,11,17,39.285714285714285,60.71428571428571,Unisex
Loy,1973,22,6,16,27.27272727272727,72.72727272727273,Unisex
Michaell,1973,14,5,9,35.714285714285715,64.28571428571429,Unisex
Arnell,1973,18,7,11,38.88888888888889,61.11111111111112,Unisex
Lashan,1973,43,34,9,79.06976744186046,20.930232558139537,Unisex
Ashley,1973,1676,1250,426,74.58233890214797,25.41766109785203,Unisex
Shermaine,1973,28,20,8,71.42857142857143,28.57142857142857,Unisex
Shylo,1973,13,8,5,61.53846153846154,38.46153846153847,Unisex
Lashaun,1973,53,43,10,81.13207547169812,18.867924528301888,Unisex
Shuron,1973,14,8,6,57.14285714285714,42.85714285714285,Unisex
Natividad,1973,25,9,16,36.0,64.0,Unisex
Clair,1973,39,16,23,41.02564102564102,58.97435897435898,Unisex
Sacha,1973,71,59,12,83.09859154929578,16.901408450704224,Unisex
Freedom,1973,26,17,9,65.38461538461539,34.61538461538461,Unisex
Bryn,1973,56,35,21,62.5,37.5,Unisex
Andree,1973,31,22,9,70.96774193548387,29.03225806451613,Unisex
Jae,1973,18,6,12,33.33333333333333,66.66666666666666,Unisex
Angel,1973,2863,1815,1048,63.39504016765631,36.604959832343695,Unisex
Kristina,1974,2898,2889,9,99.68944099378882,0.3105590062111801,Female
Vivan,1974,5,5,0,100.0,0.0,Female
Glynnis,1974,13,13,0,100.0,0.0,Female
Dorianne,1974,11,11,0,100.0,0.0,Female
Lana,1974,457,457,0,100.0,0.0,Female
Marny,1974,16,16,0,100.0,0.0,Female
Hermelinda,1974,21,21,0,100.0,0.0,Female
Laketha,1974,22,22,0,100.0,0.0,Female
Jemima,1974,15,15,0,100.0,0.0,Female
Nakeeta,1974,7,7,0,100.0,0.0,Female
Anida,1974,6,6,0,100.0,0.0,Female
Korri,1974,14,14,0,100.0,0.0,Female
Kathrina,1974,16,16,0,100.0,0.0,Female
Chenoa,1974,34,34,0,100.0,0.0,Female
Felicitas,1974,14,14,0,100.0,0.0,Female
Candida,1974,139,139,0,100.0,0.0,Female
Satonya,1974,10,10,0,100.0,0.0,Female
Tykisha,1974,9,9,0,100.0,0.0,Female
Dania,1974,47,47,0,100.0,0.0,Female
Rushell,1974,6,6,0,100.0,0.0,Female
Janal,1974,6,6,0,100.0,0.0,Female
Delicia,1974,81,81,0,100.0,0.0,Female
Danni,1974,14,14,0,100.0,0.0,Female
Evonne,1974,66,66,0,100.0,0.0,Female
Reanna,1974,7,7,0,100.0,0.0,Female
Sherae,1974,11,11,0,100.0,0.0,Female
Marymargaret,1974,9,9,0,100.0,0.0,Female
Nicolette,1974,89,89,0,100.0,0.0,Female
Babette,1974,27,27,0,100.0,0.0,Female
Conception,1974,5,5,0,100.0,0.0,Female
Ansel,1974,8,0,8,0.0,100.0,Male
Hani,1974,8,0,8,0.0,100.0,Male
Carrick,1974,5,0,5,0.0,100.0,Male
Rohn,1974,8,0,8,0.0,100.0,Male
Eliseo,1974,66,0,66,0.0,100.0,Male
Cyril,1974,42,5,37,11.904761904761903,88.09523809523809,Male
Kermit,1974,71,0,71,0.0,100.0,Male
Leman,1974,8,0,8,0.0,100.0,Male
Mervin,1974,61,0,61,0.0,100.0,Male
Jordon,1974,18,0,18,0.0,100.0,Male
Zeferino,1974,9,0,9,0.0,100.0,Male
Vonzell,1974,8,0,8,0.0,100.0,Male
Sammuel,1974,11,0,11,0.0,100.0,Male
Kip,1974,144,0,144,0.0,100.0,Male
Steven,1974,17756,89,17667,0.5012390177968011,99.4987609822032,Male
Terran,1974,13,0,13,0.0,100.0,Male
Ruven,1974,5,0,5,0.0,100.0,Male
Coy,1974,113,10,103,8.849557522123893,91.1504424778761,Male
Dywane,1974,6,0,6,0.0,100.0,Male
Antony,1974,117,0,117,0.0,100.0,Male
Zack,1974,42,0,42,0.0,100.0,Male
Dementrius,1974,5,0,5,0.0,100.0,Male
Quinten,1974,27,0,27,0.0,100.0,Male
Kester,1974,7,0,7,0.0,100.0,Male
Altonio,1974,10,0,10,0.0,100.0,Male
Zaki,1974,7,0,7,0.0,100.0,Male
Benjamen,1974,60,0,60,0.0,100.0,Male
Horace,1974,174,0,174,0.0,100.0,Male
Kimothy,1974,5,0,5,0.0,100.0,Male
Sammy,1974,403,9,394,2.2332506203473943,97.7667493796526,Male
Sascha,1974,29,21,8,72.41379310344827,27.58620689655172,Unisex
Merritt,1974,38,19,19,50.0,50.0,Unisex
Taiwan,1974,35,10,25,28.57142857142857,71.42857142857143,Unisex
Montrell,1974,35,6,29,17.142857142857142,82.85714285714286,Unisex
Lavon,1974,54,17,37,31.48148148148148,68.51851851851852,Unisex
Corie,1974,135,105,30,77.77777777777779,22.22222222222222,Unisex
Demetrus,1974,28,7,21,25.0,75.0,Unisex
Lashawn,1974,481,386,95,80.24948024948026,19.75051975051975,Unisex
Elan,1974,26,9,17,34.61538461538461,65.38461538461539,Unisex
Farley,1974,11,5,6,45.45454545454545,54.54545454545454,Unisex
Landy,1974,11,6,5,54.54545454545454,45.45454545454545,Unisex
Adrien,1974,43,13,30,30.23255813953488,69.76744186046511,Unisex
Marion,1974,499,233,266,46.6933867735471,53.3066132264529,Unisex
Corrie,1974,241,193,48,80.08298755186722,19.91701244813278,Unisex
Lajuan,1974,43,14,29,32.55813953488372,67.44186046511628,Unisex
Darby,1974,144,71,73,49.30555555555556,50.69444444444444,Unisex
Aundra,1974,31,15,16,48.38709677419355,51.61290322580645,Unisex
Demetrice,1974,114,74,40,64.91228070175438,35.08771929824561,Unisex
Tobie,1974,90,71,19,78.88888888888889,21.11111111111111,Unisex
Cris,1974,56,15,41,26.785714285714285,73.21428571428571,Unisex
Demetris,1974,79,39,40,49.36708860759494,50.63291139240506,Unisex
Marcelle,1974,57,40,17,70.17543859649122,29.82456140350877,Unisex
Frenchie,1974,15,7,8,46.66666666666666,53.333333333333336,Unisex
Lyndell,1974,37,10,27,27.027027027027028,72.97297297297297,Unisex
Vashawn,1974,14,5,9,35.714285714285715,64.28571428571429,Unisex
Schuyler,1974,24,5,19,20.833333333333336,79.16666666666666,Unisex
Loren,1974,453,96,357,21.19205298013245,78.80794701986756,Unisex
Kito,1974,19,5,14,26.31578947368421,73.68421052631578,Unisex
Amory,1974,14,8,6,57.14285714285714,42.85714285714285,Unisex
Reagan,1974,105,70,35,66.66666666666666,33.33333333333333,Unisex
Yasmeen,1975,21,21,0,100.0,0.0,Female
Cadence,1975,6,6,0,100.0,0.0,Female
Cortni,1975,11,11,0,100.0,0.0,Female
Lasundra,1975,7,7,0,100.0,0.0,Female
Meisha,1975,20,20,0,100.0,0.0,Female
Krisandra,1975,9,9,0,100.0,0.0,Female
Shimika,1975,10,10,0,100.0,0.0,Female
Rakesha,1975,5,5,0,100.0,0.0,Female
Jull,1975,9,9,0,100.0,0.0,Female
Rosemarie,1975,220,220,0,100.0,0.0,Female
Awilda,1975,38,38,0,100.0,0.0,Female
Jacelyn,1975,12,12,0,100.0,0.0,Female
Jabina,1975,7,7,0,100.0,0.0,Female
Mariel,1975,16,16,0,100.0,0.0,Female
Yavonne,1975,6,6,0,100.0,0.0,Female
Genna,1975,31,31,0,100.0,0.0,Female
Teresea,1975,6,6,0,100.0,0.0,Female
Salina,1975,90,90,0,100.0,0.0,Female
Lysette,1975,8,8,0,100.0,0.0,Female
Lyn,1975,84,72,12,85.71428571428571,14.285714285714285,Female
Adenike,1975,10,10,0,100.0,0.0,Female
Latessa,1975,13,13,0,100.0,0.0,Female
Maretta,1975,17,17,0,100.0,0.0,Female
Kamilla,1975,13,13,0,100.0,0.0,Female
Kassandra,1975,61,61,0,100.0,0.0,Female
Rafaela,1975,22,22,0,100.0,0.0,Female
Natash,1975,9,9,0,100.0,0.0,Female
Elona,1975,10,10,0,100.0,0.0,Female
Roshonda,1975,46,46,0,100.0,0.0,Female
Erum,1975,5,5,0,100.0,0.0,Female
Khalid,1975,65,0,65,0.0,100.0,Male
Tyrin,1975,6,0,6,0.0,100.0,Male
Ashton,1975,31,0,31,0.0,100.0,Male
Rowland,1975,22,0,22,0.0,100.0,Male
Jacobi,1975,5,0,5,0.0,100.0,Male
Kye,1975,10,0,10,0.0,100.0,Male
Shamir,1975,5,0,5,0.0,100.0,Male
Torris,1975,13,0,13,0.0,100.0,Male
Otha,1975,27,0,27,0.0,100.0,Male
Mozell,1975,7,0,7,0.0,100.0,Male
Halim,1975,5,0,5,0.0,100.0,Male
Eloy,1975,109,0,109,0.0,100.0,Male
Nicolo,1975,8,0,8,0.0,100.0,Male
Oneil,1975,9,0,9,0.0,100.0,Male
Coleman,1975,57,0,57,0.0,100.0,Male
Wally,1975,41,0,41,0.0,100.0,Male
Rondale,1975,15,0,15,0.0,100.0,Male
Ron,1975,327,7,320,2.140672782874617,97.85932721712538,Male
Gardner,1975,15,0,15,0.0,100.0,Male
Mohammed,1975,40,0,40,0.0,100.0,Male
Nathaniel,1975,1987,30,1957,1.509813789632612,98.4901862103674,Male
Emmanual,1975,7,0,7,0.0,100.0,Male
Frantz,1975,17,0,17,0.0,100.0,Male
Varick,1975,7,0,7,0.0,100.0,Male
Sherod,1975,14,0,14,0.0,100.0,Male
Grady,1975,208,0,208,0.0,100.0,Male
Gerasimos,1975,13,0,13,0.0,100.0,Male
Ryun,1975,8,0,8,0.0,100.0,Male
Dionicio,1975,26,0,26,0.0,100.0,Male
Shelton,1975,174,6,168,3.4482758620689653,96.55172413793105,Male
Rasheen,1975,61,12,49,19.672131147540984,80.32786885245902,Unisex
Peyton,1975,65,19,46,29.23076923076924,70.76923076923077,Unisex
Kenyada,1975,30,20,10,66.66666666666666,33.33333333333333,Unisex
Maxie,1975,29,7,22,24.13793103448276,75.86206896551724,Unisex
Kimble,1975,15,9,6,60.0,40.0,Unisex
Shandell,1975,25,20,5,80.0,20.0,Unisex
Deondra,1975,22,13,9,59.09090909090909,40.909090909090914,Unisex
Shey,1975,11,6,5,54.54545454545454,45.45454545454545,Unisex
Chancey,1975,32,10,22,31.25,68.75,Unisex
Christan,1975,28,15,13,53.57142857142857,46.42857142857143,Unisex
Ashanti,1975,49,29,20,59.18367346938776,40.81632653061224,Unisex
Lan,1975,18,13,5,72.22222222222221,27.77777777777778,Unisex
Loran,1975,22,10,12,45.45454545454545,54.54545454545454,Unisex
Nakai,1975,16,7,9,43.75,56.25,Unisex
Trinity,1975,278,165,113,59.35251798561151,40.647482014388494,Unisex
Page,1975,57,39,18,68.42105263157895,31.57894736842105,Unisex
Demetrice,1975,137,82,55,59.85401459854016,40.14598540145985,Unisex
Donyell,1975,43,21,22,48.837209302325576,51.16279069767442,Unisex
Cedar,1975,15,9,6,60.0,40.0,Unisex
Ricki,1975,79,56,23,70.88607594936708,29.11392405063291,Unisex
Dorsey,1975,27,6,21,22.22222222222222,77.77777777777779,Unisex
Sheron,1975,52,31,21,59.61538461538461,40.38461538461539,Unisex
Skeeter,1975,14,7,7,50.0,50.0,Unisex
Barrie,1975,24,12,12,50.0,50.0,Unisex
Demetris,1975,106,45,61,42.45283018867924,57.54716981132076,Unisex
Kiley,1975,91,31,60,34.065934065934066,65.93406593406593,Unisex
Jayme,1975,319,211,108,66.14420062695925,33.85579937304075,Unisex
Natale,1975,13,7,6,53.84615384615385,46.15384615384615,Unisex
Roshawn,1975,41,18,23,43.90243902439025,56.09756097560976,Unisex
Shan,1975,75,24,51,32.0,68.0,Unisex
Roshawna,1976,6,6,0,100.0,0.0,Female
Carilyn,1976,9,9,0,100.0,0.0,Female
Lakysha,1976,9,9,0,100.0,0.0,Female
Sherrese,1976,5,5,0,100.0,0.0,Female
Charice,1976,34,34,0,100.0,0.0,Female
Emy,1976,10,10,0,100.0,0.0,Female
Sharece,1976,6,6,0,100.0,0.0,Female
Shakeeta,1976,6,6,0,100.0,0.0,Female
Sossity,1976,7,7,0,100.0,0.0,Female
Dorice,1976,7,7,0,100.0,0.0,Female
Jolyne,1976,5,5,0,100.0,0.0,Female
Meshell,1976,14,14,0,100.0,0.0,Female
Sindia,1976,9,9,0,100.0,0.0,Female
Lilliana,1976,30,30,0,100.0,0.0,Female
Evangela,1976,12,12,0,100.0,0.0,Female
Charo,1976,50,44,6,88.0,12.0,Female
Xylina,1976,6,6,0,100.0,0.0,Female
Taronda,1976,8,8,0,100.0,0.0,Female
Janine,1976,496,496,0,100.0,0.0,Female
Valrie,1976,9,9,0,100.0,0.0,Female
Lourdes,1976,222,216,6,97.2972972972973,2.702702702702702,Female
Rossana,1976,11,11,0,100.0,0.0,Female
Tanara,1976,10,10,0,100.0,0.0,Female
Kendra,1976,1638,1630,8,99.51159951159951,0.4884004884004884,Female
Jerilynn,1976,12,12,0,100.0,0.0,Female
Velvet,1976,41,41,0,100.0,0.0,Female
Cherine,1976,5,5,0,100.0,0.0,Female
Jeany,1976,8,8,0,100.0,0.0,Female
Rabecka,1976,5,5,0,100.0,0.0,Female
Dorinda,1976,61,61,0,100.0,0.0,Female
Daren,1976,182,0,182,0.0,100.0,Male
Alexandro,1976,57,0,57,0.0,100.0,Male
Pierre,1976,142,0,142,0.0,100.0,Male
Machel,1976,5,0,5,0.0,100.0,Male
Nimrod,1976,6,0,6,0.0,100.0,Male
Armando,1976,972,11,961,1.131687242798354,98.86831275720164,Male
Shaw,1976,18,0,18,0.0,100.0,Male
Jefferey,1976,72,0,72,0.0,100.0,Male
Brentt,1976,8,0,8,0.0,100.0,Male
Keion,1976,14,0,14,0.0,100.0,Male
Dorien,1976,5,0,5,0.0,100.0,Male
Jermone,1976,6,0,6,0.0,100.0,Male
Sang,1976,9,0,9,0.0,100.0,Male
Desiderio,1976,6,0,6,0.0,100.0,Male
Ramy,1976,11,0,11,0.0,100.0,Male
Manu,1976,10,0,10,0.0,100.0,Male
Franz,1976,34,0,34,0.0,100.0,Male
Ronrico,1976,12,0,12,0.0,100.0,Male
Vasili,1976,5,0,5,0.0,100.0,Male
Cato,1976,5,0,5,0.0,100.0,Male
Brigham,1976,18,0,18,0.0,100.0,Male
Nat,1976,7,0,7,0.0,100.0,Male
Delon,1976,28,0,28,0.0,100.0,Male
Victorio,1976,8,0,8,0.0,100.0,Male
Dayne,1976,23,0,23,0.0,100.0,Male
Rigoberto,1976,151,0,151,0.0,100.0,Male
Jessup,1976,7,0,7,0.0,100.0,Male
Teddrick,1976,9,0,9,0.0,100.0,Male
Tau,1976,7,0,7,0.0,100.0,Male
Reinaldo,1976,60,0,60,0.0,100.0,Male
Charron,1976,20,12,8,60.0,40.0,Unisex
Tobie,1976,69,46,23,66.66666666666666,33.33333333333333,Unisex
Lashay,1976,32,27,5,84.375,15.625,Unisex
Ladon,1976,32,6,26,18.75,81.25,Unisex
Rene,1976,962,275,687,28.586278586278585,71.4137214137214,Unisex
Joby,1976,45,9,36,20.0,80.0,Unisex
Jade,1976,257,141,116,54.86381322957199,45.13618677042802,Unisex
Shamon,1976,19,6,13,31.57894736842105,68.42105263157895,Unisex
Kristan,1976,88,73,15,82.95454545454545,17.045454545454543,Unisex
Torian,1976,24,5,19,20.833333333333336,79.16666666666666,Unisex
Carroll,1976,107,22,85,20.5607476635514,79.43925233644859,Unisex
Jule,1976,16,9,7,56.25,43.75,Unisex
Keir,1976,31,6,25,19.35483870967742,80.64516129032258,Unisex
Ramey,1976,43,7,36,16.27906976744186,83.72093023255815,Unisex
Doni,1976,13,8,5,61.53846153846154,38.46153846153847,Unisex
Kriston,1976,32,13,19,40.625,59.375,Unisex
Danell,1976,50,39,11,78.0,22.0,Unisex
Sammie,1976,123,40,83,32.52032520325203,67.47967479674797,Unisex
La,1976,28,21,7,75.0,25.0,Unisex
Robbi,1976,34,27,7,79.41176470588235,20.588235294117645,Unisex
Alva,1976,53,29,24,54.71698113207547,45.28301886792453,Unisex
Mica,1976,84,64,20,76.19047619047619,23.809523809523807,Unisex
Ricci,1976,30,14,16,46.66666666666666,53.333333333333336,Unisex
Jovon,1976,56,13,43,23.214285714285715,76.78571428571429,Unisex
Micha,1976,31,14,17,45.16129032258064,54.83870967741935,Unisex
Val,1976,21,5,16,23.809523809523807,76.19047619047619,Unisex
Nikola,1976,25,11,14,44.0,56.00000000000001,Unisex
Berry,1976,58,11,47,18.96551724137931,81.03448275862068,Unisex
Roshell,1976,19,14,5,73.68421052631578,26.31578947368421,Unisex
Deandra,1976,57,39,18,68.42105263157895,31.57894736842105,Unisex
Reshonda,1977,19,19,0,100.0,0.0,Female
Dosha,1977,7,7,0,100.0,0.0,Female
Darcell,1977,7,7,0,100.0,0.0,Female
Tyaisha,1977,9,9,0,100.0,0.0,Female
Gilda,1977,32,32,0,100.0,0.0,Female
Danamarie,1977,7,7,0,100.0,0.0,Female
Elizabethann,1977,5,5,0,100.0,0.0,Female
Twanda,1977,59,59,0,100.0,0.0,Female
Shaquana,1977,40,40,0,100.0,0.0,Female
Gemini,1977,7,7,0,100.0,0.0,Female
Tashea,1977,7,7,0,100.0,0.0,Female
Terrie,1977,168,158,10,94.04761904761904,5.952380952380952,Female
Roshana,1977,8,8,0,100.0,0.0,Female
Lacey,1977,314,304,10,96.81528662420382,3.1847133757961785,Female
Chauntel,1977,12,12,0,100.0,0.0,Female
Tonilynn,1977,6,6,0,100.0,0.0,Female
Nyota,1977,9,9,0,100.0,0.0,Female
Tifney,1977,7,7,0,100.0,0.0,Female
Jennier,1977,12,12,0,100.0,0.0,Female
Miri,1977,7,7,0,100.0,0.0,Female
Lyndsey,1977,104,104,0,100.0,0.0,Female
Lanay,1977,7,7,0,100.0,0.0,Female
Tashina,1977,15,15,0,100.0,0.0,Female
Omaira,1977,12,12,0,100.0,0.0,Female
Tansy,1977,13,13,0,100.0,0.0,Female
Angelicia,1977,14,14,0,100.0,0.0,Female
Shela,1977,18,18,0,100.0,0.0,Female
Chrystel,1977,5,5,0,100.0,0.0,Female
Rori,1977,23,23,0,100.0,0.0,Female
Royale,1977,6,6,0,100.0,0.0,Female
Marsh,1977,5,0,5,0.0,100.0,Male
Steffen,1977,13,0,13,0.0,100.0,Male
Denim,1977,5,0,5,0.0,100.0,Male
Keller,1977,5,0,5,0.0,100.0,Male
Braxton,1977,25,0,25,0.0,100.0,Male
Zavier,1977,6,0,6,0.0,100.0,Male
Dimitris,1977,13,0,13,0.0,100.0,Male
Eon,1977,6,0,6,0.0,100.0,Male
Bentley,1977,16,0,16,0.0,100.0,Male
Deke,1977,8,0,8,0.0,100.0,Male
Saquan,1977,7,0,7,0.0,100.0,Male
Silas,1977,93,0,93,0.0,100.0,Male
Jordan,1977,760,111,649,14.605263157894738,85.39473684210527,Male
Tallis,1977,6,0,6,0.0,100.0,Male
Rhyan,1977,5,0,5,0.0,100.0,Male
Azel,1977,7,0,7,0.0,100.0,Male
Cedrick,1977,150,0,150,0.0,100.0,Male
Tico,1977,13,0,13,0.0,100.0,Male
Keefe,1977,13,0,13,0.0,100.0,Male
Marquese,1977,5,0,5,0.0,100.0,Male
Sherman,1977,302,0,302,0.0,100.0,Male
Johnathen,1977,8,0,8,0.0,100.0,Male
Jaeson,1977,11,0,11,0.0,100.0,Male
Zeth,1977,5,0,5,0.0,100.0,Male
Ontrell,1977,5,0,5,0.0,100.0,Male
Nils,1977,23,0,23,0.0,100.0,Male
Zachry,1977,14,0,14,0.0,100.0,Male
Saint,1977,5,0,5,0.0,100.0,Male
Nathanel,1977,8,0,8,0.0,100.0,Male
Marland,1977,23,0,23,0.0,100.0,Male
Jame,1977,49,20,29,40.81632653061224,59.18367346938776,Unisex
Mikal,1977,67,15,52,22.388059701492537,77.61194029850746,Unisex
Shilo,1977,85,65,20,76.47058823529412,23.52941176470588,Unisex
Danyale,1977,30,24,6,80.0,20.0,Unisex
Monti,1977,13,5,8,38.46153846153847,61.53846153846154,Unisex
Raye,1977,15,10,5,66.66666666666666,33.33333333333333,Unisex
Ronelle,1977,17,10,7,58.82352941176471,41.17647058823529,Unisex
Montoya,1977,30,22,8,73.33333333333333,26.666666666666668,Unisex
Shermaine,1977,30,15,15,50.0,50.0,Unisex
Marvel,1977,12,5,7,41.66666666666667,58.333333333333336,Unisex
Coty,1977,42,13,29,30.95238095238096,69.04761904761905,Unisex
Destry,1977,29,5,24,17.24137931034483,82.75862068965517,Unisex
Kendall,1977,331,81,250,24.47129909365559,75.52870090634441,Unisex
Ardell,1977,25,5,20,20.0,80.0,Unisex
Aaryn,1977,16,10,6,62.5,37.5,Unisex
Jacy,1977,69,45,24,65.21739130434783,34.78260869565217,Unisex
Thanh,1977,19,5,14,26.31578947368421,73.68421052631578,Unisex
Lashaun,1977,63,34,29,53.96825396825397,46.03174603174603,Unisex
Farrell,1977,45,12,33,26.666666666666668,73.33333333333333,Unisex
Dominique,1977,415,293,122,70.60240963855422,29.397590361445783,Unisex
Carroll,1977,109,21,88,19.26605504587156,80.73394495412845,Unisex
Bethel,1977,18,12,6,66.66666666666666,33.33333333333333,Unisex
Kenyatte,1977,20,5,15,25.0,75.0,Unisex
Christen,1977,218,184,34,84.40366972477065,15.59633027522936,Unisex
Nico,1977,26,7,19,26.923076923076923,73.07692307692307,Unisex
Shalin,1977,22,14,8,63.63636363636363,36.36363636363637,Unisex
Trenell,1977,19,12,7,63.1578947368421,36.84210526315789,Unisex
Jaimy,1977,20,15,5,75.0,25.0,Unisex
Donyelle,1977,21,16,5,76.19047619047619,23.809523809523807,Unisex
Stephane,1977,32,23,9,71.875,28.125,Unisex
Dwana,1978,27,27,0,100.0,0.0,Female
Alaine,1978,13,13,0,100.0,0.0,Female
Alinda,1978,12,12,0,100.0,0.0,Female
Mandi,1978,632,632,0,100.0,0.0,Female
Nadiya,1978,8,8,0,100.0,0.0,Female
Keleigh,1978,10,10,0,100.0,0.0,Female
Maurisa,1978,10,10,0,100.0,0.0,Female
Lavetta,1978,14,14,0,100.0,0.0,Female
Satara,1978,13,13,0,100.0,0.0,Female
Kariann,1978,24,24,0,100.0,0.0,Female
Dalal,1978,10,10,0,100.0,0.0,Female
Keni,1978,10,10,0,100.0,0.0,Female
Mailyn,1978,5,5,0,100.0,0.0,Female
Tonnetta,1978,6,6,0,100.0,0.0,Female
Kareema,1978,20,20,0,100.0,0.0,Female
Trellis,1978,7,7,0,100.0,0.0,Female
Judy,1978,553,553,0,100.0,0.0,Female
Clairissa,1978,8,8,0,100.0,0.0,Female
Chaunda,1978,7,7,0,100.0,0.0,Female
Veleka,1978,32,32,0,100.0,0.0,Female
Brendy,1978,8,8,0,100.0,0.0,Female
Yanique,1978,6,6,0,100.0,0.0,Female
Chiquita,1978,197,197,0,100.0,0.0,Female
Kennetha,1978,20,20,0,100.0,0.0,Female
Jaimelyn,1978,12,12,0,100.0,0.0,Female
Tessy,1978,7,7,0,100.0,0.0,Female
Mikala,1978,20,20,0,100.0,0.0,Female
Chalisa,1978,6,6,0,100.0,0.0,Female
Arnetia,1978,26,26,0,100.0,0.0,Female
Tenielle,1978,5,5,0,100.0,0.0,Female
Jacobi,1978,15,0,15,0.0,100.0,Male
Lionell,1978,22,0,22,0.0,100.0,Male
Ronen,1978,5,0,5,0.0,100.0,Male
Jeremey,1978,135,0,135,0.0,100.0,Male
Dennie,1978,28,0,28,0.0,100.0,Male
Demond,1978,222,0,222,0.0,100.0,Male
Chun,1978,7,0,7,0.0,100.0,Male
Markis,1978,10,0,10,0.0,100.0,Male
Dabid,1978,5,0,5,0.0,100.0,Male
Tennyson,1978,12,0,12,0.0,100.0,Male
Richrd,1978,12,0,12,0.0,100.0,Male
Wilburt,1978,5,0,5,0.0,100.0,Male
Corneluis,1978,6,0,6,0.0,100.0,Male
Luther,1978,220,0,220,0.0,100.0,Male
Javis,1978,12,0,12,0.0,100.0,Male
Ulices,1978,7,0,7,0.0,100.0,Male
Jalil,1978,8,0,8,0.0,100.0,Male
Waymond,1978,16,0,16,0.0,100.0,Male
Prem,1978,9,0,9,0.0,100.0,Male
Maneesh,1978,5,0,5,0.0,100.0,Male
Antwon,1978,119,0,119,0.0,100.0,Male
Hillel,1978,15,0,15,0.0,100.0,Male
Canon,1978,6,0,6,0.0,100.0,Male
Dequincy,1978,5,0,5,0.0,100.0,Male
Binyamin,1978,5,0,5,0.0,100.0,Male
Cato,1978,7,0,7,0.0,100.0,Male
Jaworski,1978,5,0,5,0.0,100.0,Male
Gearld,1978,11,0,11,0.0,100.0,Male
Rahn,1978,6,0,6,0.0,100.0,Male
Dayton,1978,42,0,42,0.0,100.0,Male
Jamy,1978,35,27,8,77.14285714285715,22.857142857142858,Unisex
Jamile,1978,12,7,5,58.333333333333336,41.66666666666667,Unisex
London,1978,30,17,13,56.66666666666666,43.333333333333336,Unisex
Jammy,1978,18,5,13,27.77777777777778,72.22222222222221,Unisex
Ashely,1978,25,20,5,80.0,20.0,Unisex
Tal,1978,21,6,15,28.57142857142857,71.42857142857143,Unisex
San,1978,36,26,10,72.22222222222221,27.77777777777778,Unisex
Lou,1978,63,38,25,60.31746031746032,39.68253968253968,Unisex
Andrey,1978,24,6,18,25.0,75.0,Unisex
Jontue,1978,16,5,11,31.25,68.75,Unisex
Quinn,1978,230,66,164,28.695652173913043,71.30434782608695,Unisex
Kc,1978,36,9,27,25.0,75.0,Unisex
Gwyn,1978,21,16,5,76.19047619047619,23.809523809523807,Unisex
Tevis,1978,15,5,10,33.33333333333333,66.66666666666666,Unisex
Ricki,1978,64,42,22,65.625,34.375,Unisex
Ivey,1978,30,22,8,73.33333333333333,26.666666666666668,Unisex
Linh,1978,21,15,6,71.42857142857143,28.57142857142857,Unisex
Arin,1978,80,54,26,67.5,32.5,Unisex
Cedar,1978,22,14,8,63.63636363636363,36.36363636363637,Unisex
Nevada,1978,26,17,9,65.38461538461539,34.61538461538461,Unisex
Victory,1978,17,7,10,41.17647058823529,58.82352941176471,Unisex
Dee,1978,123,85,38,69.10569105691057,30.89430894308943,Unisex
Coty,1978,51,26,25,50.98039215686274,49.01960784313725,Unisex
Dwan,1978,70,39,31,55.71428571428572,44.285714285714285,Unisex
Jayme,1978,545,443,102,81.28440366972477,18.71559633027523,Unisex
Jan,1978,377,245,132,64.9867374005305,35.0132625994695,Unisex
Berkeley,1978,12,6,6,50.0,50.0,Unisex
Jin,1978,12,7,5,58.333333333333336,41.66666666666667,Unisex
Paris,1978,112,51,61,45.535714285714285,54.46428571428571,Unisex
Demetrious,1978,22,6,16,27.27272727272727,72.72727272727273,Unisex
Tonja,1979,101,101,0,100.0,0.0,Female
Davida,1979,75,75,0,100.0,0.0,Female
Bette,1979,15,15,0,100.0,0.0,Female
Wydia,1979,5,5,0,100.0,0.0,Female
Cheramie,1979,7,7,0,100.0,0.0,Female
Dewanna,1979,16,16,0,100.0,0.0,Female
Briar,1979,7,7,0,100.0,0.0,Female
Lorren,1979,5,5,0,100.0,0.0,Female
Sunni,1979,51,46,5,90.19607843137256,9.803921568627452,Female
Jenine,1979,58,58,0,100.0,0.0,Female
Shanielle,1979,5,5,0,100.0,0.0,Female
Danine,1979,10,10,0,100.0,0.0,Female
Apryl,1979,96,96,0,100.0,0.0,Female
Lesleigh,1979,17,17,0,100.0,0.0,Female
Shauntina,1979,5,5,0,100.0,0.0,Female
Tabithia,1979,8,8,0,100.0,0.0,Female
Tekeshia,1979,8,8,0,100.0,0.0,Female
Nicholle,1979,70,70,0,100.0,0.0,Female
Trisha,1979,1777,1777,0,100.0,0.0,Female
Marshana,1979,6,6,0,100.0,0.0,Female
Rhondalyn,1979,6,6,0,100.0,0.0,Female
Kamla,1979,8,8,0,100.0,0.0,Female
Shenise,1979,10,10,0,100.0,0.0,Female
Rizza,1979,6,6,0,100.0,0.0,Female
Latunya,1979,15,15,0,100.0,0.0,Female
Genae,1979,13,13,0,100.0,0.0,Female
Shavona,1979,19,19,0,100.0,0.0,Female
Eureka,1979,38,38,0,100.0,0.0,Female
Chitra,1979,5,5,0,100.0,0.0,Female
Aliceson,1979,7,7,0,100.0,0.0,Female
Jermar,1979,18,0,18,0.0,100.0,Male
Rylan,1979,19,0,19,0.0,100.0,Male
Nichlas,1979,14,0,14,0.0,100.0,Male
Aviel,1979,7,0,7,0.0,100.0,Male
Jeffre,1979,8,0,8,0.0,100.0,Male
Dontez,1979,9,0,9,0.0,100.0,Male
Guido,1979,16,0,16,0.0,100.0,Male
Gunnar,1979,22,0,22,0.0,100.0,Male
Rameen,1979,6,0,6,0.0,100.0,Male
Kenrick,1979,22,0,22,0.0,100.0,Male
Stelios,1979,9,0,9,0.0,100.0,Male
Georgios,1979,18,0,18,0.0,100.0,Male
Mare,1979,10,0,10,0.0,100.0,Male
Tj,1979,38,0,38,0.0,100.0,Male
Nico,1979,11,0,11,0.0,100.0,Male
Takashi,1979,6,0,6,0.0,100.0,Male
Craige,1979,7,0,7,0.0,100.0,Male
Cesar,1979,773,10,763,1.29366106080207,98.70633893919792,Male
Kaiser,1979,6,0,6,0.0,100.0,Male
Johnjoseph,1979,5,0,5,0.0,100.0,Male
Bengie,1979,5,0,5,0.0,100.0,Male
Lester,1979,429,7,422,1.6317016317016315,98.36829836829835,Male
Nicolas,1979,913,7,906,0.7667031763417306,99.23329682365826,Male
Slyvester,1979,8,0,8,0.0,100.0,Male
Branden,1979,307,14,293,4.5602605863192185,95.43973941368078,Male
Bryce,1979,551,13,538,2.35934664246824,97.64065335753176,Male
Nabeel,1979,7,0,7,0.0,100.0,Male
Eloy,1979,111,0,111,0.0,100.0,Male
Carlito,1979,10,0,10,0.0,100.0,Male
Tyrece,1979,5,0,5,0.0,100.0,Male
Torrey,1979,193,29,164,15.025906735751295,84.97409326424871,Unisex
Sandeep,1979,27,5,22,18.51851851851852,81.48148148148148,Unisex
Tandy,1979,53,44,9,83.01886792452831,16.9811320754717,Unisex
Roby,1979,25,5,20,20.0,80.0,Unisex
Eden,1979,78,55,23,70.51282051282051,29.48717948717949,Unisex
Karry,1979,47,37,10,78.72340425531915,21.27659574468085,Unisex
Darcel,1979,15,9,6,60.0,40.0,Unisex
Linzy,1979,13,8,5,61.53846153846154,38.46153846153847,Unisex
Bryn,1979,101,82,19,81.1881188118812,18.81188118811881,Unisex
Aeron,1979,12,5,7,41.66666666666667,58.333333333333336,Unisex
Jan,1979,329,197,132,59.87841945288754,40.12158054711247,Unisex
Kalin,1979,23,7,16,30.434782608695656,69.56521739130434,Unisex
Cassidy,1979,149,108,41,72.48322147651007,27.516778523489933,Unisex
Rhyan,1979,16,7,9,43.75,56.25,Unisex
Sloan,1979,21,7,14,33.33333333333333,66.66666666666666,Unisex
Donyell,1979,35,17,18,48.57142857142857,51.42857142857142,Unisex
Nicola,1979,180,138,42,76.66666666666667,23.33333333333333,Unisex
Parris,1979,26,10,16,38.46153846153847,61.53846153846154,Unisex
Lyn,1979,61,50,11,81.9672131147541,18.0327868852459,Unisex
Brannan,1979,16,6,10,37.5,62.5,Unisex
Ellison,1979,12,7,5,58.333333333333336,41.66666666666667,Unisex
Starlin,1979,10,5,5,50.0,50.0,Unisex
Tyran,1979,39,6,33,15.384615384615383,84.61538461538461,Unisex
Shontel,1979,26,19,7,73.07692307692307,26.923076923076923,Unisex
Dennie,1979,34,9,25,26.47058823529412,73.52941176470588,Unisex
Korrie,1979,26,19,7,73.07692307692307,26.923076923076923,Unisex
Mykel,1979,11,5,6,45.45454545454545,54.54545454545454,Unisex
Aris,1979,29,16,13,55.172413793103445,44.82758620689656,Unisex
Daniell,1979,101,69,32,68.31683168316832,31.683168316831683,Unisex
Kwanza,1979,18,11,7,61.11111111111112,38.88888888888889,Unisex
Janean,1980,28,28,0,100.0,0.0,Female
Roxan,1980,5,5,0,100.0,0.0,Female
Joylynn,1980,9,9,0,100.0,0.0,Female
Latysha,1980,10,10,0,100.0,0.0,Female
Janille,1980,6,6,0,100.0,0.0,Female
Chere,1980,25,25,0,100.0,0.0,Female
Aimie,1980,18,18,0,100.0,0.0,Female
Penny,1980,556,556,0,100.0,0.0,Female
Shereta,1980,7,7,0,100.0,0.0,Female
Natesa,1980,7,7,0,100.0,0.0,Female
Jalene,1980,15,15,0,100.0,0.0,Female
Keturah,1980,57,57,0,100.0,0.0,Female
Timarie,1980,5,5,0,100.0,0.0,Female
Shakenya,1980,8,8,0,100.0,0.0,Female
Shameka,1980,452,452,0,100.0,0.0,Female
Shaena,1980,8,8,0,100.0,0.0,Female
Kenna,1980,72,72,0,100.0,0.0,Female
Keitra,1980,7,7,0,100.0,0.0,Female
Ebelia,1980,6,6,0,100.0,0.0,Female
Duana,1980,9,9,0,100.0,0.0,Female
Quantisha,1980,8,8,0,100.0,0.0,Female
Kaneisha,1980,18,18,0,100.0,0.0,Female
Chanel,1980,281,281,0,100.0,0.0,Female
Makeisha,1980,12,12,0,100.0,0.0,Female
Nilsa,1980,28,28,0,100.0,0.0,Female
Rosy,1980,14,14,0,100.0,0.0,Female
Nichele,1980,10,10,0,100.0,0.0,Female
Dannell,1980,7,7,0,100.0,0.0,Female
Kinberly,1980,9,9,0,100.0,0.0,Female
Jahida,1980,7,7,0,100.0,0.0,Female
Panagiotis,1980,39,0,39,0.0,100.0,Male
Montay,1980,5,0,5,0.0,100.0,Male
Tyheem,1980,7,0,7,0.0,100.0,Male
Nicholas,1980,21165,139,21026,0.6567446255610678,99.34325537443894,Male
Sharad,1980,7,0,7,0.0,100.0,Male
Benjamen,1980,67,0,67,0.0,100.0,Male
Arnaldo,1980,37,0,37,0.0,100.0,Male
Richardson,1980,7,0,7,0.0,100.0,Male
Salih,1980,6,0,6,0.0,100.0,Male
Dewayne,1980,446,5,441,1.1210762331838564,98.87892376681614,Male
Thane,1980,22,0,22,0.0,100.0,Male
Konstantine,1980,8,0,8,0.0,100.0,Male
Tyrone,1980,1214,19,1195,1.5650741350906094,98.4349258649094,Male
Clete,1980,7,0,7,0.0,100.0,Male
Bennet,1980,5,0,5,0.0,100.0,Male
Huan,1980,7,0,7,0.0,100.0,Male
Juvon,1980,5,0,5,0.0,100.0,Male
Orson,1980,13,0,13,0.0,100.0,Male
Jude,1980,99,7,92,7.07070707070707,92.92929292929291,Male
Terelle,1980,13,0,13,0.0,100.0,Male
Rafi,1980,8,0,8,0.0,100.0,Male
Ireneo,1980,6,0,6,0.0,100.0,Male
Jemale,1980,5,0,5,0.0,100.0,Male
Rayshaun,1980,27,0,27,0.0,100.0,Male
Briant,1980,10,0,10,0.0,100.0,Male
Millard,1980,29,0,29,0.0,100.0,Male
Traver,1980,10,0,10,0.0,100.0,Male
Julious,1980,10,0,10,0.0,100.0,Male
Reyes,1980,79,8,71,10.126582278481012,89.87341772151899,Male
Arren,1980,7,0,7,0.0,100.0,Male
Angel,1980,3108,1689,1419,54.34362934362934,45.656370656370655,Unisex
Quinn,1980,322,104,218,32.298136645962735,67.70186335403726,Unisex
Christan,1980,63,49,14,77.77777777777779,22.22222222222222,Unisex
Kenyatta,1980,265,161,104,60.75471698113207,39.24528301886793,Unisex
Devyn,1980,27,20,7,74.07407407407408,25.925925925925924,Unisex
Paris,1980,175,66,109,37.71428571428572,62.28571428571429,Unisex
Jamy,1980,46,30,16,65.21739130434783,34.78260869565217,Unisex
Channon,1980,31,24,7,77.41935483870968,22.58064516129032,Unisex
Jame,1980,50,21,29,42.0,57.99999999999999,Unisex
Ricci,1980,69,48,21,69.56521739130434,30.434782608695656,Unisex
Maxx,1980,13,5,8,38.46153846153847,61.53846153846154,Unisex
Sky,1980,83,30,53,36.14457831325301,63.85542168674698,Unisex
Kei,1980,18,10,8,55.55555555555556,44.44444444444444,Unisex
Kc,1980,37,8,29,21.62162162162162,78.37837837837837,Unisex
Briane,1980,20,14,6,70.0,30.0,Unisex
Hien,1980,18,9,9,50.0,50.0,Unisex
Val,1980,29,6,23,20.6896551724138,79.3103448275862,Unisex
Ronell,1980,36,8,28,22.22222222222222,77.77777777777779,Unisex
Ha,1980,28,21,7,75.0,25.0,Unisex
Aren,1980,32,7,25,21.875,78.125,Unisex
Tobie,1980,27,18,9,66.66666666666666,33.33333333333333,Unisex
Lannie,1980,23,9,14,39.130434782608695,60.86956521739131,Unisex
Jayme,1980,591,493,98,83.41793570219966,16.58206429780034,Unisex
Adama,1980,18,6,12,33.33333333333333,66.66666666666666,Unisex
Rhyan,1980,20,10,10,50.0,50.0,Unisex
Kenyata,1980,53,33,20,62.264150943396224,37.735849056603776,Unisex
Taran,1980,15,7,8,46.66666666666666,53.333333333333336,Unisex
Nicky,1980,147,57,90,38.775510204081634,61.224489795918366,Unisex
Charon,1980,36,27,9,75.0,25.0,Unisex
Diamond,1980,88,59,29,67.04545454545455,32.95454545454545,Unisex
Marixa,1981,6,6,0,100.0,0.0,Female
Shevelle,1981,6,6,0,100.0,0.0,Female
Renalda,1981,8,8,0,100.0,0.0,Female
Breeann,1981,31,31,0,100.0,0.0,Female
Smantha,1981,5,5,0,100.0,0.0,Female
Corin,1981,78,69,9,88.46153846153845,11.538461538461538,Female
Demica,1981,6,6,0,100.0,0.0,Female
Michaelena,1981,6,6,0,100.0,0.0,Female
Takisha,1981,132,132,0,100.0,0.0,Female
Erendida,1981,8,8,0,100.0,0.0,Female
Ana,1981,1454,1440,14,99.03713892709766,0.9628610729023384,Female
Polly,1981,81,81,0,100.0,0.0,Female
Tashawna,1981,13,13,0,100.0,0.0,Female
Eva,1981,863,855,8,99.07300115874855,0.9269988412514484,Female
Katheleen,1981,8,8,0,100.0,0.0,Female
Rifka,1981,16,16,0,100.0,0.0,Female
Dene,1981,12,12,0,100.0,0.0,Female
Brekke,1981,7,7,0,100.0,0.0,Female
Ronada,1981,10,10,0,100.0,0.0,Female
Temeka,1981,98,98,0,100.0,0.0,Female
Shantika,1981,5,5,0,100.0,0.0,Female
Meliah,1981,5,5,0,100.0,0.0,Female
Jovanna,1981,45,45,0,100.0,0.0,Female
Diem,1981,11,11,0,100.0,0.0,Female
Tesa,1981,29,29,0,100.0,0.0,Female
Krista,1981,1848,1848,0,100.0,0.0,Female
Jaimee,1981,126,126,0,100.0,0.0,Female
Andrea,1981,11840,11686,154,98.69932432432432,1.3006756756756757,Female
Josette,1981,61,61,0,100.0,0.0,Female
Timi,1981,9,9,0,100.0,0.0,Female
Marrio,1981,22,0,22,0.0,100.0,Male
Janson,1981,14,0,14,0.0,100.0,Male
Authur,1981,19,0,19,0.0,100.0,Male
Wynn,1981,13,0,13,0.0,100.0,Male
Dameian,1981,7,0,7,0.0,100.0,Male
Don,1981,664,11,653,1.6566265060240966,98.3433734939759,Male
Henri,1981,28,0,28,0.0,100.0,Male
Lavar,1981,78,0,78,0.0,100.0,Male
Kobie,1981,5,0,5,0.0,100.0,Male
Cloyd,1981,9,0,9,0.0,100.0,Male
Jarron,1981,19,0,19,0.0,100.0,Male
Sal,1981,24,0,24,0.0,100.0,Male
Yisroel,1981,40,0,40,0.0,100.0,Male
Schyler,1981,6,0,6,0.0,100.0,Male
Jamarcus,1981,20,0,20,0.0,100.0,Male
Lendell,1981,7,0,7,0.0,100.0,Male
Sid,1981,6,0,6,0.0,100.0,Male
Frazier,1981,15,0,15,0.0,100.0,Male
Oran,1981,17,0,17,0.0,100.0,Male
Aamir,1981,11,0,11,0.0,100.0,Male
Hughes,1981,5,0,5,0.0,100.0,Male
Allah,1981,9,0,9,0.0,100.0,Male
Bobby,1981,2758,99,2659,3.589557650471356,96.41044234952864,Male
Thurman,1981,60,0,60,0.0,100.0,Male
Arrick,1981,6,0,6,0.0,100.0,Male
Abdullah,1981,54,0,54,0.0,100.0,Male
Sebastiano,1981,8,0,8,0.0,100.0,Male
Terrence,1981,1091,14,1077,1.2832263978001834,98.7167736021998,Male
Lukus,1981,20,0,20,0.0,100.0,Male
Duke,1981,41,0,41,0.0,100.0,Male
Linden,1981,38,16,22,42.10526315789473,57.89473684210527,Unisex
Marquel,1981,21,5,16,23.809523809523807,76.19047619047619,Unisex
Danyel,1981,78,65,13,83.33333333333334,16.666666666666664,Unisex
Dia,1981,41,33,8,80.48780487804879,19.51219512195122,Unisex
Javon,1981,142,38,104,26.76056338028169,73.23943661971832,Unisex
Carey,1981,438,273,165,62.32876712328768,37.67123287671233,Unisex
Avery,1981,292,57,235,19.52054794520548,80.47945205479452,Unisex
Ji,1981,11,5,6,45.45454545454545,54.54545454545454,Unisex
Marley,1981,31,18,13,58.06451612903226,41.935483870967744,Unisex
Harvest,1981,17,11,6,64.70588235294117,35.294117647058826,Unisex
Javonne,1981,22,17,5,77.27272727272727,22.727272727272727,Unisex
Harper,1981,16,8,8,50.0,50.0,Unisex
Garnet,1981,18,13,5,72.22222222222221,27.77777777777778,Unisex
Cam,1981,17,10,7,58.82352941176471,41.17647058823529,Unisex
Jamara,1981,20,12,8,60.0,40.0,Unisex
Breon,1981,21,5,16,23.809523809523807,76.19047619047619,Unisex
Demetric,1981,89,24,65,26.96629213483146,73.03370786516854,Unisex
Smith,1981,32,6,26,18.75,81.25,Unisex
Mica,1981,82,69,13,84.14634146341463,15.853658536585366,Unisex
Teal,1981,40,34,6,85.0,15.0,Unisex
Maxie,1981,29,6,23,20.6896551724138,79.3103448275862,Unisex
Chesley,1981,29,15,14,51.72413793103448,48.27586206896552,Unisex
Aryn,1981,39,32,7,82.05128205128204,17.94871794871795,Unisex
Tuyen,1981,21,14,7,66.66666666666666,33.33333333333333,Unisex
Lashun,1981,31,20,11,64.51612903225806,35.483870967741936,Unisex
Trenell,1981,14,6,8,42.85714285714285,57.14285714285714,Unisex
Trinidad,1981,88,25,63,28.40909090909091,71.5909090909091,Unisex
Nima,1981,31,12,19,38.70967741935484,61.29032258064516,Unisex
Carlin,1981,57,23,34,40.35087719298245,59.64912280701754,Unisex
Marshell,1981,18,8,10,44.44444444444444,55.55555555555556,Unisex
Shiana,1982,6,6,0,100.0,0.0,Female
Landa,1982,5,5,0,100.0,0.0,Female
Sharise,1982,15,15,0,100.0,0.0,Female
Marguetta,1982,7,7,0,100.0,0.0,Female
Marylee,1982,13,13,0,100.0,0.0,Female
Georgeann,1982,8,8,0,100.0,0.0,Female
Jeanetta,1982,40,40,0,100.0,0.0,Female
Alishea,1982,11,11,0,100.0,0.0,Female
Yu,1982,9,9,0,100.0,0.0,Female
Katilyn,1982,6,6,0,100.0,0.0,Female
Jamileh,1982,5,5,0,100.0,0.0,Female
Shermeka,1982,11,11,0,100.0,0.0,Female
Enza,1982,7,7,0,100.0,0.0,Female
Tondra,1982,7,7,0,100.0,0.0,Female
Naja,1982,15,15,0,100.0,0.0,Female
Genna,1982,47,47,0,100.0,0.0,Female
Sulay,1982,6,6,0,100.0,0.0,Female
Amamda,1982,16,16,0,100.0,0.0,Female
Shanequa,1982,41,41,0,100.0,0.0,Female
Shellyann,1982,5,5,0,100.0,0.0,Female
Nashea,1982,6,6,0,100.0,0.0,Female
Laurie,1982,1191,1185,6,99.49622166246851,0.5037783375314862,Female
Monquie,1982,15,15,0,100.0,0.0,Female
Lateesha,1982,19,19,0,100.0,0.0,Female
Korri,1982,15,15,0,100.0,0.0,Female
Kella,1982,5,5,0,100.0,0.0,Female
Josefa,1982,21,21,0,100.0,0.0,Female
Nancy,1982,2834,2807,27,99.04728299223711,0.9527170077628794,Female
Nilsa,1982,18,18,0,100.0,0.0,Female
Thrisha,1982,6,6,0,100.0,0.0,Female
Marshon,1982,9,0,9,0.0,100.0,Male
Kahlil,1982,34,0,34,0.0,100.0,Male
Anant,1982,7,0,7,0.0,100.0,Male
Murray,1982,49,0,49,0.0,100.0,Male
Cornelius,1982,431,9,422,2.088167053364269,97.91183294663574,Male
Darrian,1982,13,0,13,0.0,100.0,Male
Terence,1982,486,7,479,1.440329218106996,98.559670781893,Male
Lemont,1982,14,0,14,0.0,100.0,Male
Zerrick,1982,6,0,6,0.0,100.0,Male
Heinz,1982,7,0,7,0.0,100.0,Male
Curvin,1982,6,0,6,0.0,100.0,Male
Martin,1982,2198,28,2170,1.2738853503184715,98.72611464968152,Male
Salim,1982,26,0,26,0.0,100.0,Male
Ozzy,1982,9,0,9,0.0,100.0,Male
Randy,1982,3270,42,3228,1.2844036697247707,98.71559633027525,Male
Ankoor,1982,5,0,5,0.0,100.0,Male
Yvan,1982,5,0,5,0.0,100.0,Male
Orlando,1982,694,5,689,0.7204610951008645,99.27953890489914,Male
Abraham,1982,847,10,837,1.180637544273908,98.8193624557261,Male
Fabrice,1982,6,0,6,0.0,100.0,Male
Sharief,1982,6,0,6,0.0,100.0,Male
Ahmaad,1982,6,0,6,0.0,100.0,Male
Osbaldo,1982,37,0,37,0.0,100.0,Male
Princeton,1982,23,0,23,0.0,100.0,Male
Benito,1982,175,0,175,0.0,100.0,Male
Bruce,1982,1599,9,1590,0.5628517823639775,99.43714821763602,Male
Talon,1982,33,0,33,0.0,100.0,Male
Davis,1982,172,0,172,0.0,100.0,Male
Ben,1982,444,7,437,1.5765765765765765,98.42342342342344,Male
Gamal,1982,14,0,14,0.0,100.0,Male
Jayme,1982,600,506,94,84.33333333333334,15.666666666666668,Unisex
Kalan,1982,21,9,12,42.85714285714285,57.14285714285714,Unisex
Peyton,1982,56,19,37,33.92857142857143,66.07142857142857,Unisex
Chee,1982,17,8,9,47.05882352941176,52.94117647058824,Unisex
Jamine,1982,19,11,8,57.89473684210527,42.10526315789473,Unisex
Dorian,1982,324,103,221,31.790123456790127,68.20987654320987,Unisex
Sequoyah,1982,12,7,5,58.333333333333336,41.66666666666667,Unisex
Nevada,1982,24,8,16,33.33333333333333,66.66666666666666,Unisex
Daniele,1982,100,82,18,82.0,18.0,Unisex
Tonie,1982,45,38,7,84.44444444444444,15.555555555555555,Unisex
Avis,1982,64,48,16,75.0,25.0,Unisex
Tyan,1982,15,8,7,53.333333333333336,46.66666666666666,Unisex
Jovan,1982,314,86,228,27.38853503184713,72.61146496815286,Unisex
Tuyen,1982,22,17,5,77.27272727272727,22.727272727272727,Unisex
Sun,1982,25,11,14,44.0,56.00000000000001,Unisex
Linn,1982,18,11,7,61.11111111111112,38.88888888888889,Unisex
Kegan,1982,18,6,12,33.33333333333333,66.66666666666666,Unisex
Holland,1982,73,57,16,78.08219178082192,21.91780821917808,Unisex
Quin,1982,16,6,10,37.5,62.5,Unisex
Chau,1982,35,19,16,54.285714285714285,45.71428571428572,Unisex
Quinn,1982,331,141,190,42.59818731117825,57.40181268882175,Unisex
Teryl,1982,16,10,6,62.5,37.5,Unisex
Chancy,1982,21,7,14,33.33333333333333,66.66666666666666,Unisex
Linden,1982,32,15,17,46.875,53.125,Unisex
Iman,1982,46,36,10,78.26086956521739,21.73913043478261,Unisex
Tobie,1982,18,9,9,50.0,50.0,Unisex
Codie,1982,53,43,10,81.13207547169812,18.867924528301888,Unisex
Elisha,1982,648,540,108,83.33333333333334,16.666666666666664,Unisex
Hoang,1982,64,11,53,17.1875,82.8125,Unisex
Lynell,1982,24,13,11,54.16666666666666,45.83333333333333,Unisex
Laquisha,1983,102,102,0,100.0,0.0,Female
Honora,1983,7,7,0,100.0,0.0,Female
Stepphanie,1983,5,5,0,100.0,0.0,Female
Delphine,1983,11,11,0,100.0,0.0,Female
Chellie,1983,5,5,0,100.0,0.0,Female
Keilah,1983,14,14,0,100.0,0.0,Female
Krizia,1983,10,10,0,100.0,0.0,Female
Marquitta,1983,138,138,0,100.0,0.0,Female
Lakea,1983,8,8,0,100.0,0.0,Female
Katalin,1983,7,7,0,100.0,0.0,Female
Sherae,1983,10,10,0,100.0,0.0,Female
Ashlei,1983,65,65,0,100.0,0.0,Female
Krissi,1983,8,8,0,100.0,0.0,Female
Kelsy,1983,40,40,0,100.0,0.0,Female
Camille,1983,625,625,0,100.0,0.0,Female
Jacqueline,1983,5433,5404,29,99.46622492177434,0.5337750782256581,Female
Kineta,1983,5,5,0,100.0,0.0,Female
Tonica,1983,15,15,0,100.0,0.0,Female
Cindy,1983,1564,1548,16,98.9769820971867,1.0230179028132993,Female
Fontella,1983,5,5,0,100.0,0.0,Female
Rosella,1983,21,21,0,100.0,0.0,Female
Camelia,1983,28,28,0,100.0,0.0,Female
Mehgan,1983,18,18,0,100.0,0.0,Female
Desa,1983,5,5,0,100.0,0.0,Female
Lesli,1983,59,59,0,100.0,0.0,Female
Chantiel,1983,5,5,0,100.0,0.0,Female
Estefani,1983,6,6,0,100.0,0.0,Female
Consuela,1983,33,33,0,100.0,0.0,Female
Leora,1983,44,44,0,100.0,0.0,Female
Liberty,1983,52,52,0,100.0,0.0,Female
Storm,1983,7,0,7,0.0,100.0,Male
Jacobs,1983,6,0,6,0.0,100.0,Male
Burke,1983,45,0,45,0.0,100.0,Male
Michah,1983,10,0,10,0.0,100.0,Male
Namon,1983,6,0,6,0.0,100.0,Male
Mithcell,1983,10,0,10,0.0,100.0,Male
Nyles,1983,6,0,6,0.0,100.0,Male
Rahul,1983,37,0,37,0.0,100.0,Male
Dionte,1983,54,5,49,9.25925925925926,90.74074074074076,Male
Antwyne,1983,8,0,8,0.0,100.0,Male
Kwane,1983,8,0,8,0.0,100.0,Male
Collis,1983,6,0,6,0.0,100.0,Male
Jamond,1983,10,0,10,0.0,100.0,Male
Munir,1983,9,0,9,0.0,100.0,Male
Delfino,1983,26,0,26,0.0,100.0,Male
Scot,1983,108,0,108,0.0,100.0,Male
Irvin,1983,104,0,104,0.0,100.0,Male
Eduard,1983,14,0,14,0.0,100.0,Male
Jakeb,1983,5,0,5,0.0,100.0,Male
Jabir,1983,5,0,5,0.0,100.0,Male
Fabio,1983,38,0,38,0.0,100.0,Male
Jarrick,1983,7,0,7,0.0,100.0,Male
Norberto,1983,77,0,77,0.0,100.0,Male
Jorje,1983,32,0,32,0.0,100.0,Male
Dagoberto,1983,32,0,32,0.0,100.0,Male
Glenford,1983,8,0,8,0.0,100.0,Male
Niel,1983,7,0,7,0.0,100.0,Male
Robert,1983,33005,255,32750,0.7726102105741555,99.22738978942584,Male
Torrance,1983,43,0,43,0.0,100.0,Male
Vuthy,1983,6,0,6,0.0,100.0,Male
Augusta,1983,33,28,5,84.84848484848484,15.151515151515152,Unisex
Nima,1983,31,9,22,29.03225806451613,70.96774193548387,Unisex
Nery,1983,14,5,9,35.714285714285715,64.28571428571429,Unisex
Lorren,1983,22,14,8,63.63636363636363,36.36363636363637,Unisex
Kesley,1983,15,8,7,53.333333333333336,46.66666666666666,Unisex
Adel,1983,25,11,14,44.0,56.00000000000001,Unisex
Alika,1983,21,6,15,28.57142857142857,71.42857142857143,Unisex
Ka,1983,46,39,7,84.78260869565217,15.217391304347828,Unisex
Sammie,1983,119,39,80,32.77310924369748,67.22689075630252,Unisex
Jin,1983,28,13,15,46.42857142857143,53.57142857142857,Unisex
Raleigh,1983,57,11,46,19.29824561403509,80.7017543859649,Unisex
Merritt,1983,33,12,21,36.36363636363637,63.63636363636363,Unisex
Torri,1983,40,28,12,70.0,30.0,Unisex
Salome,1983,23,16,7,69.56521739130434,30.434782608695656,Unisex
Jewell,1983,63,48,15,76.19047619047619,23.809523809523807,Unisex
Devan,1983,198,87,111,43.93939393939394,56.060606060606055,Unisex
Lael,1983,25,16,9,64.0,36.0,Unisex
Eran,1983,17,5,12,29.411764705882355,70.58823529411765,Unisex
Bevan,1983,13,8,5,61.53846153846154,38.46153846153847,Unisex
Hoa,1983,41,26,15,63.41463414634146,36.58536585365854,Unisex
Andie,1983,13,7,6,53.84615384615385,46.15384615384615,Unisex
Deniz,1983,16,9,7,56.25,43.75,Unisex
Lorin,1983,97,53,44,54.63917525773196,45.36082474226804,Unisex
Mikell,1983,29,5,24,17.24137931034483,82.75862068965517,Unisex
Alexis,1983,4119,3462,657,84.04952658412236,15.95047341587764,Unisex
Jacque,1983,51,33,18,64.70588235294117,35.294117647058826,Unisex
Sopheap,1983,19,11,8,57.89473684210527,42.10526315789473,Unisex
Justice,1983,34,6,28,17.647058823529413,82.35294117647058,Unisex
Phuong,1983,98,69,29,70.40816326530613,29.59183673469388,Unisex
Astin,1983,20,13,7,65.0,35.0,Unisex
Jisela,1984,6,6,0,100.0,0.0,Female
Markisha,1984,54,54,0,100.0,0.0,Female
Melisha,1984,27,27,0,100.0,0.0,Female
Cerina,1984,7,7,0,100.0,0.0,Female
Jeneva,1984,14,14,0,100.0,0.0,Female
Etta,1984,20,20,0,100.0,0.0,Female
Marilin,1984,8,8,0,100.0,0.0,Female
Shoshannah,1984,5,5,0,100.0,0.0,Female
Marlynn,1984,5,5,0,100.0,0.0,Female
Megaan,1984,6,6,0,100.0,0.0,Female
Alesia,1984,149,149,0,100.0,0.0,Female
Taressa,1984,11,11,0,100.0,0.0,Female
Kia,1984,188,188,0,100.0,0.0,Female
Hetal,1984,12,12,0,100.0,0.0,Female
Jaquana,1984,16,16,0,100.0,0.0,Female
Shiann,1984,8,8,0,100.0,0.0,Female
Leea,1984,9,9,0,100.0,0.0,Female
Kristiann,1984,6,6,0,100.0,0.0,Female
Lakendria,1984,13,13,0,100.0,0.0,Female
Nidra,1984,6,6,0,100.0,0.0,Female
Sultana,1984,6,6,0,100.0,0.0,Female
Vaneza,1984,10,10,0,100.0,0.0,Female
Margaux,1984,45,45,0,100.0,0.0,Female
Tishara,1984,7,7,0,100.0,0.0,Female
Zandria,1984,6,6,0,100.0,0.0,Female
Rekha,1984,8,8,0,100.0,0.0,Female
Kaisha,1984,22,22,0,100.0,0.0,Female
Maranda,1984,304,304,0,100.0,0.0,Female
Yaquelin,1984,6,6,0,100.0,0.0,Female
Shantika,1984,7,7,0,100.0,0.0,Female
Kedar,1984,7,0,7,0.0,100.0,Male
Seann,1984,14,0,14,0.0,100.0,Male
Iokepa,1984,5,0,5,0.0,100.0,Male
Bertram,1984,28,0,28,0.0,100.0,Male
Keyan,1984,9,0,9,0.0,100.0,Male
Rahman,1984,17,0,17,0.0,100.0,Male
Nils,1984,26,0,26,0.0,100.0,Male
Kerwin,1984,36,0,36,0.0,100.0,Male
Chadwick,1984,309,0,309,0.0,100.0,Male
Parnell,1984,19,0,19,0.0,100.0,Male
Jahaziel,1984,12,0,12,0.0,100.0,Male
Talon,1984,55,0,55,0.0,100.0,Male
Tamer,1984,18,0,18,0.0,100.0,Male
Homero,1984,50,0,50,0.0,100.0,Male
Tobiah,1984,6,0,6,0.0,100.0,Male
Yitzchok,1984,41,0,41,0.0,100.0,Male
Leoncio,1984,11,0,11,0.0,100.0,Male
Tanner,1984,414,7,407,1.6908212560386473,98.30917874396135,Male
Chukwuemeka,1984,7,0,7,0.0,100.0,Male
Kayvan,1984,6,0,6,0.0,100.0,Male
Merl,1984,5,0,5,0.0,100.0,Male
Jonah,1984,276,7,269,2.536231884057971,97.46376811594205,Male
Askia,1984,9,0,9,0.0,100.0,Male
Jaymar,1984,7,0,7,0.0,100.0,Male
Eris,1984,5,0,5,0.0,100.0,Male
Winslow,1984,12,0,12,0.0,100.0,Male
Alistair,1984,14,0,14,0.0,100.0,Male
Javid,1984,7,0,7,0.0,100.0,Male
Xue,1984,6,0,6,0.0,100.0,Male
Yonah,1984,5,0,5,0.0,100.0,Male
Jamie,1984,11527,9762,1765,84.6881235360458,15.311876463954194,Unisex
Jae,1984,23,7,16,30.434782608695656,69.56521739130434,Unisex
Kobie,1984,12,6,6,50.0,50.0,Unisex
Misha,1984,69,58,11,84.05797101449275,15.942028985507244,Unisex
Dorian,1984,311,109,202,35.048231511254016,64.95176848874597,Unisex
Christon,1984,37,12,25,32.432432432432435,67.56756756756756,Unisex
Marlo,1984,85,48,37,56.47058823529412,43.52941176470589,Unisex
Noor,1984,30,23,7,76.66666666666667,23.33333333333333,Unisex
Terren,1984,15,6,9,40.0,60.0,Unisex
Deane,1984,13,7,6,53.84615384615385,46.15384615384615,Unisex
Rashan,1984,27,6,21,22.22222222222222,77.77777777777779,Unisex
Chau,1984,28,17,11,60.71428571428571,39.285714285714285,Unisex
Sha,1984,27,22,5,81.48148148148148,18.51851851851852,Unisex
Clancy,1984,22,7,15,31.818181818181817,68.18181818181817,Unisex
Cedar,1984,24,14,10,58.333333333333336,41.66666666666667,Unisex
Torie,1984,37,31,6,83.78378378378379,16.216216216216218,Unisex
Tien,1984,28,11,17,39.285714285714285,60.71428571428571,Unisex
Karey,1984,44,35,9,79.54545454545455,20.454545454545457,Unisex
Jamille,1984,26,19,7,73.07692307692307,26.923076923076923,Unisex
Dakota,1984,79,19,60,24.050632911392405,75.9493670886076,Unisex
Ellison,1984,19,7,12,36.84210526315789,63.1578947368421,Unisex
Shanon,1984,181,149,32,82.32044198895028,17.67955801104972,Unisex
Ha,1984,37,29,8,78.37837837837837,21.62162162162162,Unisex
Samar,1984,25,20,5,80.0,20.0,Unisex
Stephane,1984,40,25,15,62.5,37.5,Unisex
Yoon,1984,13,8,5,61.53846153846154,38.46153846153847,Unisex
Kim,1984,481,388,93,80.66528066528068,19.33471933471933,Unisex
Akira,1984,45,32,13,71.11111111111111,28.88888888888889,Unisex
Carmon,1984,27,21,6,77.77777777777779,22.22222222222222,Unisex
Rickie,1984,124,19,105,15.32258064516129,84.67741935483872,Unisex
Carah,1985,18,18,0,100.0,0.0,Female
Desarie,1985,6,6,0,100.0,0.0,Female
Korrina,1985,6,6,0,100.0,0.0,Female
Sharie,1985,50,50,0,100.0,0.0,Female
Felecia,1985,180,180,0,100.0,0.0,Female
Ladreka,1985,5,5,0,100.0,0.0,Female
Nicolle,1985,144,144,0,100.0,0.0,Female
Keeyana,1985,6,6,0,100.0,0.0,Female
Melina,1985,182,182,0,100.0,0.0,Female
Sahar,1985,48,48,0,100.0,0.0,Female
Ivonne,1985,66,66,0,100.0,0.0,Female
Laparis,1985,5,5,0,100.0,0.0,Female
Geovanna,1985,7,7,0,100.0,0.0,Female
Breonna,1985,16,16,0,100.0,0.0,Female
Tennile,1985,6,6,0,100.0,0.0,Female
Margarita,1985,396,396,0,100.0,0.0,Female
Krisheena,1985,6,6,0,100.0,0.0,Female
Demika,1985,8,8,0,100.0,0.0,Female
Shoshannah,1985,13,13,0,100.0,0.0,Female
Deanza,1985,5,5,0,100.0,0.0,Female
Suong,1985,10,10,0,100.0,0.0,Female
Seema,1985,28,28,0,100.0,0.0,Female
Taralynn,1985,9,9,0,100.0,0.0,Female
Kessa,1985,6,6,0,100.0,0.0,Female
Tyeshia,1985,47,47,0,100.0,0.0,Female
Kimmy,1985,6,6,0,100.0,0.0,Female
Lashawndra,1985,6,6,0,100.0,0.0,Female
Daiana,1985,5,5,0,100.0,0.0,Female
Kedra,1985,24,24,0,100.0,0.0,Female
Aundria,1985,12,12,0,100.0,0.0,Female
Joshia,1985,7,0,7,0.0,100.0,Male
Grabiel,1985,13,0,13,0.0,100.0,Male
Darrin,1985,385,6,379,1.5584415584415583,98.44155844155844,Male
Leroy,1985,545,6,539,1.1009174311926606,98.89908256880734,Male
Rufino,1985,23,0,23,0.0,100.0,Male
Sandro,1985,18,0,18,0.0,100.0,Male
Yeng,1985,13,0,13,0.0,100.0,Male
Rodrigues,1985,7,0,7,0.0,100.0,Male
Andru,1985,5,0,5,0.0,100.0,Male
Otis,1985,203,0,203,0.0,100.0,Male
Eligah,1985,6,0,6,0.0,100.0,Male
Theran,1985,9,0,9,0.0,100.0,Male
Johua,1985,7,0,7,0.0,100.0,Male
Garin,1985,21,0,21,0.0,100.0,Male
Kermit,1985,31,0,31,0.0,100.0,Male
Cleophus,1985,11,0,11,0.0,100.0,Male
Columbus,1985,12,0,12,0.0,100.0,Male
Jamail,1985,11,0,11,0.0,100.0,Male
Steele,1985,11,0,11,0.0,100.0,Male
Quintez,1985,14,0,14,0.0,100.0,Male
Sudeep,1985,5,0,5,0.0,100.0,Male
Duke,1985,37,0,37,0.0,100.0,Male
Jostin,1985,5,0,5,0.0,100.0,Male
Dyrell,1985,8,0,8,0.0,100.0,Male
Covey,1985,6,0,6,0.0,100.0,Male
Brandley,1985,8,0,8,0.0,100.0,Male
Bret,1985,513,11,502,2.144249512670565,97.85575048732944,Male
Dwight,1985,512,10,502,1.953125,98.046875,Male
Brently,1985,7,0,7,0.0,100.0,Male
Christepher,1985,10,0,10,0.0,100.0,Male
Karry,1985,34,27,7,79.41176470588235,20.588235294117645,Unisex
Quin,1985,17,7,10,41.17647058823529,58.82352941176471,Unisex
Dann,1985,19,9,10,47.368421052631575,52.63157894736842,Unisex
Gaylen,1985,10,5,5,50.0,50.0,Unisex
Breon,1985,46,7,39,15.217391304347828,84.78260869565217,Unisex
Sina,1985,28,12,16,42.85714285714285,57.14285714285714,Unisex
Kolby,1985,110,20,90,18.181818181818183,81.81818181818183,Unisex
Karel,1985,20,7,13,35.0,65.0,Unisex
Caprice,1985,58,49,9,84.48275862068965,15.517241379310343,Unisex
Christian,1985,3452,538,2914,15.585168018539978,84.41483198146003,Unisex
Chancy,1985,32,11,21,34.375,65.625,Unisex
Sunny,1985,221,162,59,73.30316742081448,26.69683257918552,Unisex
Markie,1985,30,25,5,83.33333333333334,16.666666666666664,Unisex
Mikell,1985,25,10,15,40.0,60.0,Unisex
Kerrin,1985,30,25,5,83.33333333333334,16.666666666666664,Unisex
Casy,1985,18,5,13,27.77777777777778,72.22222222222221,Unisex
Gabriele,1985,30,24,6,80.0,20.0,Unisex
Latrell,1985,27,10,17,37.03703703703704,62.96296296296296,Unisex
Jacky,1985,41,9,32,21.951219512195124,78.04878048780488,Unisex
Isa,1985,30,20,10,66.66666666666666,33.33333333333333,Unisex
Jamile,1985,16,5,11,31.25,68.75,Unisex
Kendal,1985,162,93,69,57.407407407407405,42.5925925925926,Unisex
Amal,1985,30,25,5,83.33333333333334,16.666666666666664,Unisex
Shanon,1985,146,124,22,84.93150684931507,15.068493150684931,Unisex
Han,1985,18,9,9,50.0,50.0,Unisex
Koty,1985,13,7,6,53.84615384615385,46.15384615384615,Unisex
Dany,1985,22,7,15,31.818181818181817,68.18181818181817,Unisex
Kalani,1985,38,14,24,36.84210526315789,63.1578947368421,Unisex
Lanell,1985,24,19,5,79.16666666666666,20.833333333333336,Unisex
Jan,1985,220,90,130,40.909090909090914,59.09090909090909,Unisex
Gisell,1986,6,6,0,100.0,0.0,Female
Amberly,1986,166,166,0,100.0,0.0,Female
Mey,1986,5,5,0,100.0,0.0,Female
Malaka,1986,8,8,0,100.0,0.0,Female
Era,1986,9,9,0,100.0,0.0,Female
Rashell,1986,34,34,0,100.0,0.0,Female
Danitza,1986,16,16,0,100.0,0.0,Female
Azalia,1986,17,17,0,100.0,0.0,Female
Chanetta,1986,5,5,0,100.0,0.0,Female
Kristel,1986,52,52,0,100.0,0.0,Female
Shanina,1986,11,11,0,100.0,0.0,Female
Laquia,1986,7,7,0,100.0,0.0,Female
Nelda,1986,8,8,0,100.0,0.0,Female
Roberta,1986,290,284,6,97.93103448275862,2.0689655172413794,Female
Macaria,1986,5,5,0,100.0,0.0,Female
Tasha,1986,1310,1302,8,99.38931297709924,0.6106870229007634,Female
Darci,1986,105,105,0,100.0,0.0,Female
Sherrelle,1986,21,21,0,100.0,0.0,Female
Sheritha,1986,5,5,0,100.0,0.0,Female
Daaiyah,1986,5,5,0,100.0,0.0,Female
Jaleen,1986,6,6,0,100.0,0.0,Female
Myishia,1986,7,7,0,100.0,0.0,Female
Chrystyna,1986,5,5,0,100.0,0.0,Female
Keia,1986,15,15,0,100.0,0.0,Female
Breona,1986,15,15,0,100.0,0.0,Female
Susan,1986,2407,2390,17,99.29372663066056,0.7062733693394266,Female
Randa,1986,62,62,0,100.0,0.0,Female
Nataleigh,1986,7,7,0,100.0,0.0,Female
Khadijah,1986,77,77,0,100.0,0.0,Female
Shenekia,1986,7,7,0,100.0,0.0,Female
Toran,1986,12,0,12,0.0,100.0,Male
Ishan,1986,5,0,5,0.0,100.0,Male
Owen,1986,407,0,407,0.0,100.0,Male
Mazen,1986,8,0,8,0.0,100.0,Male
Xavian,1986,6,0,6,0.0,100.0,Male
Jediah,1986,5,0,5,0.0,100.0,Male
Placido,1986,8,0,8,0.0,100.0,Male
Janson,1986,16,0,16,0.0,100.0,Male
Rahil,1986,5,0,5,0.0,100.0,Male
Linton,1986,20,0,20,0.0,100.0,Male
Elpidio,1986,11,0,11,0.0,100.0,Male
Javier,1986,1436,9,1427,0.6267409470752089,99.3732590529248,Male
Arther,1986,8,0,8,0.0,100.0,Male
Rodrecus,1986,7,0,7,0.0,100.0,Male
Ladarious,1986,5,0,5,0.0,100.0,Male
Kashmere,1986,6,0,6,0.0,100.0,Male
Durwin,1986,5,0,5,0.0,100.0,Male
Favian,1986,38,0,38,0.0,100.0,Male
Herschel,1986,46,0,46,0.0,100.0,Male
Brandun,1986,5,0,5,0.0,100.0,Male
Anousone,1986,5,0,5,0.0,100.0,Male
Panagiotis,1986,19,0,19,0.0,100.0,Male
Ayman,1986,7,0,7,0.0,100.0,Male
Najib,1986,6,0,6,0.0,100.0,Male
Baldemar,1986,28,0,28,0.0,100.0,Male
Rikin,1986,5,0,5,0.0,100.0,Male
Sylvestre,1986,9,0,9,0.0,100.0,Male
Torivio,1986,7,0,7,0.0,100.0,Male
Rajah,1986,5,0,5,0.0,100.0,Male
Tayron,1986,9,0,9,0.0,100.0,Male
Anjel,1986,17,10,7,58.82352941176471,41.17647058823529,Unisex
Che,1986,31,9,22,29.03225806451613,70.96774193548387,Unisex
Arrin,1986,11,6,5,54.54545454545454,45.45454545454545,Unisex
Dandrea,1986,24,16,8,66.66666666666666,33.33333333333333,Unisex
Nico,1986,15,5,10,33.33333333333333,66.66666666666666,Unisex
Amory,1986,16,8,8,50.0,50.0,Unisex
Kendel,1986,27,15,12,55.55555555555556,44.44444444444444,Unisex
Ryane,1986,19,14,5,73.68421052631578,26.31578947368421,Unisex
Sina,1986,20,12,8,60.0,40.0,Unisex
Elisha,1986,508,428,80,84.25196850393701,15.748031496062993,Unisex
Karan,1986,22,5,17,22.727272727272727,77.27272727272727,Unisex
Young,1986,45,13,32,28.88888888888889,71.11111111111111,Unisex
Lenell,1986,11,6,5,54.54545454545454,45.45454545454545,Unisex
Andree,1986,21,11,10,52.38095238095239,47.61904761904761,Unisex
Sloane,1986,37,30,7,81.08108108108108,18.91891891891892,Unisex
Hue,1986,14,6,8,42.85714285714285,57.14285714285714,Unisex
Semaj,1986,23,6,17,26.08695652173913,73.91304347826086,Unisex
Shoua,1986,28,19,9,67.85714285714286,32.142857142857146,Unisex
Channa,1986,32,27,5,84.375,15.625,Unisex
Chan,1986,38,14,24,36.84210526315789,63.1578947368421,Unisex
Shamel,1986,32,6,26,18.75,81.25,Unisex
Tristin,1986,93,57,36,61.29032258064516,38.70967741935484,Unisex
Brit,1986,22,7,15,31.818181818181817,68.18181818181817,Unisex
Isa,1986,24,12,12,50.0,50.0,Unisex
Remi,1986,21,11,10,52.38095238095239,47.61904761904761,Unisex
Shalin,1986,15,7,8,46.66666666666666,53.333333333333336,Unisex
Hoa,1986,30,15,15,50.0,50.0,Unisex
Lucero,1986,44,37,7,84.0909090909091,15.909090909090908,Unisex
Flynn,1986,18,7,11,38.88888888888889,61.11111111111112,Unisex
Cameo,1986,62,52,10,83.87096774193549,16.129032258064516,Unisex
Mikeshia,1987,7,7,0,100.0,0.0,Female
Onna,1987,5,5,0,100.0,0.0,Female
Cherryl,1987,7,7,0,100.0,0.0,Female
Nadina,1987,11,11,0,100.0,0.0,Female
Maude,1987,14,14,0,100.0,0.0,Female
Kennesha,1987,11,11,0,100.0,0.0,Female
Canesha,1987,8,8,0,100.0,0.0,Female
Ariann,1987,12,12,0,100.0,0.0,Female
Marshell,1987,10,10,0,100.0,0.0,Female
Cianna,1987,6,6,0,100.0,0.0,Female
Adelyn,1987,7,7,0,100.0,0.0,Female
Kiandra,1987,16,16,0,100.0,0.0,Female
Xochitl,1987,37,37,0,100.0,0.0,Female
Karaline,1987,5,5,0,100.0,0.0,Female
Lizet,1987,39,39,0,100.0,0.0,Female
Naida,1987,7,7,0,100.0,0.0,Female
Nakedra,1987,5,5,0,100.0,0.0,Female
Kortnee,1987,14,14,0,100.0,0.0,Female
Takeshia,1987,26,26,0,100.0,0.0,Female
Sheronda,1987,19,19,0,100.0,0.0,Female
Tineka,1987,7,7,0,100.0,0.0,Female
Deneice,1987,5,5,0,100.0,0.0,Female
Shereese,1987,6,6,0,100.0,0.0,Female
Sherrill,1987,16,16,0,100.0,0.0,Female
Lakenya,1987,43,43,0,100.0,0.0,Female
Elesha,1987,16,16,0,100.0,0.0,Female
Sheree,1987,185,185,0,100.0,0.0,Female
Vienna,1987,18,18,0,100.0,0.0,Female
Aubrie,1987,90,90,0,100.0,0.0,Female
Kaitlan,1987,29,29,0,100.0,0.0,Female
Tyshawn,1987,58,6,52,10.344827586206897,89.65517241379311,Male
Kamal,1987,46,0,46,0.0,100.0,Male
Aeron,1987,7,0,7,0.0,100.0,Male
Jabbar,1987,15,0,15,0.0,100.0,Male
Trevon,1987,61,0,61,0.0,100.0,Male
Garion,1987,8,0,8,0.0,100.0,Male
Kagen,1987,6,0,6,0.0,100.0,Male
Johny,1987,31,0,31,0.0,100.0,Male
Xai,1987,5,0,5,0.0,100.0,Male
Joeph,1987,6,0,6,0.0,100.0,Male
Shaw,1987,23,0,23,0.0,100.0,Male
Shakti,1987,5,0,5,0.0,100.0,Male
Jozef,1987,9,0,9,0.0,100.0,Male
Fidencio,1987,22,0,22,0.0,100.0,Male
Jihad,1987,35,0,35,0.0,100.0,Male
Averill,1987,13,0,13,0.0,100.0,Male
Stevens,1987,18,0,18,0.0,100.0,Male
Rockey,1987,6,0,6,0.0,100.0,Male
Irineo,1987,6,0,6,0.0,100.0,Male
Bronson,1987,181,0,181,0.0,100.0,Male
Kaheem,1987,10,0,10,0.0,100.0,Male
Swain,1987,10,0,10,0.0,100.0,Male
Mac,1987,37,0,37,0.0,100.0,Male
Deshon,1987,40,0,40,0.0,100.0,Male
Tj,1987,64,0,64,0.0,100.0,Male
Chauncey,1987,139,15,124,10.79136690647482,89.20863309352518,Male
Arthuro,1987,6,0,6,0.0,100.0,Male
Anthone,1987,5,0,5,0.0,100.0,Male
Manish,1987,10,0,10,0.0,100.0,Male
Jabril,1987,16,0,16,0.0,100.0,Male
Chancy,1987,23,8,15,34.78260869565217,65.21739130434783,Unisex
Dominigue,1987,27,19,8,70.37037037037037,29.629629629629623,Unisex
Kim,1987,356,280,76,78.65168539325843,21.34831460674157,Unisex
Hollis,1987,73,27,46,36.98630136986301,63.013698630136986,Unisex
Shalon,1987,35,28,7,80.0,20.0,Unisex
Kiran,1987,28,21,7,75.0,25.0,Unisex
Tamar,1987,112,90,22,80.35714285714286,19.642857142857142,Unisex
Lannie,1987,10,5,5,50.0,50.0,Unisex
Abiola,1987,11,6,5,54.54545454545454,45.45454545454545,Unisex
Kinsley,1987,24,19,5,79.16666666666666,20.833333333333336,Unisex
Allyn,1987,50,24,26,48.0,52.0,Unisex
Corian,1987,14,5,9,35.714285714285715,64.28571428571429,Unisex
Jovan,1987,249,48,201,19.27710843373494,80.72289156626506,Unisex
Mica,1987,50,42,8,84.0,16.0,Unisex
Jaime,1987,2291,1108,1183,48.36316019205587,51.63683980794412,Unisex
Rene,1987,891,184,707,20.65095398428732,79.34904601571269,Unisex
Aston,1987,26,9,17,34.61538461538461,65.38461538461539,Unisex
Dandra,1987,24,16,8,66.66666666666666,33.33333333333333,Unisex
Toy,1987,12,6,6,50.0,50.0,Unisex
Kelyn,1987,16,11,5,68.75,31.25,Unisex
Darby,1987,79,51,28,64.55696202531645,35.44303797468354,Unisex
Robbin,1987,42,26,16,61.90476190476191,38.095238095238095,Unisex
Aquila,1987,20,15,5,75.0,25.0,Unisex
Mandeep,1987,14,8,6,57.14285714285714,42.85714285714285,Unisex
Sloan,1987,55,23,32,41.81818181818181,58.18181818181818,Unisex
Haden,1987,21,5,16,23.809523809523807,76.19047619047619,Unisex
Lynden,1987,15,5,10,33.33333333333333,66.66666666666666,Unisex
Shondell,1987,11,6,5,54.54545454545454,45.45454545454545,Unisex
Paris,1987,487,315,172,64.68172484599589,35.318275154004105,Unisex
Rhyan,1987,32,16,16,50.0,50.0,Unisex
Jalaine,1988,5,5,0,100.0,0.0,Female
Vallie,1988,5,5,0,100.0,0.0,Female
Olga,1988,260,255,5,98.07692307692308,1.9230769230769231,Female
Hollee,1988,19,19,0,100.0,0.0,Female
Lajoi,1988,5,5,0,100.0,0.0,Female
Secret,1988,7,7,0,100.0,0.0,Female
Shamarra,1988,6,6,0,100.0,0.0,Female
Jakita,1988,13,13,0,100.0,0.0,Female
Honesty,1988,9,9,0,100.0,0.0,Female
Mariama,1988,9,9,0,100.0,0.0,Female
Carmesha,1988,10,10,0,100.0,0.0,Female
Tanecia,1988,12,12,0,100.0,0.0,Female
Daiana,1988,8,8,0,100.0,0.0,Female
Khristin,1988,8,8,0,100.0,0.0,Female
Jaqlyn,1988,7,7,0,100.0,0.0,Female
Jolanda,1988,15,15,0,100.0,0.0,Female
Allisia,1988,5,5,0,100.0,0.0,Female
Darnesha,1988,21,21,0,100.0,0.0,Female
Yanira,1988,94,94,0,100.0,0.0,Female
Dawna,1988,42,42,0,100.0,0.0,Female
Malee,1988,9,9,0,100.0,0.0,Female
Jannel,1988,14,14,0,100.0,0.0,Female
Kristin,1988,6046,6019,27,99.55342375124047,0.4465762487595104,Female
Deliah,1988,6,6,0,100.0,0.0,Female
Charnetta,1988,6,6,0,100.0,0.0,Female
Trenna,1988,7,7,0,100.0,0.0,Female
Johniece,1988,7,7,0,100.0,0.0,Female
Eleasha,1988,5,5,0,100.0,0.0,Female
Tanielle,1988,11,11,0,100.0,0.0,Female
Myisha,1988,60,60,0,100.0,0.0,Female
Elpidio,1988,12,0,12,0.0,100.0,Male
Lesean,1988,12,0,12,0.0,100.0,Male
Jguadalupe,1988,5,0,5,0.0,100.0,Male
Florentino,1988,24,0,24,0.0,100.0,Male
Dao,1988,7,0,7,0.0,100.0,Male
Labrandon,1988,11,0,11,0.0,100.0,Male
Ever,1988,24,0,24,0.0,100.0,Male
Detron,1988,8,0,8,0.0,100.0,Male
Graeme,1988,22,0,22,0.0,100.0,Male
Casper,1988,15,0,15,0.0,100.0,Male
Niccolas,1988,5,0,5,0.0,100.0,Male
Yasir,1988,10,0,10,0.0,100.0,Male
Jafet,1988,6,0,6,0.0,100.0,Male
Achilles,1988,6,0,6,0.0,100.0,Male
Romeo,1988,95,0,95,0.0,100.0,Male
Uriel,1988,142,6,136,4.225352112676056,95.77464788732394,Male
Shiv,1988,8,0,8,0.0,100.0,Male
Dawan,1988,17,0,17,0.0,100.0,Male
Karl,1988,866,23,843,2.655889145496536,97.34411085450348,Male
Johnross,1988,6,0,6,0.0,100.0,Male
Terel,1988,8,0,8,0.0,100.0,Male
Gordon,1988,463,0,463,0.0,100.0,Male
Duong,1988,6,0,6,0.0,100.0,Male
Arrow,1988,6,0,6,0.0,100.0,Male
Saber,1988,6,0,6,0.0,100.0,Male
Feliz,1988,8,0,8,0.0,100.0,Male
Armin,1988,20,0,20,0.0,100.0,Male
Jatavius,1988,5,0,5,0.0,100.0,Male
Dontaye,1988,10,0,10,0.0,100.0,Male
Ronn,1988,6,0,6,0.0,100.0,Male
Devon,1988,1883,443,1440,23.526287838555497,76.47371216144451,Unisex
Sina,1988,23,10,13,43.47826086956522,56.52173913043478,Unisex
Talin,1988,13,8,5,61.53846153846154,38.46153846153847,Unisex
Kelcey,1988,87,67,20,77.01149425287356,22.988505747126435,Unisex
Sol,1988,21,11,10,52.38095238095239,47.61904761904761,Unisex
Sena,1988,22,17,5,77.27272727272727,22.727272727272727,Unisex
Casey,1988,7187,3149,4038,43.81522192848198,56.18477807151802,Unisex
Kalin,1988,75,31,44,41.333333333333336,58.66666666666666,Unisex
Jontae,1988,24,13,11,54.16666666666666,45.83333333333333,Unisex
Haven,1988,43,23,20,53.48837209302325,46.51162790697674,Unisex
Pasha,1988,17,11,6,64.70588235294117,35.294117647058826,Unisex
Jori,1988,47,38,9,80.85106382978722,19.148936170212767,Unisex
Chane,1988,12,7,5,58.333333333333336,41.66666666666667,Unisex
Brittan,1988,49,28,21,57.14285714285714,42.85714285714285,Unisex
Kenyatta,1988,146,112,34,76.71232876712328,23.28767123287671,Unisex
Paris,1988,471,293,178,62.20806794055201,37.79193205944799,Unisex
Yuri,1988,128,98,30,76.5625,23.4375,Unisex
Ferris,1988,17,6,11,35.294117647058826,64.70588235294117,Unisex
Charly,1988,59,46,13,77.96610169491525,22.033898305084744,Unisex
Jasman,1988,19,14,5,73.68421052631578,26.31578947368421,Unisex
Hue,1988,13,7,6,53.84615384615385,46.15384615384615,Unisex
Sheridan,1988,67,36,31,53.73134328358209,46.26865671641791,Unisex
Kodi,1988,121,64,57,52.89256198347108,47.10743801652893,Unisex
Deandrea,1988,125,94,31,75.2,24.8,Unisex
Keagan,1988,33,7,26,21.21212121212121,78.78787878787878,Unisex
Simran,1988,17,12,5,70.58823529411765,29.411764705882355,Unisex
Corrie,1988,152,128,24,84.21052631578947,15.789473684210526,Unisex
Anjel,1988,11,6,5,54.54545454545454,45.45454545454545,Unisex
Alexius,1988,10,5,5,50.0,50.0,Unisex
Koda,1988,13,5,8,38.46153846153847,61.53846153846154,Unisex
Shontrice,1989,5,5,0,100.0,0.0,Female
Meghann,1989,142,142,0,100.0,0.0,Female
Sandra,1989,2371,2327,44,98.14424293547026,1.8557570645297343,Female
Kortny,1989,5,5,0,100.0,0.0,Female
Saralee,1989,6,6,0,100.0,0.0,Female
Digna,1989,12,12,0,100.0,0.0,Female
Zuleica,1989,7,7,0,100.0,0.0,Female
Ambera,1989,5,5,0,100.0,0.0,Female
Bobi,1989,15,15,0,100.0,0.0,Female
Airel,1989,9,9,0,100.0,0.0,Female
Sheri,1989,187,187,0,100.0,0.0,Female
Anahi,1989,73,73,0,100.0,0.0,Female
Ahuva,1989,10,10,0,100.0,0.0,Female
Kaneshia,1989,27,27,0,100.0,0.0,Female
Antanisha,1989,6,6,0,100.0,0.0,Female
Chasmine,1989,7,7,0,100.0,0.0,Female
Coleen,1989,72,72,0,100.0,0.0,Female
Rashanda,1989,29,29,0,100.0,0.0,Female
Charlye,1989,6,6,0,100.0,0.0,Female
Capria,1989,10,10,0,100.0,0.0,Female
Rockell,1989,9,9,0,100.0,0.0,Female
Jenafer,1989,5,5,0,100.0,0.0,Female
Yetta,1989,5,5,0,100.0,0.0,Female
Shaquoia,1989,5,5,0,100.0,0.0,Female
Thy,1989,5,5,0,100.0,0.0,Female
Sana,1989,77,77,0,100.0,0.0,Female
Jalea,1989,6,6,0,100.0,0.0,Female
Dayana,1989,57,57,0,100.0,0.0,Female
Tamar,1989,120,105,15,87.5,12.5,Female
Belva,1989,6,6,0,100.0,0.0,Female
Ante,1989,8,0,8,0.0,100.0,Male
Travious,1989,9,0,9,0.0,100.0,Male
Seth,1989,3645,11,3634,0.3017832647462277,99.69821673525378,Male
Maxton,1989,7,0,7,0.0,100.0,Male
Georgemichael,1989,6,0,6,0.0,100.0,Male
Cong,1989,5,0,5,0.0,100.0,Male
Jerwin,1989,5,0,5,0.0,100.0,Male
Panagiotis,1989,27,0,27,0.0,100.0,Male
Chetan,1989,12,0,12,0.0,100.0,Male
Curvin,1989,8,0,8,0.0,100.0,Male
Chase,1989,2903,37,2866,1.2745435756114365,98.72545642438855,Male
Ezra,1989,188,0,188,0.0,100.0,Male
Wesam,1989,10,0,10,0.0,100.0,Male
Quade,1989,11,0,11,0.0,100.0,Male
Alejandr,1989,8,0,8,0.0,100.0,Male
Sher,1989,10,0,10,0.0,100.0,Male
Tajh,1989,65,0,65,0.0,100.0,Male
Bashar,1989,8,0,8,0.0,100.0,Male
Travone,1989,8,0,8,0.0,100.0,Male
Lenell,1989,6,0,6,0.0,100.0,Male
Tyerell,1989,6,0,6,0.0,100.0,Male
Jerrald,1989,8,0,8,0.0,100.0,Male
Tysen,1989,16,0,16,0.0,100.0,Male
Tyon,1989,8,0,8,0.0,100.0,Male
Wagner,1989,9,0,9,0.0,100.0,Male
Khang,1989,23,0,23,0.0,100.0,Male
Dray,1989,9,0,9,0.0,100.0,Male
Darvis,1989,17,0,17,0.0,100.0,Male
Dex,1989,13,0,13,0.0,100.0,Male
Kelvis,1989,12,0,12,0.0,100.0,Male
Haven,1989,50,37,13,74.0,26.0,Unisex
Canaan,1989,32,6,26,18.75,81.25,Unisex
Tari,1989,16,11,5,68.75,31.25,Unisex
Frankie,1989,488,119,369,24.385245901639344,75.61475409836066,Unisex
Darcel,1989,17,11,6,64.70588235294117,35.294117647058826,Unisex
Jarae,1989,14,8,6,57.14285714285714,42.85714285714285,Unisex
Kalei,1989,26,21,5,80.76923076923077,19.23076923076924,Unisex
Kendal,1989,221,104,117,47.05882352941176,52.94117647058824,Unisex
Riley,1989,844,169,675,20.023696682464458,79.97630331753555,Unisex
Jasdeep,1989,15,8,7,53.333333333333336,46.66666666666666,Unisex
Aarion,1989,19,6,13,31.57894736842105,68.42105263157895,Unisex
Dayle,1989,23,16,7,69.56521739130434,30.434782608695656,Unisex
Maika,1989,14,8,6,57.14285714285714,42.85714285714285,Unisex
Montana,1989,165,92,73,55.757575757575765,44.24242424242424,Unisex
Martice,1989,18,5,13,27.77777777777778,72.22222222222221,Unisex
Concepcion,1989,42,32,10,76.19047619047619,23.809523809523807,Unisex
Arie,1989,33,14,19,42.42424242424242,57.57575757575758,Unisex
Kayle,1989,124,101,23,81.45161290322581,18.548387096774192,Unisex
Deshay,1989,17,8,9,47.05882352941176,52.94117647058824,Unisex
Charley,1989,110,63,47,57.27272727272727,42.72727272727273,Unisex
Kiante,1989,11,5,6,45.45454545454545,54.54545454545454,Unisex
Brighton,1989,11,5,6,45.45454545454545,54.54545454545454,Unisex
Hollis,1989,80,39,41,48.75,51.24999999999999,Unisex
Amari,1989,23,16,7,69.56521739130434,30.434782608695656,Unisex
Dee,1989,47,33,14,70.2127659574468,29.78723404255319,Unisex
Allex,1989,11,6,5,54.54545454545454,45.45454545454545,Unisex
Terren,1989,29,11,18,37.93103448275862,62.06896551724138,Unisex
Shilo,1989,44,28,16,63.63636363636363,36.36363636363637,Unisex
Ryen,1989,41,10,31,24.390243902439025,75.60975609756098,Unisex
Faron,1989,25,6,19,24.0,76.0,Unisex
Sachiko,1990,5,5,0,100.0,0.0,Female
Catrice,1990,27,27,0,100.0,0.0,Female
Leeah,1990,18,18,0,100.0,0.0,Female
Nhu,1990,12,12,0,100.0,0.0,Female
Phyllicia,1990,9,9,0,100.0,0.0,Female
Denisse,1990,143,143,0,100.0,0.0,Female
Jelicia,1990,15,15,0,100.0,0.0,Female
Monika,1990,257,257,0,100.0,0.0,Female
Anntoinette,1990,10,10,0,100.0,0.0,Female
Meagan,1990,2536,2530,6,99.76340694006308,0.2365930599369085,Female
Beatrice,1990,290,290,0,100.0,0.0,Female
Sharalyn,1990,5,5,0,100.0,0.0,Female
Joann,1990,312,312,0,100.0,0.0,Female
Jetaime,1990,5,5,0,100.0,0.0,Female
Kemesha,1990,11,11,0,100.0,0.0,Female
Raynesha,1990,15,15,0,100.0,0.0,Female
Juliane,1990,29,29,0,100.0,0.0,Female
Denisia,1990,10,10,0,100.0,0.0,Female
Searra,1990,11,11,0,100.0,0.0,Female
Kelita,1990,11,11,0,100.0,0.0,Female
Nikkia,1990,37,37,0,100.0,0.0,Female
Sabreen,1990,11,11,0,100.0,0.0,Female
Isley,1990,5,5,0,100.0,0.0,Female
Stefania,1990,39,39,0,100.0,0.0,Female
Maida,1990,10,10,0,100.0,0.0,Female
Takeya,1990,15,15,0,100.0,0.0,Female
Karina,1990,1572,1562,10,99.36386768447836,0.6361323155216284,Female
Laurelyn,1990,5,5,0,100.0,0.0,Female
Simi,1990,9,9,0,100.0,0.0,Female
Keirra,1990,49,49,0,100.0,0.0,Female
Viren,1990,5,0,5,0.0,100.0,Male
Armondo,1990,26,0,26,0.0,100.0,Male
Dell,1990,21,0,21,0.0,100.0,Male
Skip,1990,7,0,7,0.0,100.0,Male
Daimon,1990,11,0,11,0.0,100.0,Male
Kenrick,1990,36,0,36,0.0,100.0,Male
Jamal,1990,1124,12,1112,1.0676156583629894,98.93238434163702,Male
Niklaus,1990,7,0,7,0.0,100.0,Male
Everett,1990,331,0,331,0.0,100.0,Male
Travonne,1990,7,0,7,0.0,100.0,Male
Sederick,1990,7,0,7,0.0,100.0,Male
Jusitn,1990,8,0,8,0.0,100.0,Male
Javonte,1990,53,0,53,0.0,100.0,Male
Kawon,1990,11,0,11,0.0,100.0,Male
Marckus,1990,5,0,5,0.0,100.0,Male
Kush,1990,11,0,11,0.0,100.0,Male
Travin,1990,9,0,9,0.0,100.0,Male
Levelle,1990,10,0,10,0.0,100.0,Male
Undra,1990,10,0,10,0.0,100.0,Male
Thaer,1990,5,0,5,0.0,100.0,Male
Tyrel,1990,119,0,119,0.0,100.0,Male
Sayyid,1990,7,0,7,0.0,100.0,Male
Kalab,1990,12,0,12,0.0,100.0,Male
Darae,1990,6,0,6,0.0,100.0,Male
Kenton,1990,139,0,139,0.0,100.0,Male
Shafiq,1990,6,0,6,0.0,100.0,Male
Xavion,1990,7,0,7,0.0,100.0,Male
Toddrick,1990,15,0,15,0.0,100.0,Male
Herberth,1990,9,0,9,0.0,100.0,Male
Carrick,1990,5,0,5,0.0,100.0,Male
Shi,1990,11,6,5,54.54545454545454,45.45454545454545,Unisex
Mackenzy,1990,14,7,7,50.0,50.0,Unisex
Corby,1990,20,6,14,30.0,70.0,Unisex
Skylar,1990,867,419,448,48.32756632064591,51.67243367935409,Unisex
Amel,1990,12,5,7,41.66666666666667,58.333333333333336,Unisex
Jasmon,1990,24,17,7,70.83333333333334,29.166666666666668,Unisex
Sharone,1990,15,10,5,66.66666666666666,33.33333333333333,Unisex
Larkin,1990,25,13,12,52.0,48.0,Unisex
Bao,1990,72,46,26,63.888888888888886,36.11111111111111,Unisex
Nevada,1990,33,14,19,42.42424242424242,57.57575757575758,Unisex
Britton,1990,146,25,121,17.123287671232877,82.87671232876713,Unisex
Jia,1990,13,7,6,53.84615384615385,46.15384615384615,Unisex
Jean,1990,622,265,357,42.60450160771704,57.39549839228296,Unisex
Aarin,1990,23,10,13,43.47826086956522,56.52173913043478,Unisex
Marquette,1990,61,19,42,31.14754098360656,68.85245901639344,Unisex
Aries,1990,36,24,12,66.66666666666666,33.33333333333333,Unisex
Sherron,1990,32,17,15,53.125,46.875,Unisex
Arden,1990,39,25,14,64.1025641025641,35.8974358974359,Unisex
Mitchelle,1990,36,21,15,58.333333333333336,41.66666666666667,Unisex
Andrian,1990,23,7,16,30.434782608695656,69.56521739130434,Unisex
Brecken,1990,19,11,8,57.89473684210527,42.10526315789473,Unisex
Nai,1990,14,9,5,64.28571428571429,35.714285714285715,Unisex
Dominique,1990,3431,1946,1485,56.7181579714369,43.2818420285631,Unisex
Micki,1990,28,21,7,75.0,25.0,Unisex
Danel,1990,17,11,6,64.70588235294117,35.294117647058826,Unisex
Micah,1990,1392,212,1180,15.229885057471265,84.77011494252874,Unisex
Jamey,1990,114,45,69,39.47368421052632,60.526315789473685,Unisex
Etienne,1990,23,7,16,30.434782608695656,69.56521739130434,Unisex
Reshawn,1990,17,6,11,35.294117647058826,64.70588235294117,Unisex
Kendre,1990,15,5,10,33.33333333333333,66.66666666666666,Unisex
Pakou,1991,13,13,0,100.0,0.0,Female
Gracen,1991,5,5,0,100.0,0.0,Female
Cali,1991,122,122,0,100.0,0.0,Female
Hettie,1991,5,5,0,100.0,0.0,Female
Kashima,1991,6,6,0,100.0,0.0,Female
Jeneffer,1991,7,7,0,100.0,0.0,Female
Vania,1991,69,69,0,100.0,0.0,Female
Mone,1991,25,25,0,100.0,0.0,Female
Tangela,1991,50,50,0,100.0,0.0,Female
Matilda,1991,29,29,0,100.0,0.0,Female
Laquaya,1991,5,5,0,100.0,0.0,Female
Hindy,1991,14,14,0,100.0,0.0,Female
Charlene,1991,531,531,0,100.0,0.0,Female
Whitlie,1991,5,5,0,100.0,0.0,Female
Sheriann,1991,5,5,0,100.0,0.0,Female
Kalley,1991,16,16,0,100.0,0.0,Female
Onyx,1991,6,6,0,100.0,0.0,Female
Jesusita,1991,11,11,0,100.0,0.0,Female
Kendi,1991,9,9,0,100.0,0.0,Female
Elyana,1991,6,6,0,100.0,0.0,Female
Kieanna,1991,8,8,0,100.0,0.0,Female
Sabah,1991,14,14,0,100.0,0.0,Female
Elyssa,1991,191,191,0,100.0,0.0,Female
Laisha,1991,16,16,0,100.0,0.0,Female
Haliegh,1991,9,9,0,100.0,0.0,Female
Falesha,1991,8,8,0,100.0,0.0,Female
Marleen,1991,27,27,0,100.0,0.0,Female
Kristeen,1991,14,14,0,100.0,0.0,Female
Leeor,1991,5,5,0,100.0,0.0,Female
Ashlinn,1991,5,5,0,100.0,0.0,Female
Evans,1991,39,0,39,0.0,100.0,Male
Antawan,1991,8,0,8,0.0,100.0,Male
Korbin,1991,49,0,49,0.0,100.0,Male
Thurman,1991,41,0,41,0.0,100.0,Male
Leith,1991,8,0,8,0.0,100.0,Male
Helio,1991,6,0,6,0.0,100.0,Male
Jamesmichael,1991,13,0,13,0.0,100.0,Male
Derrik,1991,102,0,102,0.0,100.0,Male
Naaman,1991,13,0,13,0.0,100.0,Male
Johnpatrick,1991,10,0,10,0.0,100.0,Male
Khadeem,1991,13,0,13,0.0,100.0,Male
Corney,1991,6,0,6,0.0,100.0,Male
Daris,1991,32,0,32,0.0,100.0,Male
Anibal,1991,74,0,74,0.0,100.0,Male
Alastair,1991,14,0,14,0.0,100.0,Male
Aedan,1991,5,0,5,0.0,100.0,Male
Kwashawn,1991,5,0,5,0.0,100.0,Male
Keldrick,1991,28,0,28,0.0,100.0,Male
Bertram,1991,31,0,31,0.0,100.0,Male
Shondell,1991,9,0,9,0.0,100.0,Male
Ysidro,1991,10,0,10,0.0,100.0,Male
Nickalus,1991,12,0,12,0.0,100.0,Male
Ridge,1991,98,0,98,0.0,100.0,Male
Ericberto,1991,8,0,8,0.0,100.0,Male
Lamond,1991,10,0,10,0.0,100.0,Male
Sherard,1991,18,0,18,0.0,100.0,Male
Mattias,1991,11,0,11,0.0,100.0,Male
Shakeel,1991,23,0,23,0.0,100.0,Male
Newman,1991,5,0,5,0.0,100.0,Male
Deondrae,1991,13,0,13,0.0,100.0,Male
Skyler,1991,1105,224,881,20.27149321266968,79.72850678733032,Unisex
Torrie,1991,92,74,18,80.43478260869566,19.565217391304348,Unisex
Jan,1991,142,41,101,28.87323943661972,71.12676056338029,Unisex
Tommie,1991,176,37,139,21.02272727272728,78.97727272727273,Unisex
Kim,1991,267,207,60,77.52808988764045,22.47191011235955,Unisex
San,1991,30,13,17,43.333333333333336,56.66666666666666,Unisex
Kace,1991,12,7,5,58.333333333333336,41.66666666666667,Unisex
Shadoe,1991,18,7,11,38.88888888888889,61.11111111111112,Unisex
Camryn,1991,55,29,26,52.72727272727272,47.27272727272727,Unisex
Jacky,1991,61,11,50,18.0327868852459,81.9672131147541,Unisex
Arie,1991,46,15,31,32.608695652173914,67.3913043478261,Unisex
Charly,1991,51,37,14,72.54901960784314,27.450980392156865,Unisex
Keshawn,1991,68,17,51,25.0,75.0,Unisex
Desi,1991,39,7,32,17.94871794871795,82.05128205128204,Unisex
Noa,1991,15,7,8,46.66666666666666,53.333333333333336,Unisex
Da,1991,29,14,15,48.27586206896552,51.72413793103448,Unisex
Tristyn,1991,17,12,5,70.58823529411765,29.411764705882355,Unisex
Thanh,1991,64,29,35,45.3125,54.6875,Unisex
Kaelin,1991,56,33,23,58.92857142857143,41.07142857142857,Unisex
Valentine,1991,45,13,32,28.88888888888889,71.11111111111111,Unisex
Cary,1991,176,34,142,19.318181818181817,80.68181818181817,Unisex
Rossi,1991,13,7,6,53.84615384615385,46.15384615384615,Unisex
Terez,1991,25,7,18,28.000000000000004,72.0,Unisex
Jaquise,1991,12,7,5,58.333333333333336,41.66666666666667,Unisex
Mychael,1991,65,11,54,16.923076923076923,83.07692307692308,Unisex
Deshae,1991,25,17,8,68.0,32.0,Unisex
Shiloh,1991,107,63,44,58.87850467289719,41.1214953271028,Unisex
Victory,1991,18,10,8,55.55555555555556,44.44444444444444,Unisex
Stephane,1991,58,28,30,48.27586206896552,51.72413793103448,Unisex
Shaya,1991,34,18,16,52.94117647058824,47.05882352941176,Unisex
Laporsha,1992,66,66,0,100.0,0.0,Female
Charlena,1992,18,18,0,100.0,0.0,Female
Jaquasha,1992,5,5,0,100.0,0.0,Female
Victorya,1992,15,15,0,100.0,0.0,Female
Britini,1992,22,22,0,100.0,0.0,Female
Dianna,1992,297,292,5,98.31649831649833,1.6835016835016834,Female
Allecia,1992,7,7,0,100.0,0.0,Female
Marymargaret,1992,16,16,0,100.0,0.0,Female
Tonja,1992,24,24,0,100.0,0.0,Female
Joleesa,1992,5,5,0,100.0,0.0,Female
Emilyn,1992,8,8,0,100.0,0.0,Female
Canisha,1992,13,13,0,100.0,0.0,Female
Cloie,1992,6,6,0,100.0,0.0,Female
Latesa,1992,8,8,0,100.0,0.0,Female
Carie,1992,20,20,0,100.0,0.0,Female
Talia,1992,498,498,0,100.0,0.0,Female
Rayneisha,1992,8,8,0,100.0,0.0,Female
Analleli,1992,8,8,0,100.0,0.0,Female
Dilia,1992,7,7,0,100.0,0.0,Female
Janellie,1992,5,5,0,100.0,0.0,Female
Yana,1992,12,12,0,100.0,0.0,Female
Keturah,1992,96,96,0,100.0,0.0,Female
Shelby,1992,9849,9396,453,95.4005482790131,4.599451720986902,Female
Maricela,1992,318,318,0,100.0,0.0,Female
Marquitta,1992,27,27,0,100.0,0.0,Female
Estefanie,1992,16,16,0,100.0,0.0,Female
Chantia,1992,14,14,0,100.0,0.0,Female
Tyeasha,1992,17,17,0,100.0,0.0,Female
Zea,1992,5,5,0,100.0,0.0,Female
Phylicia,1992,133,133,0,100.0,0.0,Female
Dondray,1992,6,0,6,0.0,100.0,Male
Lamone,1992,6,0,6,0.0,100.0,Male
Milford,1992,12,0,12,0.0,100.0,Male
Adison,1992,12,0,12,0.0,100.0,Male
Henrik,1992,9,0,9,0.0,100.0,Male
Tylerjames,1992,5,0,5,0.0,100.0,Male
Bobby,1992,1408,21,1387,1.4914772727272727,98.50852272727272,Male
Nehemiah,1992,94,0,94,0.0,100.0,Male
Jamichael,1992,47,0,47,0.0,100.0,Male
Devanti,1992,5,0,5,0.0,100.0,Male
Hamlet,1992,7,0,7,0.0,100.0,Male
Lauro,1992,38,0,38,0.0,100.0,Male
Dylin,1992,26,0,26,0.0,100.0,Male
Takeru,1992,5,0,5,0.0,100.0,Male
Jovan,1992,281,24,257,8.540925266903916,91.45907473309607,Male
Donta,1992,124,0,124,0.0,100.0,Male
Humza,1992,13,0,13,0.0,100.0,Male
Sven,1992,25,0,25,0.0,100.0,Male
Nathanal,1992,6,0,6,0.0,100.0,Male
Markos,1992,14,0,14,0.0,100.0,Male
Yasser,1992,12,0,12,0.0,100.0,Male
Dennie,1992,8,0,8,0.0,100.0,Male
Elam,1992,28,0,28,0.0,100.0,Male
Aerik,1992,6,0,6,0.0,100.0,Male
Deshun,1992,29,0,29,0.0,100.0,Male
Jehad,1992,6,0,6,0.0,100.0,Male
Tyreke,1992,18,0,18,0.0,100.0,Male
Marcin,1992,17,0,17,0.0,100.0,Male
Dewayne,1992,247,0,247,0.0,100.0,Male
Assad,1992,6,0,6,0.0,100.0,Male
Layne,1992,147,66,81,44.89795918367347,55.10204081632652,Unisex
Darriel,1992,15,7,8,46.66666666666666,53.333333333333336,Unisex
Davian,1992,39,6,33,15.384615384615383,84.61538461538461,Unisex
Deshannon,1992,14,6,8,42.85714285714285,57.14285714285714,Unisex
Breon,1992,111,20,91,18.01801801801802,81.98198198198197,Unisex
Dashay,1992,23,16,7,69.56521739130434,30.434782608695656,Unisex
Sherron,1992,29,17,12,58.620689655172406,41.37931034482759,Unisex
Gentry,1992,71,29,42,40.845070422535215,59.15492957746479,Unisex
Azriel,1992,16,5,11,31.25,68.75,Unisex
Yovani,1992,26,6,20,23.07692307692308,76.92307692307693,Unisex
Tamaris,1992,11,5,6,45.45454545454545,54.54545454545454,Unisex
Arshia,1992,10,5,5,50.0,50.0,Unisex
Elin,1992,18,13,5,72.22222222222221,27.77777777777778,Unisex
Mickie,1992,21,12,9,57.14285714285714,42.85714285714285,Unisex
Kashawn,1992,37,6,31,16.216216216216218,83.78378378378379,Unisex
Jaquel,1992,23,11,12,47.82608695652174,52.17391304347826,Unisex
Jalan,1992,31,6,25,19.35483870967742,80.64516129032258,Unisex
Avon,1992,14,5,9,35.714285714285715,64.28571428571429,Unisex
Isa,1992,49,26,23,53.06122448979592,46.93877551020408,Unisex
Latrelle,1992,11,6,5,54.54545454545454,45.45454545454545,Unisex
Ching,1992,14,5,9,35.714285714285715,64.28571428571429,Unisex
Austyn,1992,95,40,55,42.10526315789473,57.89473684210527,Unisex
Michale,1992,33,7,26,21.21212121212121,78.78787878787878,Unisex
Jackie,1992,578,363,215,62.80276816608996,37.19723183391003,Unisex
Mykell,1992,19,7,12,36.84210526315789,63.1578947368421,Unisex
Rio,1992,78,44,34,56.41025641025641,43.58974358974359,Unisex
Deondrea,1992,13,7,6,53.84615384615385,46.15384615384615,Unisex
Jaiden,1992,11,6,5,54.54545454545454,45.45454545454545,Unisex
Michel,1992,131,46,85,35.11450381679389,64.8854961832061,Unisex
Halston,1992,31,9,22,29.03225806451613,70.96774193548387,Unisex
Rainie,1993,6,6,0,100.0,0.0,Female
Sameera,1993,12,12,0,100.0,0.0,Female
Shatia,1993,38,38,0,100.0,0.0,Female
Desteny,1993,26,26,0,100.0,0.0,Female
Ikeia,1993,6,6,0,100.0,0.0,Female
Ambrianna,1993,7,7,0,100.0,0.0,Female
Linnea,1993,118,118,0,100.0,0.0,Female
Camaria,1993,6,6,0,100.0,0.0,Female
Shoua,1993,16,16,0,100.0,0.0,Female
Ivone,1993,10,10,0,100.0,0.0,Female
Takeyia,1993,5,5,0,100.0,0.0,Female
Thomasina,1993,21,21,0,100.0,0.0,Female
Larenda,1993,5,5,0,100.0,0.0,Female
Kyeisha,1993,16,16,0,100.0,0.0,Female
Kjirsten,1993,5,5,0,100.0,0.0,Female
Asialyn,1993,5,5,0,100.0,0.0,Female
Chesnee,1993,6,6,0,100.0,0.0,Female
Mckinsey,1993,30,30,0,100.0,0.0,Female
Dream,1993,8,8,0,100.0,0.0,Female
Raena,1993,17,17,0,100.0,0.0,Female
Shanythia,1993,7,7,0,100.0,0.0,Female
Biannca,1993,7,7,0,100.0,0.0,Female
Anuja,1993,6,6,0,100.0,0.0,Female
Alyxandra,1993,50,50,0,100.0,0.0,Female
Kourtney,1993,558,542,16,97.1326164874552,2.867383512544803,Female
Sherae,1993,6,6,0,100.0,0.0,Female
Lottie,1993,22,22,0,100.0,0.0,Female
Banna,1993,5,5,0,100.0,0.0,Female
Rosella,1993,12,12,0,100.0,0.0,Female
Meshell,1993,6,6,0,100.0,0.0,Female
Omarr,1993,7,0,7,0.0,100.0,Male
Kipp,1993,24,0,24,0.0,100.0,Male
Shaheed,1993,47,0,47,0.0,100.0,Male
Quindarius,1993,11,0,11,0.0,100.0,Male
Jouse,1993,5,0,5,0.0,100.0,Male
Lucas,1993,3922,0,3922,0.0,100.0,Male
Pernell,1993,29,0,29,0.0,100.0,Male
Ediberto,1993,8,0,8,0.0,100.0,Male
Fredrick,1993,354,0,354,0.0,100.0,Male
Desten,1993,5,0,5,0.0,100.0,Male
Chayim,1993,8,0,8,0.0,100.0,Male
Allexander,1993,7,0,7,0.0,100.0,Male
Landan,1993,14,0,14,0.0,100.0,Male
Gasper,1993,9,0,9,0.0,100.0,Male
Yoon,1993,6,0,6,0.0,100.0,Male
Arrion,1993,7,0,7,0.0,100.0,Male
Rapheal,1993,23,0,23,0.0,100.0,Male
Shareef,1993,26,0,26,0.0,100.0,Male
William,1993,22258,42,22216,0.1886961991194177,99.81130380088058,Male
Cordale,1993,16,0,16,0.0,100.0,Male
Johnjoseph,1993,9,0,9,0.0,100.0,Male
Onix,1993,6,0,6,0.0,100.0,Male
Nijal,1993,5,0,5,0.0,100.0,Male
Cordel,1993,13,0,13,0.0,100.0,Male
Erron,1993,14,0,14,0.0,100.0,Male
Byron,1993,739,0,739,0.0,100.0,Male
Davine,1993,5,0,5,0.0,100.0,Male
Kalub,1993,18,0,18,0.0,100.0,Male
Davante,1993,120,0,120,0.0,100.0,Male
Tyrees,1993,6,0,6,0.0,100.0,Male
Chaise,1993,32,6,26,18.75,81.25,Unisex
Kareen,1993,38,19,19,50.0,50.0,Unisex
Lou,1993,24,10,14,41.66666666666667,58.333333333333336,Unisex
Deondra,1993,77,61,16,79.22077922077922,20.77922077922078,Unisex
Kendahl,1993,17,12,5,70.58823529411765,29.411764705882355,Unisex
Krishna,1993,63,38,25,60.31746031746032,39.68253968253968,Unisex
Jonell,1993,23,18,5,78.26086956521739,21.73913043478261,Unisex
Shandell,1993,25,19,6,76.0,24.0,Unisex
Lunden,1993,18,11,7,61.11111111111112,38.88888888888889,Unisex
Navdeep,1993,17,8,9,47.05882352941176,52.94117647058824,Unisex
Ryen,1993,30,10,20,33.33333333333333,66.66666666666666,Unisex
Jayd,1993,21,13,8,61.90476190476191,38.095238095238095,Unisex
Tracy,1993,1033,737,296,71.34559535333979,28.65440464666021,Unisex
Ashton,1993,1506,792,714,52.589641434262944,47.410358565737056,Unisex
Shevon,1993,14,7,7,50.0,50.0,Unisex
Taylen,1993,20,7,13,35.0,65.0,Unisex
London,1993,240,132,108,55.00000000000001,45.0,Unisex
Brittin,1993,11,5,6,45.45454545454545,54.54545454545454,Unisex
Terran,1993,55,23,32,41.81818181818181,58.18181818181818,Unisex
Infantof,1993,32,15,17,46.875,53.125,Unisex
Chue,1993,27,5,22,18.51851851851852,81.48148148148148,Unisex
Perris,1993,21,6,15,28.57142857142857,71.42857142857143,Unisex
Taylon,1993,24,6,18,25.0,75.0,Unisex
Keyontae,1993,11,5,6,45.45454545454545,54.54545454545454,Unisex
Noor,1993,113,96,17,84.95575221238938,15.04424778761062,Unisex
Jaden,1993,187,69,118,36.898395721925134,63.10160427807487,Unisex
Maison,1993,33,8,25,24.24242424242424,75.75757575757575,Unisex
Harley,1993,1445,718,727,49.688581314878896,50.31141868512111,Unisex
Adair,1993,27,14,13,51.85185185185185,48.14814814814815,Unisex
Omega,1993,18,12,6,66.66666666666666,33.33333333333333,Unisex
Corrinn,1994,5,5,0,100.0,0.0,Female
Liliya,1994,9,9,0,100.0,0.0,Female
Blia,1994,5,5,0,100.0,0.0,Female
Varsha,1994,14,14,0,100.0,0.0,Female
Lianne,1994,34,34,0,100.0,0.0,Female
Teira,1994,10,10,0,100.0,0.0,Female
Jamilyn,1994,14,14,0,100.0,0.0,Female
Deslyn,1994,5,5,0,100.0,0.0,Female
Chastine,1994,9,9,0,100.0,0.0,Female
Kestrel,1994,6,6,0,100.0,0.0,Female
Gracyn,1994,5,5,0,100.0,0.0,Female
Mandelyn,1994,5,5,0,100.0,0.0,Female
Tisheena,1994,5,5,0,100.0,0.0,Female
Saralynn,1994,9,9,0,100.0,0.0,Female
Theodora,1994,49,49,0,100.0,0.0,Female
Viridiana,1994,204,204,0,100.0,0.0,Female
Branda,1994,18,18,0,100.0,0.0,Female
Salwa,1994,15,15,0,100.0,0.0,Female
Payge,1994,26,26,0,100.0,0.0,Female
Layci,1994,7,7,0,100.0,0.0,Female
Darrah,1994,20,20,0,100.0,0.0,Female
Dezerae,1994,22,22,0,100.0,0.0,Female
Hortencia,1994,22,22,0,100.0,0.0,Female
Delina,1994,16,16,0,100.0,0.0,Female
Sumar,1994,7,7,0,100.0,0.0,Female
Kierney,1994,8,8,0,100.0,0.0,Female
Laryssa,1994,35,35,0,100.0,0.0,Female
Nicole,1994,16051,16012,39,99.7570244844558,0.2429755155442028,Female
Kinjal,1994,6,6,0,100.0,0.0,Female
Dayan,1994,6,6,0,100.0,0.0,Female
Edis,1994,7,0,7,0.0,100.0,Male
Niels,1994,14,0,14,0.0,100.0,Male
Ajamu,1994,6,0,6,0.0,100.0,Male
Ivo,1994,5,0,5,0.0,100.0,Male
Mauro,1994,79,0,79,0.0,100.0,Male
Kortland,1994,6,0,6,0.0,100.0,Male
Casimiro,1994,6,0,6,0.0,100.0,Male
Shakar,1994,5,0,5,0.0,100.0,Male
Petar,1994,9,0,9,0.0,100.0,Male
Audie,1994,11,0,11,0.0,100.0,Male
Deontez,1994,7,0,7,0.0,100.0,Male
Fabio,1994,82,0,82,0.0,100.0,Male
Dequinn,1994,5,0,5,0.0,100.0,Male
Constantinos,1994,19,0,19,0.0,100.0,Male
Karthik,1994,24,0,24,0.0,100.0,Male
Bonifacio,1994,11,0,11,0.0,100.0,Male
Paras,1994,11,0,11,0.0,100.0,Male
Giuliano,1994,16,0,16,0.0,100.0,Male
Raydell,1994,9,0,9,0.0,100.0,Male
Shariq,1994,6,0,6,0.0,100.0,Male
Asian,1994,5,0,5,0.0,100.0,Male
Joseth,1994,5,0,5,0.0,100.0,Male
Javares,1994,5,0,5,0.0,100.0,Male
Boy,1994,24,0,24,0.0,100.0,Male
Bryant,1994,880,5,875,0.5681818181818182,99.43181818181816,Male
Quadry,1994,9,0,9,0.0,100.0,Male
Ilir,1994,8,0,8,0.0,100.0,Male
Taku,1994,5,0,5,0.0,100.0,Male
Maximillian,1994,149,0,149,0.0,100.0,Male
Trai,1994,23,0,23,0.0,100.0,Male
Tarin,1994,38,21,17,55.26315789473685,44.73684210526316,Unisex
Jimmi,1994,12,6,6,50.0,50.0,Unisex
Avory,1994,11,6,5,54.54545454545454,45.45454545454545,Unisex
Tonie,1994,30,25,5,83.33333333333334,16.666666666666664,Unisex
Roshawn,1994,34,8,26,23.52941176470588,76.47058823529412,Unisex
My,1994,31,23,8,74.19354838709677,25.806451612903224,Unisex
Kimani,1994,88,25,63,28.40909090909091,71.5909090909091,Unisex
Kellin,1994,16,6,10,37.5,62.5,Unisex
Antonie,1994,19,6,13,31.57894736842105,68.42105263157895,Unisex
Mikale,1994,18,6,12,33.33333333333333,66.66666666666666,Unisex
Harley,1994,1647,858,789,52.09471766848816,47.90528233151184,Unisex
Kristain,1994,15,9,6,60.0,40.0,Unisex
Dallis,1994,29,12,17,41.37931034482759,58.620689655172406,Unisex
Mykel,1994,82,24,58,29.268292682926827,70.73170731707317,Unisex
Britain,1994,29,5,24,17.24137931034483,82.75862068965517,Unisex
Chevon,1994,13,6,7,46.15384615384615,53.84615384615385,Unisex
Brion,1994,61,14,47,22.950819672131143,77.04918032786885,Unisex
Darian,1994,1544,869,675,56.28238341968912,43.71761658031088,Unisex
Kiva,1994,13,8,5,61.53846153846154,38.46153846153847,Unisex
Germany,1994,16,8,8,50.0,50.0,Unisex
Davy,1994,23,6,17,26.08695652173913,73.91304347826086,Unisex
Talor,1994,43,36,7,83.72093023255815,16.27906976744186,Unisex
Javonne,1994,22,13,9,59.09090909090909,40.909090909090914,Unisex
Jaqua,1994,22,8,14,36.36363636363637,63.63636363636363,Unisex
Nasim,1994,17,6,11,35.294117647058826,64.70588235294117,Unisex
Chauncey,1994,135,23,112,17.037037037037038,82.96296296296296,Unisex
Krystian,1994,57,22,35,38.59649122807017,61.40350877192983,Unisex
Azariah,1994,33,12,21,36.36363636363637,63.63636363636363,Unisex
Shaye,1994,61,51,10,83.60655737704919,16.39344262295082,Unisex
Wylie,1994,30,9,21,30.0,70.0,Unisex
Jocie,1995,7,7,0,100.0,0.0,Female
Aspen,1995,372,322,50,86.55913978494624,13.440860215053762,Female
Dally,1995,5,5,0,100.0,0.0,Female
Laurice,1995,9,9,0,100.0,0.0,Female
Inocencia,1995,5,5,0,100.0,0.0,Female
Kaitlin,1995,3612,3602,10,99.72314507198227,0.2768549280177187,Female
Taraya,1995,5,5,0,100.0,0.0,Female
Logann,1995,15,15,0,100.0,0.0,Female
Ashna,1995,12,12,0,100.0,0.0,Female
Brittanyann,1995,13,13,0,100.0,0.0,Female
Louisa,1995,96,96,0,100.0,0.0,Female
Adalhi,1995,5,5,0,100.0,0.0,Female
Adria,1995,66,66,0,100.0,0.0,Female
Kayle,1995,144,127,17,88.19444444444444,11.805555555555555,Female
Takiya,1995,14,14,0,100.0,0.0,Female
Serra,1995,29,29,0,100.0,0.0,Female
Kirstian,1995,5,5,0,100.0,0.0,Female
Michealla,1995,6,6,0,100.0,0.0,Female
Elisabeth,1995,701,701,0,100.0,0.0,Female
Aaisha,1995,9,9,0,100.0,0.0,Female
Destinae,1995,5,5,0,100.0,0.0,Female
Trini,1995,16,16,0,100.0,0.0,Female
Shandricka,1995,6,6,0,100.0,0.0,Female
Anjelica,1995,223,223,0,100.0,0.0,Female
Ambreanna,1995,5,5,0,100.0,0.0,Female
Brettney,1995,10,10,0,100.0,0.0,Female
Tyrika,1995,10,10,0,100.0,0.0,Female
Cindel,1995,5,5,0,100.0,0.0,Female
Teandra,1995,8,8,0,100.0,0.0,Female
Sherece,1995,7,7,0,100.0,0.0,Female
Virgil,1995,96,0,96,0.0,100.0,Male
Chauncey,1995,118,5,113,4.23728813559322,95.76271186440678,Male
Amaury,1995,17,0,17,0.0,100.0,Male
Ashkon,1995,7,0,7,0.0,100.0,Male
Quamel,1995,9,0,9,0.0,100.0,Male
Octaviano,1995,7,0,7,0.0,100.0,Male
Alexandr,1995,12,0,12,0.0,100.0,Male
Baldemar,1995,33,0,33,0.0,100.0,Male
Dontavius,1995,41,0,41,0.0,100.0,Male
Dalas,1995,8,0,8,0.0,100.0,Male
Wilberth,1995,5,0,5,0.0,100.0,Male
Nicolaas,1995,17,0,17,0.0,100.0,Male
Ioane,1995,5,0,5,0.0,100.0,Male
Hazen,1995,10,0,10,0.0,100.0,Male
Jamill,1995,7,0,7,0.0,100.0,Male
Lamark,1995,7,0,7,0.0,100.0,Male
Jequan,1995,25,0,25,0.0,100.0,Male
Duc,1995,13,0,13,0.0,100.0,Male
Haseeb,1995,11,0,11,0.0,100.0,Male
Dartavius,1995,6,0,6,0.0,100.0,Male
Quontavious,1995,7,0,7,0.0,100.0,Male
Orion,1995,175,7,168,4.0,96.0,Male
Roby,1995,14,0,14,0.0,100.0,Male
Vu,1995,12,0,12,0.0,100.0,Male
Keldon,1995,16,0,16,0.0,100.0,Male
Todd,1995,1028,0,1028,0.0,100.0,Male
Darrel,1995,84,0,84,0.0,100.0,Male
Avelardo,1995,11,0,11,0.0,100.0,Male
Marcal,1995,5,0,5,0.0,100.0,Male
Quinten,1995,224,0,224,0.0,100.0,Male
Callan,1995,57,42,15,73.68421052631578,26.31578947368421,Unisex
Nicky,1995,58,23,35,39.6551724137931,60.3448275862069,Unisex
Daylin,1995,37,14,23,37.83783783783784,62.16216216216216,Unisex
Shaunessy,1995,13,8,5,61.53846153846154,38.46153846153847,Unisex
Jamile,1995,12,6,6,50.0,50.0,Unisex
Lynn,1995,256,211,45,82.421875,17.578125,Unisex
Krishna,1995,72,40,32,55.55555555555556,44.44444444444444,Unisex
Kary,1995,29,22,7,75.86206896551724,24.13793103448276,Unisex
Sloan,1995,95,54,41,56.84210526315789,43.15789473684211,Unisex
Justis,1995,123,37,86,30.08130081300813,69.91869918699187,Unisex
Zuri,1995,66,50,16,75.75757575757575,24.24242424242424,Unisex
Avis,1995,22,16,6,72.72727272727273,27.27272727272727,Unisex
Shalom,1995,32,7,25,21.875,78.125,Unisex
Rayne,1995,86,63,23,73.25581395348837,26.744186046511626,Unisex
Cary,1995,109,22,87,20.18348623853211,79.81651376146789,Unisex
Sami,1995,96,22,74,22.916666666666664,77.08333333333334,Unisex
Braylin,1995,25,5,20,20.0,80.0,Unisex
Demaree,1995,10,5,5,50.0,50.0,Unisex
San,1995,20,7,13,35.0,65.0,Unisex
Dominique,1995,3196,2278,918,71.27659574468085,28.72340425531916,Unisex
Karee,1995,18,10,8,55.55555555555556,44.44444444444444,Unisex
Jorey,1995,17,9,8,52.94117647058824,47.05882352941176,Unisex
Briley,1995,54,38,16,70.37037037037037,29.629629629629623,Unisex
Desi,1995,25,11,14,44.0,56.00000000000001,Unisex
Shay,1995,289,160,129,55.36332179930796,44.636678200692046,Unisex
Aquarius,1995,17,12,5,70.58823529411765,29.411764705882355,Unisex
Tian,1995,14,7,7,50.0,50.0,Unisex
Marlin,1995,135,21,114,15.555555555555555,84.44444444444444,Unisex
Kalani,1995,70,43,27,61.42857142857143,38.57142857142858,Unisex
Kristain,1995,20,8,12,40.0,60.0,Unisex
Shalina,1996,12,12,0,100.0,0.0,Female
Meilani,1996,10,10,0,100.0,0.0,Female
Aleana,1996,10,10,0,100.0,0.0,Female
Adryanna,1996,8,8,0,100.0,0.0,Female
Tykia,1996,32,32,0,100.0,0.0,Female
Jailah,1996,11,11,0,100.0,0.0,Female
Livia,1996,40,40,0,100.0,0.0,Female
Miya,1996,104,104,0,100.0,0.0,Female
Dayzha,1996,15,15,0,100.0,0.0,Female
Maciel,1996,8,8,0,100.0,0.0,Female
Catina,1996,13,13,0,100.0,0.0,Female
Jaela,1996,40,40,0,100.0,0.0,Female
Marlenn,1996,6,6,0,100.0,0.0,Female
Arnelle,1996,28,28,0,100.0,0.0,Female
Alayshia,1996,6,6,0,100.0,0.0,Female
Laesha,1996,5,5,0,100.0,0.0,Female
Calee,1996,12,12,0,100.0,0.0,Female
Jennavieve,1996,5,5,0,100.0,0.0,Female
Loan,1996,10,10,0,100.0,0.0,Female
Alegra,1996,10,10,0,100.0,0.0,Female
Tymia,1996,18,18,0,100.0,0.0,Female
Manahil,1996,5,5,0,100.0,0.0,Female
Johanny,1996,8,8,0,100.0,0.0,Female
Zelia,1996,8,8,0,100.0,0.0,Female
Shakilya,1996,5,5,0,100.0,0.0,Female
Elodia,1996,15,15,0,100.0,0.0,Female
Ayanna,1996,337,337,0,100.0,0.0,Female
Laniesha,1996,11,11,0,100.0,0.0,Female
Jazzman,1996,19,19,0,100.0,0.0,Female
Stephanny,1996,10,10,0,100.0,0.0,Female
Demariae,1996,5,0,5,0.0,100.0,Male
Johnpaul,1996,94,0,94,0.0,100.0,Male
Danner,1996,9,0,9,0.0,100.0,Male
Evans,1996,23,0,23,0.0,100.0,Male
Octavian,1996,17,0,17,0.0,100.0,Male
Kennan,1996,35,5,30,14.285714285714285,85.71428571428571,Male
Dustan,1996,32,0,32,0.0,100.0,Male
Tiago,1996,23,0,23,0.0,100.0,Male
Kiwan,1996,9,0,9,0.0,100.0,Male
Taryll,1996,5,0,5,0.0,100.0,Male
Chaim,1996,162,0,162,0.0,100.0,Male
Elie,1996,20,0,20,0.0,100.0,Male
Daqwan,1996,17,0,17,0.0,100.0,Male
Osten,1996,7,0,7,0.0,100.0,Male
Jontrell,1996,8,0,8,0.0,100.0,Male
Bryse,1996,7,0,7,0.0,100.0,Male
Hale,1996,9,0,9,0.0,100.0,Male
Raekwon,1996,451,6,445,1.3303769401330376,98.66962305986696,Male
Ketan,1996,9,0,9,0.0,100.0,Male
Francisco,1996,2827,16,2811,0.5659709939865581,99.43402900601345,Male
Dquan,1996,17,0,17,0.0,100.0,Male
Logan,1996,9471,1097,8374,11.582726216872558,88.41727378312744,Male
Tysen,1996,22,0,22,0.0,100.0,Male
Siddiq,1996,9,0,9,0.0,100.0,Male
Ambrosio,1996,8,0,8,0.0,100.0,Male
Antino,1996,5,0,5,0.0,100.0,Male
Delray,1996,5,0,5,0.0,100.0,Male
Raequan,1996,63,0,63,0.0,100.0,Male
Chukwuemeka,1996,18,0,18,0.0,100.0,Male
Erol,1996,6,0,6,0.0,100.0,Male
Kodi,1996,182,75,107,41.2087912087912,58.7912087912088,Unisex
Aman,1996,44,8,36,18.181818181818183,81.81818181818183,Unisex
Jadyn,1996,74,59,15,79.72972972972973,20.27027027027027,Unisex
Nikola,1996,56,15,41,26.785714285714285,73.21428571428571,Unisex
Schyler,1996,97,66,31,68.04123711340206,31.95876288659793,Unisex
Cobi,1996,33,5,28,15.151515151515152,84.84848484848484,Unisex
Jammie,1996,45,27,18,60.0,40.0,Unisex
Kallen,1996,27,11,16,40.74074074074074,59.25925925925925,Unisex
Demetrice,1996,37,8,29,21.62162162162162,78.37837837837837,Unisex
Jalyn,1996,207,133,74,64.25120772946859,35.7487922705314,Unisex
Alexy,1996,20,12,8,60.0,40.0,Unisex
Raylin,1996,14,9,5,64.28571428571429,35.714285714285715,Unisex
Najee,1996,180,37,143,20.55555555555556,79.44444444444444,Unisex
Misha,1996,69,56,13,81.15942028985508,18.84057971014493,Unisex
Daryn,1996,78,34,44,43.58974358974359,56.41025641025641,Unisex
Sage,1996,648,337,311,52.00617283950617,47.99382716049383,Unisex
Jourdain,1996,25,5,20,20.0,80.0,Unisex
Scout,1996,67,38,29,56.71641791044776,43.28358208955223,Unisex
Kendall,1996,2144,1468,676,68.47014925373134,31.529850746268657,Unisex
Robbin,1996,25,17,8,68.0,32.0,Unisex
Adi,1996,17,11,6,64.70588235294117,35.294117647058826,Unisex
Jaz,1996,16,9,7,56.25,43.75,Unisex
Kendel,1996,50,30,20,60.0,40.0,Unisex
Kelby,1996,147,50,97,34.01360544217687,65.98639455782312,Unisex
Briar,1996,105,22,83,20.95238095238096,79.04761904761905,Unisex
Daylin,1996,37,12,25,32.432432432432435,67.56756756756756,Unisex
Chayne,1996,18,9,9,50.0,50.0,Unisex
Emory,1996,106,35,71,33.0188679245283,66.98113207547169,Unisex
Chong,1996,19,5,14,26.31578947368421,73.68421052631578,Unisex
Sinai,1996,33,28,5,84.84848484848484,15.151515151515152,Unisex
Antania,1997,15,15,0,100.0,0.0,Female
Tziporah,1997,15,15,0,100.0,0.0,Female
Faythe,1997,23,23,0,100.0,0.0,Female
Kirsta,1997,8,8,0,100.0,0.0,Female
Anahi,1997,375,375,0,100.0,0.0,Female
Aleeyah,1997,22,22,0,100.0,0.0,Female
Ysabel,1997,23,23,0,100.0,0.0,Female
Anelise,1997,13,13,0,100.0,0.0,Female
Mileena,1997,41,41,0,100.0,0.0,Female
Kriti,1997,7,7,0,100.0,0.0,Female
Mansi,1997,17,17,0,100.0,0.0,Female
Anabel,1997,164,164,0,100.0,0.0,Female
Toriana,1997,22,22,0,100.0,0.0,Female
Lismarie,1997,5,5,0,100.0,0.0,Female
Shakira,1997,382,382,0,100.0,0.0,Female
Marketta,1997,8,8,0,100.0,0.0,Female
Shaylynn,1997,75,75,0,100.0,0.0,Female
Jahne,1997,10,10,0,100.0,0.0,Female
Joely,1997,69,69,0,100.0,0.0,Female
Tenaja,1997,7,7,0,100.0,0.0,Female
Kahli,1997,7,7,0,100.0,0.0,Female
Brylie,1997,9,9,0,100.0,0.0,Female
Lakaysha,1997,5,5,0,100.0,0.0,Female
Joei,1997,7,7,0,100.0,0.0,Female
Alberta,1997,31,31,0,100.0,0.0,Female
Daphney,1997,19,19,0,100.0,0.0,Female
Mahala,1997,50,50,0,100.0,0.0,Female
Jonesha,1997,15,15,0,100.0,0.0,Female
Karizma,1997,27,27,0,100.0,0.0,Female
Analysia,1997,9,9,0,100.0,0.0,Female
Spencer,1997,3881,115,3766,2.963153826333419,97.03684617366658,Male
Jarques,1997,5,0,5,0.0,100.0,Male
Richar,1997,5,0,5,0.0,100.0,Male
Delmar,1997,30,0,30,0.0,100.0,Male
Zev,1997,50,0,50,0.0,100.0,Male
Nijel,1997,9,0,9,0.0,100.0,Male
Wil,1997,25,0,25,0.0,100.0,Male
Witt,1997,5,0,5,0.0,100.0,Male
Nafis,1997,18,0,18,0.0,100.0,Male
Kasaun,1997,11,0,11,0.0,100.0,Male
Darragh,1997,6,0,6,0.0,100.0,Male
Kenn,1997,5,0,5,0.0,100.0,Male
Stevin,1997,9,0,9,0.0,100.0,Male
Konstantin,1997,7,0,7,0.0,100.0,Male
Webb,1997,7,0,7,0.0,100.0,Male
Washington,1997,9,0,9,0.0,100.0,Male
Damien,1997,907,0,907,0.0,100.0,Male
Georgio,1997,14,0,14,0.0,100.0,Male
Markus,1997,330,0,330,0.0,100.0,Male
Nikolaos,1997,29,0,29,0.0,100.0,Male
Vic,1997,12,0,12,0.0,100.0,Male
Polo,1997,14,0,14,0.0,100.0,Male
Ramel,1997,39,0,39,0.0,100.0,Male
Jadarius,1997,75,0,75,0.0,100.0,Male
Sadonte,1997,6,0,6,0.0,100.0,Male
Selvin,1997,24,0,24,0.0,100.0,Male
Giovanni,1997,1310,29,1281,2.213740458015267,97.78625954198472,Male
Kaileb,1997,16,0,16,0.0,100.0,Male
Romen,1997,6,0,6,0.0,100.0,Male
Jahquel,1997,5,0,5,0.0,100.0,Male
Karol,1997,39,30,9,76.92307692307693,23.07692307692308,Unisex
Storme,1997,14,6,8,42.85714285714285,57.14285714285714,Unisex
Goldie,1997,37,31,6,83.78378378378379,16.216216216216218,Unisex
Rayne,1997,96,63,33,65.625,34.375,Unisex
Karrington,1997,24,13,11,54.16666666666666,45.83333333333333,Unisex
Darrien,1997,169,31,138,18.34319526627219,81.65680473372781,Unisex
Brighton,1997,49,16,33,32.6530612244898,67.3469387755102,Unisex
Aren,1997,73,20,53,27.3972602739726,72.6027397260274,Unisex
Britain,1997,13,7,6,53.84615384615385,46.15384615384615,Unisex
Zakiah,1997,16,10,6,62.5,37.5,Unisex
Landry,1997,56,23,33,41.07142857142857,58.92857142857143,Unisex
Addison,1997,890,530,360,59.55056179775281,40.44943820224719,Unisex
Blaize,1997,37,7,30,18.91891891891892,81.08108108108108,Unisex
Jaymie,1997,66,56,10,84.84848484848484,15.151515151515152,Unisex
Jourdain,1997,12,5,7,41.66666666666667,58.333333333333336,Unisex
Terin,1997,17,11,6,64.70588235294117,35.294117647058826,Unisex
Austyn,1997,290,47,243,16.206896551724135,83.79310344827586,Unisex
Reegan,1997,14,8,6,57.14285714285714,42.85714285714285,Unisex
Mychal,1997,37,12,25,32.432432432432435,67.56756756756756,Unisex
Kessler,1997,17,5,12,29.411764705882355,70.58823529411765,Unisex
Lael,1997,26,20,6,76.92307692307693,23.07692307692308,Unisex
Tommie,1997,106,29,77,27.358490566037734,72.64150943396226,Unisex
Onyx,1997,29,12,17,41.37931034482759,58.620689655172406,Unisex
Avory,1997,19,8,11,42.10526315789473,57.89473684210527,Unisex
Wisdom,1997,17,9,8,52.94117647058824,47.05882352941176,Unisex
Payden,1997,46,14,32,30.434782608695656,69.56521739130434,Unisex
Yeng,1997,25,8,17,32.0,68.0,Unisex
Neema,1997,24,8,16,33.33333333333333,66.66666666666666,Unisex
Jakai,1997,34,11,23,32.35294117647059,67.64705882352942,Unisex
Amari,1997,471,322,149,68.36518046709129,31.634819532908704,Unisex
Keeli,1998,31,31,0,100.0,0.0,Female
Rhegan,1998,7,7,0,100.0,0.0,Female
Jadia,1998,9,9,0,100.0,0.0,Female
Keela,1998,9,9,0,100.0,0.0,Female
Aloria,1998,6,6,0,100.0,0.0,Female
Monasia,1998,11,11,0,100.0,0.0,Female
Njeri,1998,12,12,0,100.0,0.0,Female
Dashiah,1998,5,5,0,100.0,0.0,Female
Lucretia,1998,21,21,0,100.0,0.0,Female
Ripley,1998,20,20,0,100.0,0.0,Female
Kamara,1998,31,31,0,100.0,0.0,Female
Alee,1998,13,13,0,100.0,0.0,Female
Brinesha,1998,5,5,0,100.0,0.0,Female
Lashawna,1998,21,21,0,100.0,0.0,Female
Allisa,1998,56,56,0,100.0,0.0,Female
Sana,1998,104,104,0,100.0,0.0,Female
Zarina,1998,17,17,0,100.0,0.0,Female
Abbie,1998,398,398,0,100.0,0.0,Female
Ayauna,1998,9,9,0,100.0,0.0,Female
Aaniyah,1998,8,8,0,100.0,0.0,Female
Lejla,1998,21,21,0,100.0,0.0,Female
Tonya,1998,141,141,0,100.0,0.0,Female
Aanchal,1998,7,7,0,100.0,0.0,Female
Zitlally,1998,6,6,0,100.0,0.0,Female
Dnae,1998,8,8,0,100.0,0.0,Female
Teagen,1998,9,9,0,100.0,0.0,Female
Kharis,1998,5,5,0,100.0,0.0,Female
Imonie,1998,7,7,0,100.0,0.0,Female
Agigail,1998,5,5,0,100.0,0.0,Female
Sarha,1998,8,8,0,100.0,0.0,Female
Gerson,1998,85,0,85,0.0,100.0,Male
Joequan,1998,7,0,7,0.0,100.0,Male
Tizoc,1998,5,0,5,0.0,100.0,Male
Isaiahs,1998,9,0,9,0.0,100.0,Male
Masahiro,1998,9,0,9,0.0,100.0,Male
Mikey,1998,17,0,17,0.0,100.0,Male
Victormanuel,1998,12,0,12,0.0,100.0,Male
Nasir,1998,165,0,165,0.0,100.0,Male
Jamone,1998,7,0,7,0.0,100.0,Male
Jovian,1998,9,0,9,0.0,100.0,Male
Neilson,1998,7,0,7,0.0,100.0,Male
Sajan,1998,6,0,6,0.0,100.0,Male
Keneth,1998,9,0,9,0.0,100.0,Male
Wayd,1998,5,0,5,0.0,100.0,Male
Deondrae,1998,9,0,9,0.0,100.0,Male
Luisfernando,1998,15,0,15,0.0,100.0,Male
Turon,1998,5,0,5,0.0,100.0,Male
Lincoln,1998,165,0,165,0.0,100.0,Male
Ameen,1998,36,0,36,0.0,100.0,Male
Brinden,1998,6,0,6,0.0,100.0,Male
Edmundo,1998,51,0,51,0.0,100.0,Male
Chayan,1998,5,0,5,0.0,100.0,Male
Giovani,1998,119,0,119,0.0,100.0,Male
Niel,1998,6,0,6,0.0,100.0,Male
Kentarius,1998,5,0,5,0.0,100.0,Male
Oswald,1998,16,0,16,0.0,100.0,Male
Daelen,1998,8,0,8,0.0,100.0,Male
Breyon,1998,13,0,13,0.0,100.0,Male
Josejuan,1998,5,0,5,0.0,100.0,Male
Demarko,1998,13,0,13,0.0,100.0,Male
Carroll,1998,27,12,15,44.44444444444444,55.55555555555556,Unisex
Harper,1998,132,93,39,70.45454545454545,29.545454545454547,Unisex
Zyaire,1998,19,7,12,36.84210526315789,63.1578947368421,Unisex
Ramey,1998,21,13,8,61.90476190476191,38.095238095238095,Unisex
Waverly,1998,35,27,8,77.14285714285715,22.857142857142858,Unisex
Bayley,1998,172,112,60,65.11627906976744,34.88372093023256,Unisex
Cashmere,1998,25,20,5,80.0,20.0,Unisex
Breon,1998,68,15,53,22.058823529411764,77.94117647058823,Unisex
Bentley,1998,47,16,31,34.04255319148936,65.95744680851064,Unisex
Cristin,1998,44,37,7,84.0909090909091,15.909090909090908,Unisex
Talor,1998,45,33,12,73.33333333333333,26.666666666666668,Unisex
Koree,1998,18,10,8,55.55555555555556,44.44444444444444,Unisex
Corin,1998,41,28,13,68.29268292682927,31.70731707317073,Unisex
Noa,1998,106,76,30,71.69811320754717,28.30188679245283,Unisex
Austine,1998,14,6,8,42.85714285714285,57.14285714285714,Unisex
Quinlan,1998,103,17,86,16.50485436893204,83.49514563106796,Unisex
Jakai,1998,22,5,17,22.727272727272727,77.27272727272727,Unisex
Mekiah,1998,13,6,7,46.15384615384615,53.84615384615385,Unisex
Tabor,1998,40,8,32,20.0,80.0,Unisex
Tamari,1998,16,8,8,50.0,50.0,Unisex
Miciah,1998,20,12,8,60.0,40.0,Unisex
Kacy,1998,109,88,21,80.73394495412845,19.26605504587156,Unisex
Adama,1998,21,13,8,61.90476190476191,38.095238095238095,Unisex
Mcclain,1998,14,5,9,35.714285714285715,64.28571428571429,Unisex
Crosby,1998,19,12,7,63.1578947368421,36.84210526315789,Unisex
Jerri,1998,45,38,7,84.44444444444444,15.555555555555555,Unisex
Desi,1998,30,9,21,30.0,70.0,Unisex
Ki,1998,19,6,13,31.57894736842105,68.42105263157895,Unisex
Keiran,1998,30,6,24,20.0,80.0,Unisex
Michale,1998,34,7,27,20.588235294117645,79.41176470588235,Unisex
Auria,1999,9,9,0,100.0,0.0,Female
Destynie,1999,24,24,0,100.0,0.0,Female
Kassi,1999,62,62,0,100.0,0.0,Female
Grisel,1999,22,22,0,100.0,0.0,Female
Brisa,1999,105,105,0,100.0,0.0,Female
Talesha,1999,12,12,0,100.0,0.0,Female
Sureena,1999,5,5,0,100.0,0.0,Female
Nyeemah,1999,6,6,0,100.0,0.0,Female
Cathrine,1999,34,34,0,100.0,0.0,Female
Katierra,1999,5,5,0,100.0,0.0,Female
Takira,1999,48,48,0,100.0,0.0,Female
Allexis,1999,27,27,0,100.0,0.0,Female
Caroline,1999,4480,4474,6,99.86607142857142,0.1339285714285714,Female
Waad,1999,7,7,0,100.0,0.0,Female
Merriam,1999,5,5,0,100.0,0.0,Female
Mckinsey,1999,33,33,0,100.0,0.0,Female
Marli,1999,38,38,0,100.0,0.0,Female
Kaela,1999,323,323,0,100.0,0.0,Female
Rickiya,1999,6,6,0,100.0,0.0,Female
Torilynn,1999,5,5,0,100.0,0.0,Female
Shealyn,1999,52,52,0,100.0,0.0,Female
Latavia,1999,120,120,0,100.0,0.0,Female
Deira,1999,6,6,0,100.0,0.0,Female
Kelsi,1999,330,330,0,100.0,0.0,Female
Mallary,1999,27,27,0,100.0,0.0,Female
Matti,1999,17,17,0,100.0,0.0,Female
Miriya,1999,5,5,0,100.0,0.0,Female
Rebbecca,1999,20,20,0,100.0,0.0,Female
Saraya,1999,33,33,0,100.0,0.0,Female
Daijana,1999,6,6,0,100.0,0.0,Female
Javontae,1999,63,0,63,0.0,100.0,Male
Gael,1999,12,0,12,0.0,100.0,Male
Sudeep,1999,9,0,9,0.0,100.0,Male
Brendyn,1999,58,0,58,0.0,100.0,Male
Jaspal,1999,5,0,5,0.0,100.0,Male
Christion,1999,96,0,96,0.0,100.0,Male
Sederick,1999,5,0,5,0.0,100.0,Male
Obie,1999,5,0,5,0.0,100.0,Male
Denis,1999,110,11,99,10.0,90.0,Male
Fulton,1999,12,0,12,0.0,100.0,Male
Feliciano,1999,31,0,31,0.0,100.0,Male
Kelten,1999,6,0,6,0.0,100.0,Male
Voshon,1999,12,0,12,0.0,100.0,Male
Santosh,1999,7,0,7,0.0,100.0,Male
Brynt,1999,6,0,6,0.0,100.0,Male
Kanen,1999,11,0,11,0.0,100.0,Male
Hank,1999,56,0,56,0.0,100.0,Male
Luis,1999,7243,32,7211,0.441805881540798,99.5581941184592,Male
Zakee,1999,20,0,20,0.0,100.0,Male
Irfan,1999,15,0,15,0.0,100.0,Male
Sayvion,1999,7,0,7,0.0,100.0,Male
Shammond,1999,11,0,11,0.0,100.0,Male
Grantham,1999,10,0,10,0.0,100.0,Male
Derron,1999,23,0,23,0.0,100.0,Male
Mosiah,1999,12,0,12,0.0,100.0,Male
Donnel,1999,5,0,5,0.0,100.0,Male
Simeon,1999,157,0,157,0.0,100.0,Male
Kenderius,1999,6,0,6,0.0,100.0,Male
Jovany,1999,150,0,150,0.0,100.0,Male
Kodey,1999,25,0,25,0.0,100.0,Male
Kamerin,1999,29,17,12,58.620689655172406,41.37931034482759,Unisex
Jammie,1999,41,19,22,46.34146341463415,53.65853658536586,Unisex
Breck,1999,29,13,16,44.82758620689656,55.172413793103445,Unisex
Matisse,1999,24,17,7,70.83333333333334,29.166666666666668,Unisex
Tai,1999,136,40,96,29.411764705882355,70.58823529411765,Unisex
Casey,1999,3845,1802,2043,46.86605981794538,53.133940182054616,Unisex
Mekel,1999,15,5,10,33.33333333333333,66.66666666666666,Unisex
Chika,1999,17,12,5,70.58823529411765,29.411764705882355,Unisex
Bao,1999,21,5,16,23.809523809523807,76.19047619047619,Unisex
Riley,1999,5282,2312,2970,43.771298750473306,56.22870124952669,Unisex
Torey,1999,81,27,54,33.33333333333333,66.66666666666666,Unisex
Graeson,1999,15,5,10,33.33333333333333,66.66666666666666,Unisex
Hannan,1999,23,13,10,56.52173913043478,43.47826086956522,Unisex
Rayne,1999,99,80,19,80.8080808080808,19.19191919191919,Unisex
Charon,1999,15,10,5,66.66666666666666,33.33333333333333,Unisex
Daniell,1999,33,22,11,66.66666666666666,33.33333333333333,Unisex
Rio,1999,79,39,40,49.36708860759494,50.63291139240506,Unisex
Chandler,1999,2842,447,2395,15.7283603096411,84.2716396903589,Unisex
Addison,1999,1213,795,418,65.53998351195384,34.46001648804617,Unisex
Corin,1999,56,35,21,62.5,37.5,Unisex
Mendy,1999,15,5,10,33.33333333333333,66.66666666666666,Unisex
Myca,1999,19,13,6,68.42105263157895,31.57894736842105,Unisex
Kerry,1999,350,200,150,57.14285714285714,42.85714285714285,Unisex
Mandeep,1999,16,8,8,50.0,50.0,Unisex
Maika,1999,16,11,5,68.75,31.25,Unisex
Nakia,1999,200,166,34,83.0,17.0,Unisex
Kendle,1999,18,6,12,33.33333333333333,66.66666666666666,Unisex
Nevada,1999,64,45,19,70.3125,29.6875,Unisex
Briley,1999,133,94,39,70.67669172932331,29.32330827067669,Unisex
Ryen,1999,69,35,34,50.72463768115942,49.275362318840585,Unisex
Marietta,2000,17,17,0,100.0,0.0,Female
Clorissa,2000,8,8,0,100.0,0.0,Female
Nivedita,2000,7,7,0,100.0,0.0,Female
Nykayla,2000,7,7,0,100.0,0.0,Female
Effie,2000,18,18,0,100.0,0.0,Female
Micaella,2000,7,7,0,100.0,0.0,Female
Kayleah,2000,14,14,0,100.0,0.0,Female
Anjoli,2000,5,5,0,100.0,0.0,Female
Yunuen,2000,16,16,0,100.0,0.0,Female
Jakiya,2000,54,54,0,100.0,0.0,Female
Landy,2000,9,9,0,100.0,0.0,Female
Brailyn,2000,21,21,0,100.0,0.0,Female
Salimata,2000,7,7,0,100.0,0.0,Female
Maryam,2000,235,235,0,100.0,0.0,Female
Griselda,2000,154,154,0,100.0,0.0,Female
Chalsea,2000,5,5,0,100.0,0.0,Female
Jamiee,2000,12,12,0,100.0,0.0,Female
Daena,2000,11,11,0,100.0,0.0,Female
Bliss,2000,15,15,0,100.0,0.0,Female
Jordane,2000,9,9,0,100.0,0.0,Female
Jinal,2000,5,5,0,100.0,0.0,Female
Analiza,2000,7,7,0,100.0,0.0,Female
Ketara,2000,24,24,0,100.0,0.0,Female
Alaura,2000,54,54,0,100.0,0.0,Female
Brynley,2000,15,15,0,100.0,0.0,Female
Lynlee,2000,5,5,0,100.0,0.0,Female
Nathally,2000,5,5,0,100.0,0.0,Female
Temima,2000,5,5,0,100.0,0.0,Female
Solae,2000,6,6,0,100.0,0.0,Female
Jannat,2000,8,8,0,100.0,0.0,Female
Marzell,2000,9,0,9,0.0,100.0,Male
Tarkan,2000,5,0,5,0.0,100.0,Male
Jayland,2000,31,0,31,0.0,100.0,Male
Khylen,2000,5,0,5,0.0,100.0,Male
Partick,2000,6,0,6,0.0,100.0,Male
Tyquavious,2000,16,0,16,0.0,100.0,Male
Joey,2000,561,80,481,14.260249554367205,85.73975044563281,Male
Leopold,2000,10,0,10,0.0,100.0,Male
Jarron,2000,35,0,35,0.0,100.0,Male
Deshan,2000,7,0,7,0.0,100.0,Male
Jakob,2000,2161,0,2161,0.0,100.0,Male
Sharod,2000,23,0,23,0.0,100.0,Male
Anjelo,2000,5,0,5,0.0,100.0,Male
Finnian,2000,41,0,41,0.0,100.0,Male
Catarino,2000,11,0,11,0.0,100.0,Male
Sven,2000,29,0,29,0.0,100.0,Male
Olando,2000,7,0,7,0.0,100.0,Male
Liban,2000,11,0,11,0.0,100.0,Male
Jhalin,2000,5,0,5,0.0,100.0,Male
Mohsen,2000,5,0,5,0.0,100.0,Male
Cam,2000,19,0,19,0.0,100.0,Male
Brenden,2000,1394,0,1394,0.0,100.0,Male
Henry,2000,3131,6,3125,0.1916320664324496,99.80836793356757,Male
Steffen,2000,22,0,22,0.0,100.0,Male
Alanzo,2000,8,0,8,0.0,100.0,Male
Timoteo,2000,18,0,18,0.0,100.0,Male
Jacobie,2000,29,0,29,0.0,100.0,Male
Nyjee,2000,6,0,6,0.0,100.0,Male
Yacoub,2000,5,0,5,0.0,100.0,Male
Kyson,2000,37,0,37,0.0,100.0,Male
Ariel,2000,2137,1753,384,82.03088441740758,17.96911558259242,Unisex
Bayan,2000,30,25,5,83.33333333333334,16.666666666666664,Unisex
Talor,2000,41,33,8,80.48780487804879,19.51219512195122,Unisex
Codi,2000,123,71,52,57.72357723577236,42.27642276422765,Unisex
Kadence,2000,24,18,6,75.0,25.0,Unisex
Khari,2000,97,16,81,16.49484536082474,83.50515463917526,Unisex
Rory,2000,375,85,290,22.666666666666664,77.33333333333333,Unisex
Weslie,2000,12,7,5,58.333333333333336,41.66666666666667,Unisex
Jariel,2000,25,7,18,28.000000000000004,72.0,Unisex
Reegan,2000,62,49,13,79.03225806451613,20.967741935483872,Unisex
Brandis,2000,12,6,6,50.0,50.0,Unisex
Kalan,2000,34,13,21,38.23529411764706,61.76470588235294,Unisex
Tali,2000,38,32,6,84.21052631578947,15.789473684210526,Unisex
Alexey,2000,21,9,12,42.85714285714285,57.14285714285714,Unisex
Jessie,2000,1252,719,533,57.42811501597445,42.57188498402556,Unisex
Sumeet,2000,13,5,8,38.46153846153847,61.53846153846154,Unisex
Amadi,2000,19,10,9,52.63157894736842,47.368421052631575,Unisex
Ziah,2000,22,15,7,68.18181818181817,31.818181818181817,Unisex
Pepper,2000,12,7,5,58.333333333333336,41.66666666666667,Unisex
Rameen,2000,11,5,6,45.45454545454545,54.54545454545454,Unisex
Reilley,2000,18,12,6,66.66666666666666,33.33333333333333,Unisex
Marion,2000,244,141,103,57.78688524590165,42.21311475409836,Unisex
Lunden,2000,29,14,15,48.27586206896552,51.72413793103448,Unisex
Micah,2000,2368,393,1975,16.596283783783782,83.40371621621621,Unisex
Jarae,2000,11,5,6,45.45454545454545,54.54545454545454,Unisex
Jireh,2000,42,21,21,50.0,50.0,Unisex
Teagen,2000,21,7,14,33.33333333333333,66.66666666666666,Unisex
Schylar,2000,26,14,12,53.84615384615385,46.15384615384615,Unisex
Xavia,2000,34,28,6,82.35294117647058,17.647058823529413,Unisex
Jessy,2000,127,45,82,35.43307086614173,64.56692913385827,Unisex
Reann,2001,22,22,0,100.0,0.0,Female
Ellese,2001,5,5,0,100.0,0.0,Female
Anjali,2001,222,222,0,100.0,0.0,Female
Mackensey,2001,13,13,0,100.0,0.0,Female
Sameria,2001,8,8,0,100.0,0.0,Female
Oluwatoyin,2001,6,6,0,100.0,0.0,Female
Shantia,2001,15,15,0,100.0,0.0,Female
Skyle,2001,5,5,0,100.0,0.0,Female
Aariel,2001,5,5,0,100.0,0.0,Female
Shaddai,2001,5,5,0,100.0,0.0,Female
Makyiah,2001,7,7,0,100.0,0.0,Female
Haillie,2001,24,24,0,100.0,0.0,Female
Saryna,2001,13,13,0,100.0,0.0,Female
Brittanny,2001,7,7,0,100.0,0.0,Female
Hikari,2001,7,7,0,100.0,0.0,Female
Keionna,2001,36,36,0,100.0,0.0,Female
Chari,2001,5,5,0,100.0,0.0,Female
Kortnie,2001,24,24,0,100.0,0.0,Female
Sanaii,2001,5,5,0,100.0,0.0,Female
Sindhuja,2001,7,7,0,100.0,0.0,Female
Alyissa,2001,25,25,0,100.0,0.0,Female
Shevy,2001,6,6,0,100.0,0.0,Female
Tyffani,2001,6,6,0,100.0,0.0,Female
Analys,2001,6,6,0,100.0,0.0,Female
Aishani,2001,7,7,0,100.0,0.0,Female
Kemaria,2001,5,5,0,100.0,0.0,Female
Nila,2001,35,35,0,100.0,0.0,Female
Treva,2001,12,12,0,100.0,0.0,Female
Rilee,2001,103,89,14,86.40776699029125,13.592233009708735,Female
Naja,2001,53,53,0,100.0,0.0,Female
Librado,2001,12,0,12,0.0,100.0,Male
Fenton,2001,9,0,9,0.0,100.0,Male
Rayshon,2001,21,0,21,0.0,100.0,Male
Aki,2001,11,0,11,0.0,100.0,Male
Cathan,2001,5,0,5,0.0,100.0,Male
Jonothon,2001,5,0,5,0.0,100.0,Male
Ramaj,2001,7,0,7,0.0,100.0,Male
Qamar,2001,6,0,6,0.0,100.0,Male
Jabarie,2001,6,0,6,0.0,100.0,Male
Steele,2001,42,0,42,0.0,100.0,Male
Lajon,2001,8,0,8,0.0,100.0,Male
Benjaman,2001,15,0,15,0.0,100.0,Male
Kainan,2001,15,0,15,0.0,100.0,Male
Annas,2001,7,0,7,0.0,100.0,Male
Jakhi,2001,15,0,15,0.0,100.0,Male
Hassan,2001,218,0,218,0.0,100.0,Male
Norton,2001,5,0,5,0.0,100.0,Male
Deontre,2001,34,0,34,0.0,100.0,Male
Marcelus,2001,9,0,9,0.0,100.0,Male
Zackeri,2001,6,0,6,0.0,100.0,Male
Corbin,2001,1009,17,992,1.684836471754212,98.3151635282458,Male
Ashawn,2001,7,0,7,0.0,100.0,Male
Malakye,2001,8,0,8,0.0,100.0,Male
Ramzy,2001,9,0,9,0.0,100.0,Male
Abdalla,2001,7,0,7,0.0,100.0,Male
Dajohn,2001,13,0,13,0.0,100.0,Male
Khadir,2001,5,0,5,0.0,100.0,Male
Fermin,2001,61,0,61,0.0,100.0,Male
Tyden,2001,6,0,6,0.0,100.0,Male
Friedrich,2001,7,0,7,0.0,100.0,Male
Emerson,2001,408,183,225,44.85294117647059,55.14705882352941,Unisex
Kadence,2001,19,12,7,63.1578947368421,36.84210526315789,Unisex
Averey,2001,24,17,7,70.83333333333334,29.166666666666668,Unisex
Jamey,2001,46,26,20,56.52173913043478,43.47826086956522,Unisex
Felice,2001,31,24,7,77.41935483870968,22.58064516129032,Unisex
Denali,2001,61,44,17,72.1311475409836,27.86885245901639,Unisex
Deandrea,2001,50,35,15,70.0,30.0,Unisex
Asanti,2001,18,9,9,50.0,50.0,Unisex
Sai,2001,50,15,35,30.0,70.0,Unisex
Berlin,2001,12,5,7,41.66666666666667,58.333333333333336,Unisex
Truth,2001,15,7,8,46.66666666666666,53.333333333333336,Unisex
Misha,2001,41,30,11,73.17073170731707,26.82926829268293,Unisex
Arie,2001,51,32,19,62.74509803921568,37.25490196078432,Unisex
Teylor,2001,22,14,8,63.63636363636363,36.36363636363637,Unisex
Jadis,2001,18,9,9,50.0,50.0,Unisex
Rudi,2001,19,9,10,47.368421052631575,52.63157894736842,Unisex
Cache,2001,33,18,15,54.54545454545454,45.45454545454545,Unisex
Conley,2001,28,5,23,17.857142857142858,82.14285714285714,Unisex
Jasiah,2001,70,11,59,15.714285714285714,84.28571428571429,Unisex
Tai,2001,137,42,95,30.656934306569344,69.34306569343066,Unisex
Vegas,2001,12,5,7,41.66666666666667,58.333333333333336,Unisex
Jayline,2001,29,24,5,82.75862068965517,17.24137931034483,Unisex
Damar,2001,28,5,23,17.857142857142858,82.14285714285714,Unisex
Jasdeep,2001,12,5,7,41.66666666666667,58.333333333333336,Unisex
Daniele,2001,42,31,11,73.80952380952381,26.1904761904762,Unisex
Tyrae,2001,19,6,13,31.57894736842105,68.42105263157895,Unisex
Dilynn,2001,11,6,5,54.54545454545454,45.45454545454545,Unisex
Naje,2001,18,13,5,72.22222222222221,27.77777777777778,Unisex
Christan,2001,57,12,45,21.052631578947366,78.94736842105263,Unisex
Maysen,2001,20,14,6,70.0,30.0,Unisex
Lysha,2002,9,9,0,100.0,0.0,Female
Kinzi,2002,5,5,0,100.0,0.0,Female
Jazlyn,2002,411,411,0,100.0,0.0,Female
Tamea,2002,14,14,0,100.0,0.0,Female
Khrista,2002,5,5,0,100.0,0.0,Female
Jarely,2002,40,40,0,100.0,0.0,Female
Rabiah,2002,6,6,0,100.0,0.0,Female
Tausha,2002,5,5,0,100.0,0.0,Female
Rubith,2002,5,5,0,100.0,0.0,Female
Kenyah,2002,15,15,0,100.0,0.0,Female
Staci,2002,59,59,0,100.0,0.0,Female
Paisley,2002,109,109,0,100.0,0.0,Female
Nida,2002,24,24,0,100.0,0.0,Female
Shadiyah,2002,6,6,0,100.0,0.0,Female
Danika,2002,160,160,0,100.0,0.0,Female
Fantasia,2002,29,29,0,100.0,0.0,Female
Naimah,2002,28,28,0,100.0,0.0,Female
Monai,2002,5,5,0,100.0,0.0,Female
Jianna,2002,82,82,0,100.0,0.0,Female
Mackena,2002,9,9,0,100.0,0.0,Female
Frances,2002,422,414,8,98.1042654028436,1.895734597156398,Female
Lyric,2002,374,328,46,87.70053475935828,12.299465240641712,Female
Deshonna,2002,7,7,0,100.0,0.0,Female
Rashelle,2002,11,11,0,100.0,0.0,Female
Sahara,2002,96,96,0,100.0,0.0,Female
Vegas,2002,8,8,0,100.0,0.0,Female
Ilysa,2002,5,5,0,100.0,0.0,Female
Tahreem,2002,5,5,0,100.0,0.0,Female
Ikram,2002,8,8,0,100.0,0.0,Female
Hareem,2002,5,5,0,100.0,0.0,Female
Tajh,2002,23,0,23,0.0,100.0,Male
Majd,2002,10,0,10,0.0,100.0,Male
Guy,2002,173,0,173,0.0,100.0,Male
Matthue,2002,6,0,6,0.0,100.0,Male
Nicasio,2002,7,0,7,0.0,100.0,Male
Kristofer,2002,160,0,160,0.0,100.0,Male
Wilburn,2002,6,0,6,0.0,100.0,Male
Izack,2002,19,0,19,0.0,100.0,Male
Haralambos,2002,6,0,6,0.0,100.0,Male
Aditya,2002,190,0,190,0.0,100.0,Male
Colgan,2002,5,0,5,0.0,100.0,Male
Reyce,2002,5,0,5,0.0,100.0,Male
Wes,2002,33,0,33,0.0,100.0,Male
Zaccary,2002,16,0,16,0.0,100.0,Male
Thayer,2002,14,0,14,0.0,100.0,Male
Ky,2002,32,0,32,0.0,100.0,Male
Case,2002,136,0,136,0.0,100.0,Male
Lalo,2002,9,0,9,0.0,100.0,Male
Govind,2002,9,0,9,0.0,100.0,Male
Henrique,2002,11,0,11,0.0,100.0,Male
Zarik,2002,7,0,7,0.0,100.0,Male
Armando,2002,1393,0,1393,0.0,100.0,Male
Josafat,2002,12,0,12,0.0,100.0,Male
Suhas,2002,13,0,13,0.0,100.0,Male
Calan,2002,14,0,14,0.0,100.0,Male
Trajen,2002,6,0,6,0.0,100.0,Male
Tayyab,2002,6,0,6,0.0,100.0,Male
Abbaas,2002,5,0,5,0.0,100.0,Male
Blade,2002,112,0,112,0.0,100.0,Male
Jalal,2002,18,0,18,0.0,100.0,Male
Jaime,2002,1533,270,1263,17.61252446183953,82.38747553816047,Unisex
Cashmere,2002,24,15,9,62.5,37.5,Unisex
Dacotah,2002,11,6,5,54.54545454545454,45.45454545454545,Unisex
Caton,2002,18,9,9,50.0,50.0,Unisex
Eri,2002,16,7,9,43.75,56.25,Unisex
Naveen,2002,27,6,21,22.22222222222222,77.77777777777779,Unisex
Berkley,2002,59,38,21,64.40677966101694,35.59322033898305,Unisex
Carrington,2002,144,99,45,68.75,31.25,Unisex
Xin,2002,16,10,6,62.5,37.5,Unisex
Deni,2002,15,9,6,60.0,40.0,Unisex
Ande,2002,14,9,5,64.28571428571429,35.714285714285715,Unisex
Reeve,2002,22,6,16,27.27272727272727,72.72727272727273,Unisex
Deovion,2002,12,5,7,41.66666666666667,58.333333333333336,Unisex
Christen,2002,152,112,40,73.68421052631578,26.31578947368421,Unisex
Sincere,2002,285,60,225,21.052631578947366,78.94736842105263,Unisex
Tracy,2002,401,283,118,70.57356608478803,29.42643391521197,Unisex
Rane,2002,14,7,7,50.0,50.0,Unisex
Terryn,2002,25,19,6,76.0,24.0,Unisex
Weslee,2002,38,8,30,21.052631578947366,78.94736842105263,Unisex
Davine,2002,13,7,6,53.84615384615385,46.15384615384615,Unisex
Cypress,2002,23,10,13,43.47826086956522,56.52173913043478,Unisex
Krishi,2002,21,6,15,28.57142857142857,71.42857142857143,Unisex
Kamani,2002,29,13,16,44.82758620689656,55.172413793103445,Unisex
Shiva,2002,28,6,22,21.428571428571427,78.57142857142857,Unisex
Braedyn,2002,70,16,54,22.857142857142858,77.14285714285715,Unisex
Payden,2002,60,19,41,31.666666666666664,68.33333333333333,Unisex
Lynden,2002,29,15,14,51.72413793103448,48.27586206896552,Unisex
Holland,2002,126,103,23,81.74603174603175,18.253968253968253,Unisex
Kyrie,2002,76,54,22,71.05263157894737,28.94736842105264,Unisex
Jaydan,2002,100,19,81,19.0,81.0,Unisex
Dnyah,2003,5,5,0,100.0,0.0,Female
Madysin,2003,8,8,0,100.0,0.0,Female
Sulekha,2003,5,5,0,100.0,0.0,Female
Circe,2003,6,6,0,100.0,0.0,Female
Carlynn,2003,8,8,0,100.0,0.0,Female
Anastaisa,2003,5,5,0,100.0,0.0,Female
Devina,2003,32,32,0,100.0,0.0,Female
Anastasiya,2003,19,19,0,100.0,0.0,Female
Zakyia,2003,5,5,0,100.0,0.0,Female
Diamonique,2003,35,35,0,100.0,0.0,Female
Laina,2003,57,57,0,100.0,0.0,Female
Elle,2003,497,497,0,100.0,0.0,Female
Cristabel,2003,9,9,0,100.0,0.0,Female
Yutzil,2003,6,6,0,100.0,0.0,Female
Zorah,2003,13,13,0,100.0,0.0,Female
Merline,2003,5,5,0,100.0,0.0,Female
Hanae,2003,5,5,0,100.0,0.0,Female
Brena,2003,17,17,0,100.0,0.0,Female
Anyla,2003,32,32,0,100.0,0.0,Female
Daisy,2003,2418,2410,8,99.66914805624482,0.3308519437551696,Female
Ember,2003,127,127,0,100.0,0.0,Female
Zaydee,2003,6,6,0,100.0,0.0,Female
Rialey,2003,6,6,0,100.0,0.0,Female
Nhi,2003,28,28,0,100.0,0.0,Female
Rhea,2003,195,195,0,100.0,0.0,Female
Angeni,2003,14,14,0,100.0,0.0,Female
Taylur,2003,5,5,0,100.0,0.0,Female
Kealy,2003,13,13,0,100.0,0.0,Female
Mkya,2003,7,7,0,100.0,0.0,Female
Alessa,2003,39,39,0,100.0,0.0,Female
Elijan,2003,5,0,5,0.0,100.0,Male
Symon,2003,16,0,16,0.0,100.0,Male
Toney,2003,22,0,22,0.0,100.0,Male
Jahmar,2003,20,0,20,0.0,100.0,Male
Markavious,2003,6,0,6,0.0,100.0,Male
Keagon,2003,17,0,17,0.0,100.0,Male
Nytrell,2003,5,0,5,0.0,100.0,Male
Cove,2003,5,0,5,0.0,100.0,Male
Hagen,2003,105,7,98,6.666666666666667,93.33333333333331,Male
Blue,2003,16,0,16,0.0,100.0,Male
Branan,2003,7,0,7,0.0,100.0,Male
Anthonee,2003,10,0,10,0.0,100.0,Male
Aby,2003,8,0,8,0.0,100.0,Male
Dontavis,2003,5,0,5,0.0,100.0,Male
Ozzie,2003,23,0,23,0.0,100.0,Male
Blake,2003,5383,108,5275,2.006316180568456,97.99368381943154,Male
Samba,2003,8,0,8,0.0,100.0,Male
Dallyn,2003,17,0,17,0.0,100.0,Male
Jairen,2003,6,0,6,0.0,100.0,Male
Tavar,2003,6,0,6,0.0,100.0,Male
Wylee,2003,8,0,8,0.0,100.0,Male
Avantae,2003,13,0,13,0.0,100.0,Male
Davarion,2003,11,0,11,0.0,100.0,Male
Sneh,2003,8,0,8,0.0,100.0,Male
Keelan,2003,106,7,99,6.60377358490566,93.39622641509436,Male
Gregg,2003,35,0,35,0.0,100.0,Male
Shykeem,2003,6,0,6,0.0,100.0,Male
Mccord,2003,6,0,6,0.0,100.0,Male
Lavaughn,2003,5,0,5,0.0,100.0,Male
Lawton,2003,42,0,42,0.0,100.0,Male
Ky,2003,40,6,34,15.0,85.0,Unisex
Landry,2003,182,102,80,56.04395604395605,43.95604395604396,Unisex
Oreoluwa,2003,17,5,12,29.411764705882355,70.58823529411765,Unisex
Camerin,2003,37,10,27,27.027027027027028,72.97297297297297,Unisex
Samar,2003,36,27,9,75.0,25.0,Unisex
Aseel,2003,34,27,7,79.41176470588235,20.588235294117645,Unisex
Haydyn,2003,11,6,5,54.54545454545454,45.45454545454545,Unisex
Donyae,2003,29,15,14,51.72413793103448,48.27586206896552,Unisex
Sagen,2003,12,5,7,41.66666666666667,58.333333333333336,Unisex
Kamil,2003,76,14,62,18.421052631578945,81.57894736842105,Unisex
Jadin,2003,177,56,121,31.63841807909605,68.36158192090396,Unisex
Gabryel,2003,16,5,11,31.25,68.75,Unisex
Love,2003,57,47,10,82.45614035087719,17.543859649122805,Unisex
Ryen,2003,68,37,31,54.41176470588235,45.588235294117645,Unisex
Nakia,2003,117,93,24,79.48717948717949,20.51282051282051,Unisex
Anh,2003,55,43,12,78.18181818181819,21.818181818181817,Unisex
Yared,2003,28,8,20,28.57142857142857,71.42857142857143,Unisex
Kamori,2003,15,9,6,60.0,40.0,Unisex
Christan,2003,59,10,49,16.94915254237288,83.05084745762711,Unisex
Sivan,2003,19,14,5,73.68421052631578,26.31578947368421,Unisex
Corian,2003,14,5,9,35.714285714285715,64.28571428571429,Unisex
Sion,2003,21,6,15,28.57142857142857,71.42857142857143,Unisex
Malikah,2003,13,8,5,61.53846153846154,38.46153846153847,Unisex
Quincy,2003,648,100,548,15.432098765432098,84.5679012345679,Unisex
Michal,2003,105,46,59,43.80952380952381,56.19047619047619,Unisex
Dakota,2003,4076,916,3160,22.47301275760549,77.52698724239451,Unisex
Avin,2003,24,5,19,20.833333333333336,79.16666666666666,Unisex
Caymen,2003,18,5,13,27.77777777777778,72.22222222222221,Unisex
Makana,2003,30,19,11,63.33333333333333,36.66666666666666,Unisex
Harley,2003,1610,996,614,61.86335403726708,38.13664596273292,Unisex
Yaelin,2004,5,5,0,100.0,0.0,Female
Janeva,2004,9,9,0,100.0,0.0,Female
Merli,2004,8,8,0,100.0,0.0,Female
Nanci,2004,41,41,0,100.0,0.0,Female
Markyla,2004,7,7,0,100.0,0.0,Female
Makaia,2004,17,17,0,100.0,0.0,Female
Darielle,2004,23,23,0,100.0,0.0,Female
Emilia,2004,630,630,0,100.0,0.0,Female
Judy,2004,167,167,0,100.0,0.0,Female
Airyonna,2004,5,5,0,100.0,0.0,Female
Nyasiah,2004,6,6,0,100.0,0.0,Female
Janica,2004,7,7,0,100.0,0.0,Female
Tynajah,2004,9,9,0,100.0,0.0,Female
Shandee,2004,5,5,0,100.0,0.0,Female
Lydia,2004,2646,2630,16,99.39531368102796,0.6046863189720333,Female
Rie,2004,5,5,0,100.0,0.0,Female
Joie,2004,56,56,0,100.0,0.0,Female
Leylah,2004,11,11,0,100.0,0.0,Female
Josaphine,2004,11,11,0,100.0,0.0,Female
Danajia,2004,5,5,0,100.0,0.0,Female
Aerica,2004,5,5,0,100.0,0.0,Female
Ilaria,2004,5,5,0,100.0,0.0,Female
Jeanne,2004,68,68,0,100.0,0.0,Female
Casidy,2004,12,12,0,100.0,0.0,Female
Rosalia,2004,74,74,0,100.0,0.0,Female
Ayniah,2004,6,6,0,100.0,0.0,Female
Gayathri,2004,9,9,0,100.0,0.0,Female
Taysia,2004,27,27,0,100.0,0.0,Female
Monet,2004,104,104,0,100.0,0.0,Female
Mckennzie,2004,5,5,0,100.0,0.0,Female
Carlos,2004,6275,16,6259,0.2549800796812749,99.74501992031873,Male
Crew,2004,44,0,44,0.0,100.0,Male
Jonny,2004,66,0,66,0.0,100.0,Male
Matej,2004,6,0,6,0.0,100.0,Male
Angello,2004,11,0,11,0.0,100.0,Male
Nahzir,2004,8,0,8,0.0,100.0,Male
Jay,2004,829,7,822,0.8443908323281062,99.1556091676719,Male
Wyett,2004,15,0,15,0.0,100.0,Male
Kobee,2004,6,0,6,0.0,100.0,Male
Rubin,2004,34,0,34,0.0,100.0,Male
Aamir,2004,42,0,42,0.0,100.0,Male
Jhoan,2004,10,0,10,0.0,100.0,Male
Markeal,2004,6,0,6,0.0,100.0,Male
Abdulahi,2004,16,0,16,0.0,100.0,Male
Eberardo,2004,10,0,10,0.0,100.0,Male
Jerrald,2004,5,0,5,0.0,100.0,Male
Trapper,2004,28,0,28,0.0,100.0,Male
Jalen,2004,2126,104,2022,4.891815616180621,95.10818438381938,Male
Kayron,2004,10,0,10,0.0,100.0,Male
Elston,2004,6,0,6,0.0,100.0,Male
Lyndon,2004,102,6,96,5.88235294117647,94.11764705882352,Male
Darel,2004,9,0,9,0.0,100.0,Male
Louie,2004,84,0,84,0.0,100.0,Male
Haadi,2004,7,0,7,0.0,100.0,Male
Torii,2004,5,0,5,0.0,100.0,Male
Izzak,2004,5,0,5,0.0,100.0,Male
Caymen,2004,13,0,13,0.0,100.0,Male
Krystopher,2004,18,0,18,0.0,100.0,Male
Imauri,2004,5,0,5,0.0,100.0,Male
Vasilis,2004,7,0,7,0.0,100.0,Male
Deavion,2004,36,14,22,38.88888888888889,61.11111111111112,Unisex
Rossi,2004,13,8,5,61.53846153846154,38.46153846153847,Unisex
Jourdyn,2004,22,13,9,59.09090909090909,40.909090909090914,Unisex
Maika,2004,31,18,13,58.06451612903226,41.935483870967744,Unisex
Tobie,2004,24,10,14,41.66666666666667,58.333333333333336,Unisex
Demaree,2004,11,6,5,54.54545454545454,45.45454545454545,Unisex
Desi,2004,33,10,23,30.303030303030305,69.6969696969697,Unisex
Kelyn,2004,22,12,10,54.54545454545454,45.45454545454545,Unisex
Micaiah,2004,141,65,76,46.09929078014184,53.90070921985816,Unisex
Jayln,2004,51,14,37,27.450980392156865,72.54901960784314,Unisex
Ayan,2004,58,21,37,36.206896551724135,63.793103448275865,Unisex
Ariyon,2004,20,15,5,75.0,25.0,Unisex
Deni,2004,20,7,13,35.0,65.0,Unisex
Nature,2004,16,11,5,68.75,31.25,Unisex
Tamar,2004,109,88,21,80.73394495412845,19.26605504587156,Unisex
Jasdeep,2004,16,5,11,31.25,68.75,Unisex
Landry,2004,237,149,88,62.869198312236286,37.130801687763714,Unisex
Ahmari,2004,65,26,39,40.0,60.0,Unisex
Carrington,2004,118,91,27,77.11864406779661,22.88135593220339,Unisex
Terryn,2004,20,14,6,70.0,30.0,Unisex
Adonijah,2004,18,5,13,27.77777777777778,72.22222222222221,Unisex
Wynn,2004,26,10,16,38.46153846153847,61.53846153846154,Unisex
Drue,2004,47,28,19,59.57446808510638,40.42553191489361,Unisex
Kahmari,2004,19,7,12,36.84210526315789,63.1578947368421,Unisex
Atley,2004,27,10,17,37.03703703703704,62.96296296296296,Unisex
Kodi,2004,116,56,60,48.27586206896552,51.72413793103448,Unisex
Sammie,2004,54,26,28,48.14814814814815,51.85185185185185,Unisex
Armanie,2004,10,5,5,50.0,50.0,Unisex
Giavonni,2004,18,6,12,33.33333333333333,66.66666666666666,Unisex
Perris,2004,16,11,5,68.75,31.25,Unisex
Thy,2005,13,13,0,100.0,0.0,Female
Anely,2005,14,14,0,100.0,0.0,Female
Cambree,2005,74,74,0,100.0,0.0,Female
Deeksha,2005,17,17,0,100.0,0.0,Female
Macye,2005,6,6,0,100.0,0.0,Female
Nyaira,2005,16,16,0,100.0,0.0,Female
Corah,2005,9,9,0,100.0,0.0,Female
Dakaria,2005,8,8,0,100.0,0.0,Female
Anastacia,2005,140,140,0,100.0,0.0,Female
Andriel,2005,5,5,0,100.0,0.0,Female
Jasline,2005,7,7,0,100.0,0.0,Female
Lilyahna,2005,6,6,0,100.0,0.0,Female
Laprincia,2005,8,8,0,100.0,0.0,Female
Breseis,2005,7,7,0,100.0,0.0,Female
Caili,2005,8,8,0,100.0,0.0,Female
Jazlynn,2005,227,227,0,100.0,0.0,Female
Nashaya,2005,6,6,0,100.0,0.0,Female
Amarachi,2005,24,24,0,100.0,0.0,Female
Kenidee,2005,13,13,0,100.0,0.0,Female
Kenae,2005,6,6,0,100.0,0.0,Female
Mandi,2005,53,53,0,100.0,0.0,Female
Dorthy,2005,6,6,0,100.0,0.0,Female
Amarylis,2005,7,7,0,100.0,0.0,Female
Rosana,2005,14,14,0,100.0,0.0,Female
Zayli,2005,7,7,0,100.0,0.0,Female
Karolynn,2005,6,6,0,100.0,0.0,Female
Najah,2005,49,49,0,100.0,0.0,Female
Ismelda,2005,6,6,0,100.0,0.0,Female
Karena,2005,40,40,0,100.0,0.0,Female
Jaleia,2005,8,8,0,100.0,0.0,Female
Jahree,2005,6,0,6,0.0,100.0,Male
Dysen,2005,9,0,9,0.0,100.0,Male
Garren,2005,49,0,49,0.0,100.0,Male
Taner,2005,28,0,28,0.0,100.0,Male
Jatavion,2005,15,0,15,0.0,100.0,Male
Coston,2005,5,0,5,0.0,100.0,Male
Triton,2005,37,0,37,0.0,100.0,Male
Sidarth,2005,6,0,6,0.0,100.0,Male
Kalep,2005,6,0,6,0.0,100.0,Male
Vic,2005,6,0,6,0.0,100.0,Male
Jakori,2005,29,0,29,0.0,100.0,Male
Sony,2005,6,0,6,0.0,100.0,Male
Liborio,2005,5,0,5,0.0,100.0,Male
Jakarius,2005,8,0,8,0.0,100.0,Male
Kadien,2005,5,0,5,0.0,100.0,Male
Aleczander,2005,36,0,36,0.0,100.0,Male
Jabe,2005,8,0,8,0.0,100.0,Male
Job,2005,76,0,76,0.0,100.0,Male
Nephtali,2005,6,0,6,0.0,100.0,Male
Nichalos,2005,8,0,8,0.0,100.0,Male
Wesley,2005,2129,16,2113,0.7515265382808831,99.24847346171912,Male
Camilo,2005,150,0,150,0.0,100.0,Male
Damariyon,2005,5,0,5,0.0,100.0,Male
Vince,2005,119,0,119,0.0,100.0,Male
Meir,2005,88,0,88,0.0,100.0,Male
Zak,2005,43,0,43,0.0,100.0,Male
Jvon,2005,24,0,24,0.0,100.0,Male
Tyren,2005,74,0,74,0.0,100.0,Male
Artrell,2005,6,0,6,0.0,100.0,Male
Kiev,2005,5,0,5,0.0,100.0,Male
Aris,2005,73,32,41,43.83561643835616,56.16438356164384,Unisex
Kim,2005,86,73,13,84.88372093023256,15.11627906976744,Unisex
Dakoda,2005,170,41,129,24.11764705882353,75.88235294117646,Unisex
Amorie,2005,19,13,6,68.42105263157895,31.57894736842105,Unisex
Alexes,2005,32,21,11,65.625,34.375,Unisex
Tameron,2005,12,5,7,41.66666666666667,58.333333333333336,Unisex
Franki,2005,23,15,8,65.21739130434783,34.78260869565217,Unisex
Kerrington,2005,24,16,8,66.66666666666666,33.33333333333333,Unisex
Quincey,2005,48,13,35,27.08333333333333,72.91666666666666,Unisex
Domonique,2005,61,47,14,77.04918032786885,22.950819672131143,Unisex
Eliah,2005,46,20,26,43.47826086956522,56.52173913043478,Unisex
Haydin,2005,35,14,21,40.0,60.0,Unisex
Truth,2005,27,14,13,51.85185185185185,48.14814814814815,Unisex
Micha,2005,41,28,13,68.29268292682927,31.70731707317073,Unisex
Devyn,2005,564,290,274,51.41843971631206,48.58156028368794,Unisex
Aeron,2005,19,5,14,26.31578947368421,73.68421052631578,Unisex
Jessey,2005,21,8,13,38.095238095238095,61.90476190476191,Unisex
Kaelen,2005,42,16,26,38.095238095238095,61.90476190476191,Unisex
Rhylee,2005,51,40,11,78.43137254901961,21.5686274509804,Unisex
Jailin,2005,32,16,16,50.0,50.0,Unisex
Daylyn,2005,19,12,7,63.1578947368421,36.84210526315789,Unisex
Shalin,2005,14,5,9,35.714285714285715,64.28571428571429,Unisex
Nole,2005,12,5,7,41.66666666666667,58.333333333333336,Unisex
Avis,2005,18,12,6,66.66666666666666,33.33333333333333,Unisex
Jory,2005,36,11,25,30.55555555555556,69.44444444444444,Unisex
Carsen,2005,153,29,124,18.954248366013072,81.04575163398692,Unisex
Aaren,2005,33,5,28,15.151515151515152,84.84848484848484,Unisex
Danyel,2005,34,19,15,55.88235294117647,44.11764705882353,Unisex
Keona,2005,109,92,17,84.40366972477065,15.59633027522936,Unisex
Ashe,2005,18,6,12,33.33333333333333,66.66666666666666,Unisex
Haillie,2006,12,12,0,100.0,0.0,Female
Allisan,2006,6,6,0,100.0,0.0,Female
Nancy,2006,1017,1017,0,100.0,0.0,Female
Siya,2006,93,93,0,100.0,0.0,Female
Tamiyah,2006,47,47,0,100.0,0.0,Female
Tyra,2006,439,439,0,100.0,0.0,Female
Anistyn,2006,21,21,0,100.0,0.0,Female
Saphira,2006,9,9,0,100.0,0.0,Female
Aerianna,2006,16,16,0,100.0,0.0,Female
Naomy,2006,79,79,0,100.0,0.0,Female
Maymunah,2006,5,5,0,100.0,0.0,Female
Lakira,2006,15,15,0,100.0,0.0,Female
Dahlila,2006,12,12,0,100.0,0.0,Female
Sylvia,2006,581,581,0,100.0,0.0,Female
Stephanye,2006,6,6,0,100.0,0.0,Female
Anairis,2006,5,5,0,100.0,0.0,Female
Fraidy,2006,27,27,0,100.0,0.0,Female
Folasade,2006,11,11,0,100.0,0.0,Female
Lanah,2006,15,15,0,100.0,0.0,Female
Jazariah,2006,12,12,0,100.0,0.0,Female
Eniya,2006,29,29,0,100.0,0.0,Female
Thailia,2006,7,7,0,100.0,0.0,Female
Aundrea,2006,189,189,0,100.0,0.0,Female
Narya,2006,8,8,0,100.0,0.0,Female
Alizia,2006,15,15,0,100.0,0.0,Female
Matalyn,2006,19,19,0,100.0,0.0,Female
Alyha,2006,7,7,0,100.0,0.0,Female
Aleen,2006,15,15,0,100.0,0.0,Female
Lisbet,2006,29,29,0,100.0,0.0,Female
Caley,2006,71,71,0,100.0,0.0,Female
Kache,2006,6,0,6,0.0,100.0,Male
Travone,2006,6,0,6,0.0,100.0,Male
Dreshun,2006,5,0,5,0.0,100.0,Male
Brenner,2006,38,0,38,0.0,100.0,Male
Danny,2006,1079,5,1074,0.4633920296570898,99.5366079703429,Male
Shaker,2006,5,0,5,0.0,100.0,Male
Teo,2006,49,0,49,0.0,100.0,Male
Melbin,2006,9,0,9,0.0,100.0,Male
Giovonnie,2006,5,0,5,0.0,100.0,Male
Kalif,2006,6,0,6,0.0,100.0,Male
Agastya,2006,14,0,14,0.0,100.0,Male
Dilan,2006,152,0,152,0.0,100.0,Male
Albaraa,2006,7,0,7,0.0,100.0,Male
Ezechiel,2006,6,0,6,0.0,100.0,Male
Baruch,2006,29,0,29,0.0,100.0,Male
Bayron,2006,34,0,34,0.0,100.0,Male
Tres,2006,11,0,11,0.0,100.0,Male
Berk,2006,11,0,11,0.0,100.0,Male
Kaynan,2006,5,0,5,0.0,100.0,Male
Garv,2006,7,0,7,0.0,100.0,Male
Jabari,2006,392,0,392,0.0,100.0,Male
Barry,2006,169,0,169,0.0,100.0,Male
Javarious,2006,27,0,27,0.0,100.0,Male
Jyrell,2006,6,0,6,0.0,100.0,Male
Arrion,2006,14,0,14,0.0,100.0,Male
Jovan,2006,239,0,239,0.0,100.0,Male
Decarlos,2006,22,0,22,0.0,100.0,Male
Jakiem,2006,10,0,10,0.0,100.0,Male
Raequan,2006,14,0,14,0.0,100.0,Male
Kevian,2006,6,0,6,0.0,100.0,Male
Justice,2006,1269,546,723,43.02600472813239,56.973995271867615,Unisex
Laine,2006,111,72,39,64.86486486486487,35.13513513513514,Unisex
Azari,2006,25,18,7,72.0,28.000000000000004,Unisex
Cayce,2006,26,18,8,69.23076923076923,30.76923076923077,Unisex
Tsion,2006,17,12,5,70.58823529411765,29.411764705882355,Unisex
Rieley,2006,18,10,8,55.55555555555556,44.44444444444444,Unisex
Ara,2006,42,29,13,69.04761904761905,30.95238095238096,Unisex
Akemi,2006,22,17,5,77.27272727272727,22.727272727272727,Unisex
Daylin,2006,127,56,71,44.09448818897638,55.90551181102362,Unisex
Majesty,2006,24,18,6,75.0,25.0,Unisex
Nevada,2006,67,49,18,73.13432835820896,26.86567164179105,Unisex
Haydan,2006,30,5,25,16.666666666666664,83.33333333333334,Unisex
Avan,2006,25,5,20,20.0,80.0,Unisex
Makani,2006,28,6,22,21.428571428571427,78.57142857142857,Unisex
Damarie,2006,17,5,12,29.411764705882355,70.58823529411765,Unisex
Nguyen,2006,12,5,7,41.66666666666667,58.333333333333336,Unisex
Payton,2006,3449,2158,1291,62.56886053928675,37.43113946071325,Unisex
Najae,2006,21,16,5,76.19047619047619,23.809523809523807,Unisex
Ahmari,2006,45,14,31,31.11111111111111,68.88888888888889,Unisex
Rui,2006,23,5,18,21.73913043478261,78.26086956521739,Unisex
Ridley,2006,44,19,25,43.18181818181818,56.81818181818182,Unisex
Shae,2006,204,150,54,73.52941176470588,26.47058823529412,Unisex
Memphis,2006,248,47,201,18.951612903225808,81.04838709677419,Unisex
Jaedyn,2006,299,181,118,60.535117056856194,39.46488294314381,Unisex
Bevin,2006,11,6,5,54.54545454545454,45.45454545454545,Unisex
Charley,2006,291,225,66,77.31958762886599,22.68041237113402,Unisex
Mykah,2006,78,51,27,65.38461538461539,34.61538461538461,Unisex
Irie,2006,57,45,12,78.94736842105263,21.052631578947366,Unisex
Hero,2006,12,5,7,41.66666666666667,58.333333333333336,Unisex
Kalin,2006,73,42,31,57.53424657534247,42.465753424657535,Unisex
Julieth,2007,17,17,0,100.0,0.0,Female
Lillya,2007,5,5,0,100.0,0.0,Female
Yachet,2007,10,10,0,100.0,0.0,Female
Mariona,2007,13,13,0,100.0,0.0,Female
Tanya,2007,354,354,0,100.0,0.0,Female
Dianna,2007,198,198,0,100.0,0.0,Female
Kristyana,2007,11,11,0,100.0,0.0,Female
Makyia,2007,33,33,0,100.0,0.0,Female
Dekyla,2007,6,6,0,100.0,0.0,Female
Kynnadi,2007,13,13,0,100.0,0.0,Female
Estafani,2007,5,5,0,100.0,0.0,Female
Madelinn,2007,5,5,0,100.0,0.0,Female
Raela,2007,5,5,0,100.0,0.0,Female
Lianny,2007,19,19,0,100.0,0.0,Female
Anah,2007,14,14,0,100.0,0.0,Female
Laylah,2007,237,237,0,100.0,0.0,Female
Sierah,2007,6,6,0,100.0,0.0,Female
Mileigh,2007,31,31,0,100.0,0.0,Female
Tyja,2007,7,7,0,100.0,0.0,Female
Fatemah,2007,5,5,0,100.0,0.0,Female
Kaileia,2007,8,8,0,100.0,0.0,Female
Laticia,2007,15,15,0,100.0,0.0,Female
Dorsa,2007,6,6,0,100.0,0.0,Female
Danaira,2007,5,5,0,100.0,0.0,Female
Dimond,2007,11,11,0,100.0,0.0,Female
Marley,2007,978,839,139,85.78732106339469,14.212678936605316,Female
Bridie,2007,6,6,0,100.0,0.0,Female
Xaviera,2007,16,16,0,100.0,0.0,Female
Giara,2007,9,9,0,100.0,0.0,Female
Keyri,2007,38,38,0,100.0,0.0,Female
Maximilliano,2007,15,0,15,0.0,100.0,Male
Grey,2007,117,14,103,11.965811965811966,88.03418803418803,Male
Quanell,2007,8,0,8,0.0,100.0,Male
Vijay,2007,34,0,34,0.0,100.0,Male
Elgin,2007,21,0,21,0.0,100.0,Male
Briyan,2007,9,0,9,0.0,100.0,Male
Jakel,2007,17,0,17,0.0,100.0,Male
Hayzen,2007,9,0,9,0.0,100.0,Male
Thoren,2007,7,0,7,0.0,100.0,Male
Khalon,2007,16,0,16,0.0,100.0,Male
Devarion,2007,8,0,8,0.0,100.0,Male
Tyshon,2007,49,0,49,0.0,100.0,Male
Dion,2007,200,7,193,3.5000000000000004,96.5,Male
Che,2007,29,0,29,0.0,100.0,Male
Kaedin,2007,30,0,30,0.0,100.0,Male
Erza,2007,5,0,5,0.0,100.0,Male
Damain,2007,7,0,7,0.0,100.0,Male
Obie,2007,22,0,22,0.0,100.0,Male
Adlai,2007,19,0,19,0.0,100.0,Male
Summit,2007,20,0,20,0.0,100.0,Male
Uzziel,2007,32,0,32,0.0,100.0,Male
Enoch,2007,149,0,149,0.0,100.0,Male
Xzaveon,2007,7,0,7,0.0,100.0,Male
Aniket,2007,16,0,16,0.0,100.0,Male
Daysen,2007,11,0,11,0.0,100.0,Male
Azjon,2007,5,0,5,0.0,100.0,Male
Zaeveon,2007,6,0,6,0.0,100.0,Male
Adyan,2007,11,0,11,0.0,100.0,Male
Emmanual,2007,10,0,10,0.0,100.0,Male
Kamerion,2007,7,0,7,0.0,100.0,Male
Tanay,2007,50,12,38,24.0,76.0,Unisex
Edy,2007,32,14,18,43.75,56.25,Unisex
Memphis,2007,323,52,271,16.09907120743034,83.90092879256966,Unisex
Raylan,2007,16,9,7,56.25,43.75,Unisex
Aviv,2007,37,16,21,43.24324324324324,56.75675675675676,Unisex
Dasani,2007,82,65,17,79.26829268292683,20.73170731707317,Unisex
Milen,2007,10,5,5,50.0,50.0,Unisex
Aries,2007,159,79,80,49.685534591194966,50.31446540880504,Unisex
Haydin,2007,68,22,46,32.35294117647059,67.64705882352942,Unisex
Corrie,2007,33,19,14,57.57575757575758,42.42424242424242,Unisex
Camerin,2007,52,10,42,19.23076923076924,80.76923076923077,Unisex
Hampton,2007,64,11,53,17.1875,82.8125,Unisex
Torrance,2007,72,28,44,38.88888888888889,61.11111111111112,Unisex
Kodi,2007,110,50,60,45.45454545454545,54.54545454545454,Unisex
Adair,2007,120,20,100,16.666666666666664,83.33333333333334,Unisex
Taygen,2007,31,12,19,38.70967741935484,61.29032258064516,Unisex
Ikram,2007,18,12,6,66.66666666666666,33.33333333333333,Unisex
Taren,2007,21,9,12,42.85714285714285,57.14285714285714,Unisex
Tayler,2007,290,242,48,83.44827586206897,16.551724137931036,Unisex
Tsering,2007,13,5,8,38.46153846153847,61.53846153846154,Unisex
Miciah,2007,25,12,13,48.0,52.0,Unisex
Cayce,2007,25,19,6,76.0,24.0,Unisex
Jaryn,2007,31,13,18,41.935483870967744,58.06451612903226,Unisex
Kylar,2007,91,35,56,38.46153846153847,61.53846153846154,Unisex
Bentley,2007,276,81,195,29.347826086956523,70.65217391304348,Unisex
Kobi,2007,69,19,50,27.536231884057973,72.46376811594203,Unisex
Kyree,2007,171,32,139,18.71345029239766,81.28654970760235,Unisex
Olamide,2007,17,11,6,64.70588235294117,35.294117647058826,Unisex
Avan,2007,36,6,30,16.666666666666664,83.33333333333334,Unisex
Emile,2007,56,15,41,26.785714285714285,73.21428571428571,Unisex
Sofija,2008,19,19,0,100.0,0.0,Female
Rubi,2008,531,531,0,100.0,0.0,Female
Haydee,2008,87,87,0,100.0,0.0,Female
Brynnleigh,2008,7,7,0,100.0,0.0,Female
Caytlyn,2008,5,5,0,100.0,0.0,Female
Nina,2008,1228,1228,0,100.0,0.0,Female
Aleecia,2008,30,30,0,100.0,0.0,Female
Zanijah,2008,12,12,0,100.0,0.0,Female
Naia,2008,57,57,0,100.0,0.0,Female
Batya,2008,12,12,0,100.0,0.0,Female
Daliana,2008,12,12,0,100.0,0.0,Female
Dayiana,2008,5,5,0,100.0,0.0,Female
Nadelyn,2008,5,5,0,100.0,0.0,Female
Ski,2008,10,10,0,100.0,0.0,Female
Samayia,2008,5,5,0,100.0,0.0,Female
Maleaha,2008,8,8,0,100.0,0.0,Female
Mana,2008,17,17,0,100.0,0.0,Female
Story,2008,72,72,0,100.0,0.0,Female
Kaibree,2008,7,7,0,100.0,0.0,Female
Arielys,2008,12,12,0,100.0,0.0,Female
Aoki,2008,21,21,0,100.0,0.0,Female
Roshell,2008,5,5,0,100.0,0.0,Female
Adah,2008,65,65,0,100.0,0.0,Female
Keidy,2008,18,18,0,100.0,0.0,Female
Cella,2008,8,8,0,100.0,0.0,Female
Karlee,2008,511,511,0,100.0,0.0,Female
Noell,2008,12,12,0,100.0,0.0,Female
Callia,2008,20,20,0,100.0,0.0,Female
Addysen,2008,119,119,0,100.0,0.0,Female
Arline,2008,9,9,0,100.0,0.0,Female
Javien,2008,126,0,126,0.0,100.0,Male
Wynston,2008,15,0,15,0.0,100.0,Male
Dalson,2008,6,0,6,0.0,100.0,Male
Mordche,2008,10,0,10,0.0,100.0,Male
Ralph,2008,247,0,247,0.0,100.0,Male
Jasaiah,2008,6,0,6,0.0,100.0,Male
Xayden,2008,21,0,21,0.0,100.0,Male
Xion,2008,23,0,23,0.0,100.0,Male
Theoden,2008,7,0,7,0.0,100.0,Male
Areg,2008,6,0,6,0.0,100.0,Male
Brenin,2008,11,0,11,0.0,100.0,Male
Daegon,2008,16,0,16,0.0,100.0,Male
Rykin,2008,9,0,9,0.0,100.0,Male
Bricyn,2008,5,0,5,0.0,100.0,Male
Graisen,2008,5,0,5,0.0,100.0,Male
Javonta,2008,27,0,27,0.0,100.0,Male
Szymon,2008,27,0,27,0.0,100.0,Male
Kolson,2008,13,0,13,0.0,100.0,Male
Asaph,2008,11,0,11,0.0,100.0,Male
Fernando,2008,2388,5,2383,0.2093802345058626,99.79061976549414,Male
Jordon,2008,285,26,259,9.12280701754386,90.87719298245617,Male
Javori,2008,5,0,5,0.0,100.0,Male
Jacaden,2008,7,0,7,0.0,100.0,Male
Guthrie,2008,14,0,14,0.0,100.0,Male
Benedict,2008,101,0,101,0.0,100.0,Male
Josuha,2008,5,0,5,0.0,100.0,Male
Jax,2008,343,0,343,0.0,100.0,Male
Quest,2008,11,0,11,0.0,100.0,Male
Tre,2008,110,0,110,0.0,100.0,Male
Marrio,2008,6,0,6,0.0,100.0,Male
Rogue,2008,29,18,11,62.06896551724138,37.93103448275862,Unisex
Rhythm,2008,20,13,7,65.0,35.0,Unisex
Tobie,2008,28,14,14,50.0,50.0,Unisex
Kellin,2008,20,5,15,25.0,75.0,Unisex
Heli,2008,11,6,5,54.54545454545454,45.45454545454545,Unisex
Amarri,2008,29,10,19,34.48275862068966,65.51724137931035,Unisex
River,2008,859,249,610,28.987194412107105,71.0128055878929,Unisex
Kemauri,2008,38,7,31,18.421052631578945,81.57894736842105,Unisex
Kalin,2008,77,39,38,50.64935064935064,49.35064935064935,Unisex
Daylin,2008,148,72,76,48.64864864864865,51.35135135135135,Unisex
Valen,2008,34,8,26,23.52941176470588,76.47058823529412,Unisex
Kymani,2008,349,91,258,26.07449856733524,73.92550143266476,Unisex
Kymoni,2008,11,5,6,45.45454545454545,54.54545454545454,Unisex
Anel,2008,49,37,12,75.51020408163265,24.489795918367346,Unisex
Mateja,2008,12,7,5,58.333333333333336,41.66666666666667,Unisex
Zahmari,2008,11,5,6,45.45454545454545,54.54545454545454,Unisex
Denis,2008,166,34,132,20.48192771084337,79.51807228915662,Unisex
Reace,2008,16,7,9,43.75,56.25,Unisex
Asani,2008,18,12,6,66.66666666666666,33.33333333333333,Unisex
Braylyn,2008,69,37,32,53.62318840579711,46.3768115942029,Unisex
Wisdom,2008,64,33,31,51.5625,48.4375,Unisex
Oluwaseun,2008,19,9,10,47.368421052631575,52.63157894736842,Unisex
Anh,2008,45,35,10,77.77777777777779,22.22222222222222,Unisex
Ami,2008,106,79,27,74.52830188679245,25.471698113207548,Unisex
Aarin,2008,25,9,16,36.0,64.0,Unisex
Timber,2008,39,27,12,69.23076923076923,30.76923076923077,Unisex
Zarin,2008,19,9,10,47.368421052631575,52.63157894736842,Unisex
Rielly,2008,25,16,9,64.0,36.0,Unisex
Coty,2008,26,5,21,19.23076923076924,80.76923076923077,Unisex
Kyri,2008,26,20,6,76.92307692307693,23.07692307692308,Unisex
Carlisa,2009,5,5,0,100.0,0.0,Female
Shamaya,2009,27,27,0,100.0,0.0,Female
Rivky,2009,63,63,0,100.0,0.0,Female
Aubrea,2009,23,23,0,100.0,0.0,Female
Issabella,2009,121,121,0,100.0,0.0,Female
Tzippy,2009,8,8,0,100.0,0.0,Female
Camilla,2009,552,552,0,100.0,0.0,Female
Evlyn,2009,10,10,0,100.0,0.0,Female
Estrella,2009,768,768,0,100.0,0.0,Female
Rahmah,2009,6,6,0,100.0,0.0,Female
Ariyannah,2009,15,15,0,100.0,0.0,Female
Nayelly,2009,18,18,0,100.0,0.0,Female
Emiyah,2009,37,37,0,100.0,0.0,Female
Meranda,2009,27,27,0,100.0,0.0,Female
Chimamanda,2009,7,7,0,100.0,0.0,Female
Shine,2009,13,13,0,100.0,0.0,Female
Isabelly,2009,6,6,0,100.0,0.0,Female
Skarlette,2009,5,5,0,100.0,0.0,Female
Samya,2009,187,187,0,100.0,0.0,Female
Kimorra,2009,7,7,0,100.0,0.0,Female
Shastelyn,2009,35,35,0,100.0,0.0,Female
Danaria,2009,9,9,0,100.0,0.0,Female
Avary,2009,89,84,5,94.3820224719101,5.617977528089887,Female
Dailynne,2009,6,6,0,100.0,0.0,Female
Lexany,2009,10,10,0,100.0,0.0,Female
Nyajah,2009,7,7,0,100.0,0.0,Female
Nyera,2009,5,5,0,100.0,0.0,Female
Taliyha,2009,6,6,0,100.0,0.0,Female
Kiyara,2009,16,16,0,100.0,0.0,Female
Kaileen,2009,19,19,0,100.0,0.0,Female
Maximos,2009,29,0,29,0.0,100.0,Male
Elston,2009,9,0,9,0.0,100.0,Male
Zedrick,2009,10,0,10,0.0,100.0,Male
Aksel,2009,54,0,54,0.0,100.0,Male
Cashius,2009,22,0,22,0.0,100.0,Male
Scot,2009,17,0,17,0.0,100.0,Male
Rashaun,2009,64,0,64,0.0,100.0,Male
Izaiyah,2009,16,0,16,0.0,100.0,Male
Azden,2009,5,0,5,0.0,100.0,Male
Jaymeson,2009,30,0,30,0.0,100.0,Male
Arrion,2009,8,0,8,0.0,100.0,Male
Jabdiel,2009,5,0,5,0.0,100.0,Male
Zalen,2009,20,0,20,0.0,100.0,Male
Yadriel,2009,15,0,15,0.0,100.0,Male
Bowdy,2009,6,0,6,0.0,100.0,Male
Briggs,2009,146,0,146,0.0,100.0,Male
Ezequiel,2009,466,0,466,0.0,100.0,Male
Rydell,2009,7,0,7,0.0,100.0,Male
Arash,2009,6,0,6,0.0,100.0,Male
Koen,2009,216,0,216,0.0,100.0,Male
Mathieu,2009,70,0,70,0.0,100.0,Male
Tayvon,2009,52,0,52,0.0,100.0,Male
Vitor,2009,6,0,6,0.0,100.0,Male
Pruitt,2009,5,0,5,0.0,100.0,Male
Terrion,2009,72,5,67,6.944444444444445,93.05555555555556,Male
Aydenn,2009,19,0,19,0.0,100.0,Male
Emilliano,2009,5,0,5,0.0,100.0,Male
Amario,2009,8,0,8,0.0,100.0,Male
Sandeep,2009,7,0,7,0.0,100.0,Male
Zayn,2009,55,0,55,0.0,100.0,Male
Tagen,2009,24,9,15,37.5,62.5,Unisex
Neri,2009,65,12,53,18.461538461538463,81.53846153846153,Unisex
Yuri,2009,127,80,47,62.99212598425197,37.00787401574803,Unisex
Cache,2009,53,8,45,15.09433962264151,84.90566037735849,Unisex
Jimi,2009,21,6,15,28.57142857142857,71.42857142857143,Unisex
Stephane,2009,17,7,10,41.17647058823529,58.82352941176471,Unisex
Tal,2009,22,6,16,27.27272727272727,72.72727272727273,Unisex
Erion,2009,40,10,30,25.0,75.0,Unisex
Kodie,2009,65,30,35,46.15384615384615,53.84615384615385,Unisex
Aries,2009,153,63,90,41.17647058823529,58.82352941176471,Unisex
Toluwani,2009,13,8,5,61.53846153846154,38.46153846153847,Unisex
Tyjah,2009,15,7,8,46.66666666666666,53.333333333333336,Unisex
Edy,2009,36,13,23,36.11111111111111,63.888888888888886,Unisex
Alija,2009,12,5,7,41.66666666666667,58.333333333333336,Unisex
Maycen,2009,12,7,5,58.333333333333336,41.66666666666667,Unisex
Timber,2009,46,25,21,54.34782608695652,45.65217391304348,Unisex
Aziah,2009,63,39,24,61.90476190476191,38.095238095238095,Unisex
Etienne,2009,47,8,39,17.02127659574468,82.97872340425532,Unisex
Skylen,2009,15,6,9,40.0,60.0,Unisex
Tennessee,2009,13,7,6,53.84615384615385,46.15384615384615,Unisex
Massiah,2009,30,6,24,20.0,80.0,Unisex
Afton,2009,105,82,23,78.0952380952381,21.904761904761905,Unisex
Cashmere,2009,49,30,19,61.224489795918366,38.775510204081634,Unisex
Hani,2009,22,7,15,31.818181818181817,68.18181818181817,Unisex
Kanon,2009,53,8,45,15.09433962264151,84.90566037735849,Unisex
Yuki,2009,44,21,23,47.72727272727273,52.27272727272727,Unisex
Skylor,2009,35,10,25,28.57142857142857,71.42857142857143,Unisex
Rani,2009,30,25,5,83.33333333333334,16.666666666666664,Unisex
Jermani,2009,35,26,9,74.28571428571429,25.71428571428571,Unisex
Reise,2009,21,13,8,61.90476190476191,38.095238095238095,Unisex
Khylie,2010,41,41,0,100.0,0.0,Female
Abbigayle,2010,63,63,0,100.0,0.0,Female
Aloura,2010,11,11,0,100.0,0.0,Female
Nelli,2010,13,13,0,100.0,0.0,Female
Karee,2010,7,7,0,100.0,0.0,Female
Danna,2010,1231,1226,5,99.59382615759546,0.4061738424045491,Female
Carleen,2010,11,11,0,100.0,0.0,Female
Talullah,2010,6,6,0,100.0,0.0,Female
Genavieve,2010,36,36,0,100.0,0.0,Female
Maleiah,2010,15,15,0,100.0,0.0,Female
Dazya,2010,6,6,0,100.0,0.0,Female
Anella,2010,12,12,0,100.0,0.0,Female
Adjoa,2010,5,5,0,100.0,0.0,Female
Haylie,2010,351,351,0,100.0,0.0,Female
Gisela,2010,68,68,0,100.0,0.0,Female
Mayra,2010,307,307,0,100.0,0.0,Female
Kaylyn,2010,355,355,0,100.0,0.0,Female
Adamari,2010,115,115,0,100.0,0.0,Female
Vrinda,2010,17,17,0,100.0,0.0,Female
Kurstin,2010,5,5,0,100.0,0.0,Female
Armony,2010,8,8,0,100.0,0.0,Female
Anjelika,2010,6,6,0,100.0,0.0,Female
Deona,2010,15,15,0,100.0,0.0,Female
Tifani,2010,7,7,0,100.0,0.0,Female
Laika,2010,5,5,0,100.0,0.0,Female
Yazlyn,2010,15,15,0,100.0,0.0,Female
Braleigh,2010,35,35,0,100.0,0.0,Female
Emelie,2010,61,61,0,100.0,0.0,Female
Imanie,2010,8,8,0,100.0,0.0,Female
Nicha,2010,8,8,0,100.0,0.0,Female
Brynner,2010,6,0,6,0.0,100.0,Male
Jaycob,2010,234,0,234,0.0,100.0,Male
Ihsan,2010,15,0,15,0.0,100.0,Male
Deantoine,2010,5,0,5,0.0,100.0,Male
Luchiano,2010,7,0,7,0.0,100.0,Male
Vishak,2010,6,0,6,0.0,100.0,Male
Smith,2010,78,0,78,0.0,100.0,Male
Trezden,2010,6,0,6,0.0,100.0,Male
Cooper,2010,5344,85,5259,1.5905688622754492,98.40943113772454,Male
Jobani,2010,8,0,8,0.0,100.0,Male
Marcus,2010,3134,5,3129,0.1595405232929164,99.84045947670708,Male
Kenan,2010,93,5,88,5.376344086021505,94.6236559139785,Male
Jahshua,2010,5,0,5,0.0,100.0,Male
Kanari,2010,8,0,8,0.0,100.0,Male
Quintavious,2010,19,0,19,0.0,100.0,Male
Esa,2010,19,0,19,0.0,100.0,Male
Jossue,2010,20,0,20,0.0,100.0,Male
Roanin,2010,8,0,8,0.0,100.0,Male
Azmi,2010,5,0,5,0.0,100.0,Male
Nicholaus,2010,16,0,16,0.0,100.0,Male
Hisham,2010,17,0,17,0.0,100.0,Male
Shlok,2010,34,0,34,0.0,100.0,Male
Brycyn,2010,5,0,5,0.0,100.0,Male
Deveion,2010,6,0,6,0.0,100.0,Male
Raunak,2010,8,0,8,0.0,100.0,Male
Cullen,2010,685,6,679,0.8759124087591241,99.12408759124088,Male
Orlandis,2010,6,0,6,0.0,100.0,Male
Brevan,2010,10,0,10,0.0,100.0,Male
Edris,2010,15,0,15,0.0,100.0,Male
Boyce,2010,7,0,7,0.0,100.0,Male
Quin,2010,60,20,40,33.33333333333333,66.66666666666666,Unisex
Zuriel,2010,83,13,70,15.66265060240964,84.33734939759037,Unisex
Harlem,2010,133,31,102,23.308270676691727,76.69172932330827,Unisex
Payden,2010,115,52,63,45.21739130434783,54.78260869565217,Unisex
Katriel,2010,30,20,10,66.66666666666666,33.33333333333333,Unisex
Makari,2010,43,7,36,16.27906976744186,83.72093023255815,Unisex
Dee,2010,10,5,5,50.0,50.0,Unisex
Ryver,2010,34,17,17,50.0,50.0,Unisex
Dyllan,2010,150,37,113,24.666666666666668,75.33333333333333,Unisex
Izzy,2010,54,41,13,75.92592592592592,24.07407407407408,Unisex
Nihal,2010,33,6,27,18.181818181818183,81.81818181818183,Unisex
Blayke,2010,68,30,38,44.11764705882353,55.88235294117647,Unisex
Kit,2010,23,13,10,56.52173913043478,43.47826086956522,Unisex
Jaydynn,2010,11,6,5,54.54545454545454,45.45454545454545,Unisex
Rayn,2010,35,23,12,65.71428571428571,34.285714285714285,Unisex
Sinclair,2010,16,5,11,31.25,68.75,Unisex
Jamani,2010,21,10,11,47.61904761904761,52.38095238095239,Unisex
Kenyatta,2010,32,11,21,34.375,65.625,Unisex
Kashmere,2010,21,14,7,66.66666666666666,33.33333333333333,Unisex
Zhane,2010,33,27,6,81.81818181818183,18.181818181818183,Unisex
Asanti,2010,17,8,9,47.05882352941176,52.94117647058824,Unisex
Kamoni,2010,30,19,11,63.33333333333333,36.66666666666666,Unisex
Paxtyn,2010,37,16,21,43.24324324324324,56.75675675675676,Unisex
Yanis,2010,17,7,10,41.17647058823529,58.82352941176471,Unisex
Halen,2010,72,25,47,34.72222222222222,65.27777777777779,Unisex
Maysen,2010,64,35,29,54.6875,45.3125,Unisex
Satori,2010,19,14,5,73.68421052631578,26.31578947368421,Unisex
Kellyn,2010,69,56,13,81.15942028985508,18.84057971014493,Unisex
Hannan,2010,18,13,5,72.22222222222221,27.77777777777778,Unisex
Temiloluwa,2010,21,10,11,47.61904761904761,52.38095238095239,Unisex
Jazzleen,2011,5,5,0,100.0,0.0,Female
Madailein,2011,13,13,0,100.0,0.0,Female
Graelyn,2011,11,11,0,100.0,0.0,Female
Hrithika,2011,5,5,0,100.0,0.0,Female
Shayonna,2011,6,6,0,100.0,0.0,Female
Zuzanna,2011,40,40,0,100.0,0.0,Female
Bahati,2011,5,5,0,100.0,0.0,Female
Jessia,2011,5,5,0,100.0,0.0,Female
Alajiah,2011,7,7,0,100.0,0.0,Female
Jaiyanna,2011,10,10,0,100.0,0.0,Female
Javaya,2011,6,6,0,100.0,0.0,Female
Joclyn,2011,14,14,0,100.0,0.0,Female
Ona,2011,28,28,0,100.0,0.0,Female
Graziella,2011,15,15,0,100.0,0.0,Female
Jacinda,2011,32,32,0,100.0,0.0,Female
Evolett,2011,18,18,0,100.0,0.0,Female
Kadience,2011,29,29,0,100.0,0.0,Female
Annabelle,2011,2729,2729,0,100.0,0.0,Female
Lynette,2011,91,91,0,100.0,0.0,Female
Evolette,2011,19,19,0,100.0,0.0,Female
Sofee,2011,10,10,0,100.0,0.0,Female
Seleen,2011,5,5,0,100.0,0.0,Female
Naiomi,2011,39,39,0,100.0,0.0,Female
Yuliette,2011,5,5,0,100.0,0.0,Female
Taqwa,2011,7,7,0,100.0,0.0,Female
Astraea,2011,5,5,0,100.0,0.0,Female
Claira,2011,125,125,0,100.0,0.0,Female
Delany,2011,38,38,0,100.0,0.0,Female
Aneliz,2011,18,18,0,100.0,0.0,Female
Lalani,2011,20,20,0,100.0,0.0,Female
Abdulhamid,2011,9,0,9,0.0,100.0,Male
Jeremaih,2011,23,0,23,0.0,100.0,Male
Axsel,2011,9,0,9,0.0,100.0,Male
Rhett,2011,454,7,447,1.5418502202643172,98.45814977973568,Male
Philopater,2011,9,0,9,0.0,100.0,Male
Tavarius,2011,14,0,14,0.0,100.0,Male
Thomas,2011,6934,10,6924,0.1442169022209403,99.85578309777908,Male
Dreyden,2011,41,0,41,0.0,100.0,Male
Emmitt,2011,284,0,284,0.0,100.0,Male
Antron,2011,11,0,11,0.0,100.0,Male
Keevon,2011,7,0,7,0.0,100.0,Male
Amir,2011,1400,16,1384,1.1428571428571428,98.85714285714286,Male
Ernest,2011,253,0,253,0.0,100.0,Male
Mishael,2011,7,0,7,0.0,100.0,Male
Armin,2011,45,0,45,0.0,100.0,Male
Jhovany,2011,17,0,17,0.0,100.0,Male
Oswaldo,2011,95,0,95,0.0,100.0,Male
Jeanmarc,2011,7,0,7,0.0,100.0,Male
Jahaziah,2011,7,0,7,0.0,100.0,Male
Denley,2011,10,0,10,0.0,100.0,Male
Giovanie,2011,12,0,12,0.0,100.0,Male
Snyder,2011,5,0,5,0.0,100.0,Male
Daren,2011,76,0,76,0.0,100.0,Male
Denny,2011,68,0,68,0.0,100.0,Male
Ryzen,2011,5,0,5,0.0,100.0,Male
Aaren,2011,19,0,19,0.0,100.0,Male
Zayvon,2011,7,0,7,0.0,100.0,Male
Nathin,2011,8,0,8,0.0,100.0,Male
Silas,2011,2117,0,2117,0.0,100.0,Male
Jayko,2011,12,0,12,0.0,100.0,Male
Avyn,2011,33,18,15,54.54545454545454,45.45454545454545,Unisex
Akai,2011,25,6,19,24.0,76.0,Unisex
Stoney,2011,18,5,13,27.77777777777778,72.22222222222221,Unisex
Palmer,2011,161,67,94,41.61490683229814,58.38509316770186,Unisex
Karsyn,2011,490,412,78,84.08163265306122,15.918367346938776,Unisex
Ziyan,2011,23,16,7,69.56521739130434,30.434782608695656,Unisex
Destine,2011,15,7,8,46.66666666666666,53.333333333333336,Unisex
Jaidynn,2011,32,26,6,81.25,18.75,Unisex
Tien,2011,28,7,21,25.0,75.0,Unisex
Kamoni,2011,33,15,18,45.45454545454545,54.54545454545454,Unisex
Kebron,2011,13,6,7,46.15384615384615,53.84615384615385,Unisex
Jamey,2011,39,24,15,61.53846153846154,38.46153846153847,Unisex
Erza,2011,11,5,6,45.45454545454545,54.54545454545454,Unisex
Aseel,2011,47,37,10,78.72340425531915,21.27659574468085,Unisex
Johanny,2011,23,13,10,56.52173913043478,43.47826086956522,Unisex
Jessi,2011,97,77,20,79.38144329896907,20.61855670103093,Unisex
Keilin,2011,14,9,5,64.28571428571429,35.714285714285715,Unisex
Lamari,2011,24,5,19,20.833333333333336,79.16666666666666,Unisex
Daylin,2011,143,69,74,48.25174825174825,51.74825174825175,Unisex
Kaydn,2011,24,7,17,29.166666666666668,70.83333333333334,Unisex
Tracy,2011,177,106,71,59.88700564971752,40.11299435028249,Unisex
Ziyon,2011,67,13,54,19.402985074626866,80.59701492537313,Unisex
Charley,2011,547,462,85,84.46069469835467,15.539305301645337,Unisex
Braylin,2011,307,87,220,28.33876221498372,71.66123778501628,Unisex
Elim,2011,20,8,12,40.0,60.0,Unisex
Kyndell,2011,39,31,8,79.48717948717949,20.51282051282051,Unisex
Aviv,2011,23,6,17,26.08695652173913,73.91304347826086,Unisex
Damonie,2011,18,11,7,61.11111111111112,38.88888888888889,Unisex
Rowan,2011,1591,544,1047,34.19233186675047,65.80766813324954,Unisex
Riely,2011,14,7,7,50.0,50.0,Unisex
Ziyah,2012,52,52,0,100.0,0.0,Female
Jacalyn,2012,5,5,0,100.0,0.0,Female
Christiona,2012,5,5,0,100.0,0.0,Female
Chantal,2012,49,49,0,100.0,0.0,Female
Nahomy,2012,82,82,0,100.0,0.0,Female
Meryl,2012,34,34,0,100.0,0.0,Female
Fareedah,2012,7,7,0,100.0,0.0,Female
Zoila,2012,20,20,0,100.0,0.0,Female
Caia,2012,32,32,0,100.0,0.0,Female
Samya,2012,173,173,0,100.0,0.0,Female
Lydiah,2012,21,21,0,100.0,0.0,Female
Harlynn,2012,27,27,0,100.0,0.0,Female
Emilyne,2012,6,6,0,100.0,0.0,Female
Mellissa,2012,6,6,0,100.0,0.0,Female
Anessah,2012,6,6,0,100.0,0.0,Female
Marchella,2012,5,5,0,100.0,0.0,Female
Esveidy,2012,5,5,0,100.0,0.0,Female
Rashmika,2012,5,5,0,100.0,0.0,Female
Cheyenna,2012,5,5,0,100.0,0.0,Female
Samina,2012,17,17,0,100.0,0.0,Female
Litzi,2012,11,11,0,100.0,0.0,Female
Matilda,2012,432,432,0,100.0,0.0,Female
Suzana,2012,15,15,0,100.0,0.0,Female
Zoriana,2012,8,8,0,100.0,0.0,Female
Ritisha,2012,8,8,0,100.0,0.0,Female
Taeya,2012,10,10,0,100.0,0.0,Female
Deem,2012,8,8,0,100.0,0.0,Female
Natalia,2012,2594,2594,0,100.0,0.0,Female
Divya,2012,81,76,5,93.82716049382717,6.172839506172839,Female
Lianni,2012,11,11,0,100.0,0.0,Female
Dharius,2012,6,0,6,0.0,100.0,Male
Mackson,2012,10,0,10,0.0,100.0,Male
Anurag,2012,9,0,9,0.0,100.0,Male
Dayln,2012,7,0,7,0.0,100.0,Male
Kent,2012,114,0,114,0.0,100.0,Male
Zylon,2012,7,0,7,0.0,100.0,Male
Dallon,2012,14,0,14,0.0,100.0,Male
Klaus,2012,9,0,9,0.0,100.0,Male
Javid,2012,11,0,11,0.0,100.0,Male
Javani,2012,10,0,10,0.0,100.0,Male
Juanmanuel,2012,14,0,14,0.0,100.0,Male
Jheremy,2012,6,0,6,0.0,100.0,Male
Abrahan,2012,26,0,26,0.0,100.0,Male
Arthor,2012,5,0,5,0.0,100.0,Male
Sufyaan,2012,8,0,8,0.0,100.0,Male
Kamal,2012,53,0,53,0.0,100.0,Male
Jayant,2012,11,0,11,0.0,100.0,Male
Zamare,2012,5,0,5,0.0,100.0,Male
Hairo,2012,8,0,8,0.0,100.0,Male
Jayzin,2012,5,0,5,0.0,100.0,Male
Isaiahs,2012,13,0,13,0.0,100.0,Male
Pierre,2012,192,0,192,0.0,100.0,Male
Akshan,2012,5,0,5,0.0,100.0,Male
Xavy,2012,5,0,5,0.0,100.0,Male
Zan,2012,7,0,7,0.0,100.0,Male
Kieffer,2012,8,0,8,0.0,100.0,Male
Aagam,2012,8,0,8,0.0,100.0,Male
Derreck,2012,10,0,10,0.0,100.0,Male
Jayvin,2012,62,0,62,0.0,100.0,Male
Jerred,2012,6,0,6,0.0,100.0,Male
Lynden,2012,59,30,29,50.84745762711864,49.15254237288136,Unisex
Shayden,2012,52,8,44,15.384615384615383,84.61538461538461,Unisex
Zareth,2012,11,6,5,54.54545454545454,45.45454545454545,Unisex
Rei,2012,24,16,8,66.66666666666666,33.33333333333333,Unisex
Cire,2012,23,9,14,39.130434782608695,60.86956521739131,Unisex
Adama,2012,31,15,16,48.38709677419355,51.61290322580645,Unisex
Rilyn,2012,120,100,20,83.33333333333334,16.666666666666664,Unisex
Tylynn,2012,26,21,5,80.76923076923077,19.23076923076924,Unisex
Blu,2012,17,10,7,58.82352941176471,41.17647058823529,Unisex
Dezi,2012,38,24,14,63.1578947368421,36.84210526315789,Unisex
Adore,2012,26,18,8,69.23076923076923,30.76923076923077,Unisex
Elizah,2012,38,30,8,78.94736842105263,21.052631578947366,Unisex
Kamauri,2012,57,19,38,33.33333333333333,66.66666666666666,Unisex
Loyal,2012,51,8,43,15.68627450980392,84.31372549019608,Unisex
Jasani,2012,33,22,11,66.66666666666666,33.33333333333333,Unisex
Mecca,2012,29,17,12,58.620689655172406,41.37931034482759,Unisex
Everette,2012,56,12,44,21.428571428571427,78.57142857142857,Unisex
Harjas,2012,12,6,6,50.0,50.0,Unisex
Lyrick,2012,30,11,19,36.66666666666666,63.33333333333333,Unisex
Surya,2012,54,10,44,18.51851851851852,81.48148148148148,Unisex
Tennessee,2012,27,16,11,59.25925925925925,40.74074074074074,Unisex
Nyaire,2012,12,7,5,58.333333333333336,41.66666666666667,Unisex
Nijah,2012,23,12,11,52.17391304347826,47.82608695652174,Unisex
Lennie,2012,13,6,7,46.15384615384615,53.84615384615385,Unisex
Gabryel,2012,24,8,16,33.33333333333333,66.66666666666666,Unisex
Dayan,2012,27,6,21,22.22222222222222,77.77777777777779,Unisex
Joey,2012,487,83,404,17.04312114989733,82.95687885010267,Unisex
Jourdyn,2012,43,33,10,76.74418604651163,23.25581395348837,Unisex
Cayman,2012,29,6,23,20.6896551724138,79.3103448275862,Unisex
Ami,2012,100,67,33,67.0,33.0,Unisex
Kasiah,2013,9,9,0,100.0,0.0,Female
Cyanne,2013,6,6,0,100.0,0.0,Female
Rodina,2013,18,18,0,100.0,0.0,Female
Kamia,2013,66,66,0,100.0,0.0,Female
Kirstyn,2013,25,25,0,100.0,0.0,Female
Aaleeyah,2013,13,13,0,100.0,0.0,Female
Bridgit,2013,16,16,0,100.0,0.0,Female
Raha,2013,8,8,0,100.0,0.0,Female
Jaylene,2013,382,382,0,100.0,0.0,Female
Rainbow,2013,16,16,0,100.0,0.0,Female
Emunah,2013,18,18,0,100.0,0.0,Female
Lailynn,2013,14,14,0,100.0,0.0,Female
Karah,2013,62,62,0,100.0,0.0,Female
Jaylah,2013,1366,1366,0,100.0,0.0,Female
Shatori,2013,6,6,0,100.0,0.0,Female
Aimee,2013,359,359,0,100.0,0.0,Female
Nysha,2013,11,11,0,100.0,0.0,Female
Radha,2013,34,34,0,100.0,0.0,Female
Elisabeth,2013,460,460,0,100.0,0.0,Female
Koraima,2013,5,5,0,100.0,0.0,Female
Jesslynn,2013,44,44,0,100.0,0.0,Female
Ashly,2013,109,109,0,100.0,0.0,Female
Skarleth,2013,10,10,0,100.0,0.0,Female
Talula,2013,22,22,0,100.0,0.0,Female
Kasie,2013,18,18,0,100.0,0.0,Female
Jennicka,2013,15,15,0,100.0,0.0,Female
Azayla,2013,20,20,0,100.0,0.0,Female
Lyssa,2013,16,16,0,100.0,0.0,Female
Dana,2013,402,373,29,92.7860696517413,7.213930348258707,Female
Emberli,2013,7,7,0,100.0,0.0,Female
Didier,2013,30,0,30,0.0,100.0,Male
Keshun,2013,8,0,8,0.0,100.0,Male
Lukus,2013,43,0,43,0.0,100.0,Male
Gianluka,2013,6,0,6,0.0,100.0,Male
Dewayne,2013,115,0,115,0.0,100.0,Male
Zacharias,2013,49,0,49,0.0,100.0,Male
Jahid,2013,6,0,6,0.0,100.0,Male
Daquan,2013,86,0,86,0.0,100.0,Male
Naphtali,2013,6,0,6,0.0,100.0,Male
Myles,2013,1644,8,1636,0.48661800486618,99.51338199513384,Male
Nate,2013,113,0,113,0.0,100.0,Male
Kashten,2013,6,0,6,0.0,100.0,Male
Johntez,2013,5,0,5,0.0,100.0,Male
Jaidin,2013,7,0,7,0.0,100.0,Male
Percival,2013,8,0,8,0.0,100.0,Male
Rayland,2013,29,0,29,0.0,100.0,Male
Quintin,2013,250,0,250,0.0,100.0,Male
Marshawn,2013,63,0,63,0.0,100.0,Male
Eldad,2013,5,0,5,0.0,100.0,Male
Nihar,2013,9,0,9,0.0,100.0,Male
Jostyn,2013,6,0,6,0.0,100.0,Male
Ondre,2013,6,0,6,0.0,100.0,Male
Ottis,2013,8,0,8,0.0,100.0,Male
Marqus,2013,12,0,12,0.0,100.0,Male
Tavyn,2013,9,0,9,0.0,100.0,Male
Adante,2013,6,0,6,0.0,100.0,Male
Vaughn,2013,268,21,247,7.835820895522389,92.1641791044776,Male
Eivin,2013,22,0,22,0.0,100.0,Male
Amire,2013,44,6,38,13.636363636363637,86.36363636363636,Male
Jairo,2013,285,0,285,0.0,100.0,Male
Romani,2013,19,6,13,31.57894736842105,68.42105263157895,Unisex
Darrian,2013,49,10,39,20.40816326530612,79.59183673469387,Unisex
Bradleigh,2013,19,14,5,73.68421052631578,26.31578947368421,Unisex
Dominque,2013,20,7,13,35.0,65.0,Unisex
Codie,2013,31,19,12,61.29032258064516,38.70967741935484,Unisex
Camaro,2013,13,5,8,38.46153846153847,61.53846153846154,Unisex
Azaryah,2013,23,15,8,65.21739130434783,34.78260869565217,Unisex
Aeon,2013,14,5,9,35.714285714285715,64.28571428571429,Unisex
Moon,2013,13,8,5,61.53846153846154,38.46153846153847,Unisex
Schuyler,2013,40,16,24,40.0,60.0,Unisex
Gianny,2013,23,10,13,43.47826086956522,56.52173913043478,Unisex
Chayse,2013,122,23,99,18.852459016393443,81.14754098360656,Unisex
Sinclair,2013,19,10,9,52.63157894736842,47.368421052631575,Unisex
Dresden,2013,64,11,53,17.1875,82.8125,Unisex
Peyson,2013,24,18,6,75.0,25.0,Unisex
Kemari,2013,71,16,55,22.53521126760564,77.46478873239437,Unisex
Massiah,2013,69,11,58,15.942028985507244,84.05797101449275,Unisex
Neylan,2013,11,6,5,54.54545454545454,45.45454545454545,Unisex
Braylin,2013,279,105,174,37.634408602150536,62.36559139784946,Unisex
Sevin,2013,32,9,23,28.125,71.875,Unisex
Shams,2013,15,8,7,53.333333333333336,46.66666666666666,Unisex
Inioluwa,2013,25,16,9,64.0,36.0,Unisex
Tobi,2013,33,14,19,42.42424242424242,57.57575757575758,Unisex
Brekyn,2013,12,6,6,50.0,50.0,Unisex
Giavanni,2013,18,12,6,66.66666666666666,33.33333333333333,Unisex
Bayan,2013,36,28,8,77.77777777777779,22.22222222222222,Unisex
Jermani,2013,39,31,8,79.48717948717949,20.51282051282051,Unisex
Halston,2013,21,5,16,23.809523809523807,76.19047619047619,Unisex
Rayen,2013,12,7,5,58.333333333333336,41.66666666666667,Unisex
Joss,2013,21,5,16,23.809523809523807,76.19047619047619,Unisex
Casi,2014,6,6,0,100.0,0.0,Female
Darah,2014,6,6,0,100.0,0.0,Female
Jaylianiz,2014,5,5,0,100.0,0.0,Female
Elyce,2014,15,15,0,100.0,0.0,Female
Juiliana,2014,6,6,0,100.0,0.0,Female
Amaia,2014,95,95,0,100.0,0.0,Female
Lisa,2014,378,378,0,100.0,0.0,Female
Kamor,2014,5,5,0,100.0,0.0,Female
Batsheva,2014,122,122,0,100.0,0.0,Female
Kataleya,2014,232,232,0,100.0,0.0,Female
Adelade,2014,5,5,0,100.0,0.0,Female
Lesslie,2014,5,5,0,100.0,0.0,Female
Cristela,2014,5,5,0,100.0,0.0,Female
Erma,2014,21,21,0,100.0,0.0,Female
Skylynn,2014,186,186,0,100.0,0.0,Female
Italia,2014,122,122,0,100.0,0.0,Female
Toula,2014,8,8,0,100.0,0.0,Female
Avriana,2014,16,16,0,100.0,0.0,Female
Yaresly,2014,6,6,0,100.0,0.0,Female
Makinze,2014,6,6,0,100.0,0.0,Female
Amiyra,2014,6,6,0,100.0,0.0,Female
Makinzie,2014,25,25,0,100.0,0.0,Female
Nataya,2014,13,13,0,100.0,0.0,Female
Jiannah,2014,6,6,0,100.0,0.0,Female
Adrienna,2014,6,6,0,100.0,0.0,Female
Jakyrah,2014,6,6,0,100.0,0.0,Female
Aaralyn,2014,105,105,0,100.0,0.0,Female
Prezley,2014,7,7,0,100.0,0.0,Female
Jayliannie,2014,5,5,0,100.0,0.0,Female
Jamyra,2014,26,26,0,100.0,0.0,Female
Charvez,2014,5,0,5,0.0,100.0,Male
Demitrius,2014,27,0,27,0.0,100.0,Male
Ulises,2014,315,0,315,0.0,100.0,Male
Sanad,2014,18,0,18,0.0,100.0,Male
Nomar,2014,24,0,24,0.0,100.0,Male
Eli,2014,7526,22,7504,0.2923199574807334,99.70768004251926,Male
Tavares,2014,24,0,24,0.0,100.0,Male
Lavonte,2014,21,0,21,0.0,100.0,Male
Andreu,2014,8,0,8,0.0,100.0,Male
Whitton,2014,8,0,8,0.0,100.0,Male
Jayton,2014,21,0,21,0.0,100.0,Male
Haidar,2014,12,0,12,0.0,100.0,Male
Ki,2014,13,0,13,0.0,100.0,Male
Abir,2014,25,0,25,0.0,100.0,Male
Akiles,2014,5,0,5,0.0,100.0,Male
Fabiano,2014,6,0,6,0.0,100.0,Male
Zayvion,2014,113,0,113,0.0,100.0,Male
Brydan,2014,9,0,9,0.0,100.0,Male
Kenric,2014,7,0,7,0.0,100.0,Male
Earle,2014,6,0,6,0.0,100.0,Male
Cipriano,2014,10,0,10,0.0,100.0,Male
Arik,2014,57,0,57,0.0,100.0,Male
Sahir,2014,46,0,46,0.0,100.0,Male
Kaelon,2014,7,0,7,0.0,100.0,Male
Arnez,2014,14,0,14,0.0,100.0,Male
Arben,2014,6,0,6,0.0,100.0,Male
Matrim,2014,7,0,7,0.0,100.0,Male
Labron,2014,9,0,9,0.0,100.0,Male
Byran,2014,7,0,7,0.0,100.0,Male
Akshar,2014,21,0,21,0.0,100.0,Male
Jaidyn,2014,289,144,145,49.82698961937716,50.17301038062284,Unisex
Amiel,2014,27,5,22,18.51851851851852,81.48148148148148,Unisex
Finesse,2014,10,5,5,50.0,50.0,Unisex
Kaimana,2014,31,6,25,19.35483870967742,80.64516129032258,Unisex
Blayke,2014,69,44,25,63.76811594202898,36.231884057971016,Unisex
Sayge,2014,25,17,8,68.0,32.0,Unisex
Egypt,2014,218,174,44,79.81651376146789,20.18348623853211,Unisex
Dasani,2014,42,30,12,71.42857142857143,28.57142857142857,Unisex
Cameryn,2014,97,63,34,64.94845360824742,35.051546391752574,Unisex
Jody,2014,91,25,66,27.472527472527474,72.52747252747253,Unisex
Jianni,2014,25,7,18,28.000000000000004,72.0,Unisex
Bostyn,2014,57,41,16,71.9298245614035,28.07017543859649,Unisex
Audi,2014,21,13,8,61.90476190476191,38.095238095238095,Unisex
Pacey,2014,36,20,16,55.55555555555556,44.44444444444444,Unisex
Nazareth,2014,73,38,35,52.05479452054794,47.94520547945205,Unisex
Kentley,2014,23,16,7,69.56521739130434,30.434782608695656,Unisex
Harlyn,2014,53,42,11,79.24528301886792,20.75471698113208,Unisex
Skylen,2014,24,13,11,54.16666666666666,45.83333333333333,Unisex
Bradlee,2014,108,25,83,23.14814814814815,76.85185185185185,Unisex
Psalm,2014,16,5,11,31.25,68.75,Unisex
Britton,2014,203,99,104,48.76847290640394,51.231527093596064,Unisex
Morgen,2014,39,28,11,71.7948717948718,28.205128205128204,Unisex
Kasyn,2014,100,19,81,19.0,81.0,Unisex
Alexis,2014,5417,4242,1175,78.30902713679158,21.69097286320842,Unisex
Jayme,2014,87,66,21,75.86206896551724,24.13793103448276,Unisex
Abishai,2014,21,8,13,38.095238095238095,61.90476190476191,Unisex
Peniel,2014,16,9,7,56.25,43.75,Unisex
Tai,2014,85,15,70,17.647058823529413,82.35294117647058,Unisex
Shiloh,2014,677,481,196,71.04874446085671,28.95125553914328,Unisex
Kolbie,2014,89,72,17,80.89887640449437,19.101123595505616,Unisex
Lamia,2015,35,35,0,100.0,0.0,Female
Ravya,2015,7,7,0,100.0,0.0,Female
Abela,2015,6,6,0,100.0,0.0,Female
Jozette,2015,7,7,0,100.0,0.0,Female
Lauralee,2015,11,11,0,100.0,0.0,Female
Amera,2015,33,33,0,100.0,0.0,Female
Lillyanna,2015,212,212,0,100.0,0.0,Female
Cidney,2015,8,8,0,100.0,0.0,Female
Kaye,2015,16,16,0,100.0,0.0,Female
Jaliana,2015,7,7,0,100.0,0.0,Female
Talyia,2015,5,5,0,100.0,0.0,Female
Maelynn,2015,111,111,0,100.0,0.0,Female
Valarie,2015,49,49,0,100.0,0.0,Female
Audriauna,2015,5,5,0,100.0,0.0,Female
Ciela,2015,15,15,0,100.0,0.0,Female
Ivoree,2015,5,5,0,100.0,0.0,Female
Sthefany,2015,5,5,0,100.0,0.0,Female
Eleora,2015,16,16,0,100.0,0.0,Female
Kennedie,2015,35,35,0,100.0,0.0,Female
Una,2015,45,45,0,100.0,0.0,Female
Natori,2015,5,5,0,100.0,0.0,Female
Aanika,2015,24,24,0,100.0,0.0,Female
Nefertiti,2015,11,11,0,100.0,0.0,Female
Saesha,2015,12,12,0,100.0,0.0,Female
Harlequin,2015,5,5,0,100.0,0.0,Female
Nyra,2015,31,31,0,100.0,0.0,Female
Mariska,2015,30,30,0,100.0,0.0,Female
Taige,2015,5,5,0,100.0,0.0,Female
Natividad,2015,6,6,0,100.0,0.0,Female
Catalia,2015,24,24,0,100.0,0.0,Female
Maxtin,2015,9,0,9,0.0,100.0,Male
Whitfield,2015,5,0,5,0.0,100.0,Male
Dayten,2015,10,0,10,0.0,100.0,Male
Khade,2015,5,0,5,0.0,100.0,Male
Winchester,2015,9,0,9,0.0,100.0,Male
Hoytt,2015,6,0,6,0.0,100.0,Male
Emanuel,2015,982,5,977,0.5091649694501018,99.4908350305499,Male
Hughston,2015,7,0,7,0.0,100.0,Male
Jasser,2015,5,0,5,0.0,100.0,Male
Esneider,2015,9,0,9,0.0,100.0,Male
Seton,2015,7,0,7,0.0,100.0,Male
Trayveon,2015,16,0,16,0.0,100.0,Male
Thorin,2015,156,0,156,0.0,100.0,Male
Kyrell,2015,29,0,29,0.0,100.0,Male
Ivaniel,2015,5,0,5,0.0,100.0,Male
Aubin,2015,9,0,9,0.0,100.0,Male
Bukhari,2015,5,0,5,0.0,100.0,Male
Jenson,2015,135,0,135,0.0,100.0,Male
Telvin,2015,10,0,10,0.0,100.0,Male
Mithun,2015,5,0,5,0.0,100.0,Male
Kendan,2015,12,0,12,0.0,100.0,Male
Fredy,2015,94,0,94,0.0,100.0,Male
Nikoloz,2015,5,0,5,0.0,100.0,Male
Eros,2015,66,0,66,0.0,100.0,Male
Arka,2015,6,0,6,0.0,100.0,Male
Martin,2015,1344,0,1344,0.0,100.0,Male
Ruthvik,2015,9,0,9,0.0,100.0,Male
Romell,2015,31,0,31,0.0,100.0,Male
Xander,2015,1932,0,1932,0.0,100.0,Male
Jarett,2015,26,0,26,0.0,100.0,Male
Abisai,2015,43,13,30,30.23255813953488,69.76744186046511,Unisex
Mckay,2015,53,11,42,20.75471698113208,79.24528301886792,Unisex
Leone,2015,31,8,23,25.806451612903224,74.19354838709677,Unisex
Palmer,2015,314,177,137,56.36942675159236,43.63057324840764,Unisex
Harbor,2015,86,62,24,72.09302325581395,27.906976744186046,Unisex
Matty,2015,30,21,9,70.0,30.0,Unisex
Rickie,2015,39,8,31,20.51282051282051,79.48717948717949,Unisex
Mylin,2015,14,6,8,42.85714285714285,57.14285714285714,Unisex
Kena,2015,14,9,5,64.28571428571429,35.714285714285715,Unisex
Basil,2015,68,16,52,23.52941176470588,76.47058823529412,Unisex
Amazing,2015,20,14,6,70.0,30.0,Unisex
Justis,2015,26,6,20,23.07692307692308,76.92307692307693,Unisex
Anjel,2015,32,5,27,15.625,84.375,Unisex
Zen,2015,98,23,75,23.46938775510204,76.53061224489795,Unisex
Baylen,2015,53,10,43,18.867924528301888,81.13207547169812,Unisex
Nile,2015,72,16,56,22.22222222222222,77.77777777777779,Unisex
Majesty,2015,125,92,33,73.6,26.4,Unisex
Kaydyn,2015,32,8,24,25.0,75.0,Unisex
Braelin,2015,22,7,15,31.818181818181817,68.18181818181817,Unisex
Rally,2015,12,5,7,41.66666666666667,58.333333333333336,Unisex
Mica,2015,53,32,21,60.37735849056604,39.62264150943396,Unisex
Gentry,2015,209,112,97,53.588516746411486,46.411483253588514,Unisex
Peyton,2015,5287,3904,1383,73.8414980139966,26.1585019860034,Unisex
Collyn,2015,38,13,25,34.21052631578947,65.78947368421053,Unisex
Burkley,2015,18,9,9,50.0,50.0,Unisex
Elim,2015,31,10,21,32.25806451612903,67.74193548387096,Unisex
Seeley,2015,52,15,37,28.846153846153843,71.15384615384616,Unisex
Shea,2015,291,191,100,65.63573883161511,34.36426116838488,Unisex
Reynolds,2015,19,9,10,47.368421052631575,52.63157894736842,Unisex
Avynn,2015,10,5,5,50.0,50.0,Unisex
Kilyn,2016,10,10,0,100.0,0.0,Female
Alylah,2016,13,13,0,100.0,0.0,Female
Rozyn,2016,5,5,0,100.0,0.0,Female
Tesneem,2016,5,5,0,100.0,0.0,Female
Daryah,2016,7,7,0,100.0,0.0,Female
Nairi,2016,13,13,0,100.0,0.0,Female
Emelin,2016,14,14,0,100.0,0.0,Female
Dalyah,2016,11,11,0,100.0,0.0,Female
Gentri,2016,7,7,0,100.0,0.0,Female
Hanan,2016,72,67,5,93.05555555555556,6.944444444444445,Female
Amela,2016,13,13,0,100.0,0.0,Female
Sydnie,2016,36,36,0,100.0,0.0,Female
Sareya,2016,5,5,0,100.0,0.0,Female
Ysabelle,2016,14,14,0,100.0,0.0,Female
Annmarie,2016,101,101,0,100.0,0.0,Female
Kamaiya,2016,12,12,0,100.0,0.0,Female
Jacqlyn,2016,5,5,0,100.0,0.0,Female
Selma,2016,95,95,0,100.0,0.0,Female
Roseleigh,2016,6,6,0,100.0,0.0,Female
Margery,2016,7,7,0,100.0,0.0,Female
Jessabelle,2016,17,17,0,100.0,0.0,Female
Magaly,2016,71,71,0,100.0,0.0,Female
Adelie,2016,35,35,0,100.0,0.0,Female
Yenty,2016,9,9,0,100.0,0.0,Female
Emmalynn,2016,333,333,0,100.0,0.0,Female
Liliann,2016,23,23,0,100.0,0.0,Female
Chara,2016,11,11,0,100.0,0.0,Female
Molina,2016,5,5,0,100.0,0.0,Female
Asmara,2016,5,5,0,100.0,0.0,Female
Najmo,2016,6,6,0,100.0,0.0,Female
Cutler,2016,37,0,37,0.0,100.0,Male
Draeden,2016,5,0,5,0.0,100.0,Male
Xyler,2016,12,0,12,0.0,100.0,Male
Yamin,2016,11,0,11,0.0,100.0,Male
Lakelan,2016,8,0,8,0.0,100.0,Male
Olivar,2016,6,0,6,0.0,100.0,Male
Liamjames,2016,7,0,7,0.0,100.0,Male
Luciano,2016,583,0,583,0.0,100.0,Male
Lander,2016,17,0,17,0.0,100.0,Male
Demitrius,2016,27,0,27,0.0,100.0,Male
Jamarion,2016,208,0,208,0.0,100.0,Male
Fyodor,2016,9,0,9,0.0,100.0,Male
Obed,2016,97,0,97,0.0,100.0,Male
Claytin,2016,5,0,5,0.0,100.0,Male
Mikayel,2016,8,0,8,0.0,100.0,Male
Kazz,2016,6,0,6,0.0,100.0,Male
Cylis,2016,18,0,18,0.0,100.0,Male
Ameer,2016,284,0,284,0.0,100.0,Male
Duy,2016,8,0,8,0.0,100.0,Male
Jorawar,2016,8,0,8,0.0,100.0,Male
Richmond,2016,24,0,24,0.0,100.0,Male
Kaynon,2016,13,0,13,0.0,100.0,Male
Hayyan,2016,6,0,6,0.0,100.0,Male
Everton,2016,12,0,12,0.0,100.0,Male
Koen,2016,186,5,181,2.6881720430107525,97.31182795698923,Male
Kel,2016,7,0,7,0.0,100.0,Male
Airik,2016,5,0,5,0.0,100.0,Male
Titan,2016,409,0,409,0.0,100.0,Male
Domingo,2016,56,0,56,0.0,100.0,Male
Yaasir,2016,6,0,6,0.0,100.0,Male
Sterling,2016,803,133,670,16.562889165628892,83.43711083437111,Unisex
Sakari,2016,29,14,15,48.27586206896552,51.72413793103448,Unisex
Amery,2016,31,26,5,83.87096774193549,16.129032258064516,Unisex
Zihan,2016,16,7,9,43.75,56.25,Unisex
Jesiah,2016,250,65,185,26.0,74.0,Unisex
Maize,2016,11,6,5,54.54545454545454,45.45454545454545,Unisex
Amauri,2016,127,22,105,17.322834645669293,82.67716535433071,Unisex
Kitt,2016,14,8,6,57.14285714285714,42.85714285714285,Unisex
Ivery,2016,20,15,5,75.0,25.0,Unisex
Liel,2016,30,19,11,63.33333333333333,36.66666666666666,Unisex
Wrigley,2016,49,18,31,36.734693877551024,63.26530612244898,Unisex
Arlow,2016,27,8,19,29.629629629629623,70.37037037037037,Unisex
Kemani,2016,43,24,19,55.81395348837209,44.18604651162791,Unisex
Amrit,2016,29,16,13,55.172413793103445,44.82758620689656,Unisex
Aquila,2016,22,12,10,54.54545454545454,45.45454545454545,Unisex
Azariyah,2016,45,36,9,80.0,20.0,Unisex
Kemper,2016,52,13,39,25.0,75.0,Unisex
Halen,2016,65,28,37,43.07692307692308,56.92307692307692,Unisex
Camari,2016,98,44,54,44.89795918367347,55.10204081632652,Unisex
Greycen,2016,21,6,15,28.57142857142857,71.42857142857143,Unisex
Sayge,2016,35,24,11,68.57142857142857,31.428571428571427,Unisex
Dayan,2016,27,7,20,25.925925925925924,74.07407407407408,Unisex
Elston,2016,16,5,11,31.25,68.75,Unisex
Trinidad,2016,34,13,21,38.23529411764706,61.76470588235294,Unisex
Weylyn,2016,19,8,11,42.10526315789473,57.89473684210527,Unisex
Shaw,2016,39,6,33,15.384615384615383,84.61538461538461,Unisex
Livingston,2016,18,11,7,61.11111111111112,38.88888888888889,Unisex
Taylen,2016,148,62,86,41.891891891891895,58.108108108108105,Unisex
Bora,2016,32,15,17,46.875,53.125,Unisex
Kansas,2016,38,32,6,84.21052631578947,15.789473684210526,Unisex
Alanah,2017,155,155,0,100.0,0.0,Female
Aleemah,2017,8,8,0,100.0,0.0,Female
Cristy,2017,16,16,0,100.0,0.0,Female
Arshika,2017,14,14,0,100.0,0.0,Female
Adalis,2017,7,7,0,100.0,0.0,Female
Halie,2017,8,8,0,100.0,0.0,Female
Jazariyah,2017,5,5,0,100.0,0.0,Female
Kawaii,2017,5,5,0,100.0,0.0,Female
Illianna,2017,25,25,0,100.0,0.0,Female
Iylah,2017,28,28,0,100.0,0.0,Female
Syniah,2017,11,11,0,100.0,0.0,Female
Ayaana,2017,22,22,0,100.0,0.0,Female
Aamia,2017,6,6,0,100.0,0.0,Female
Anise,2017,6,6,0,100.0,0.0,Female
Junia,2017,43,43,0,100.0,0.0,Female
Shealynn,2017,12,12,0,100.0,0.0,Female
Juliah,2017,10,10,0,100.0,0.0,Female
Camillia,2017,18,18,0,100.0,0.0,Female
Aariya,2017,18,18,0,100.0,0.0,Female
Tallula,2017,9,9,0,100.0,0.0,Female
Dalaina,2017,6,6,0,100.0,0.0,Female
Shresta,2017,10,10,0,100.0,0.0,Female
Emberli,2017,13,13,0,100.0,0.0,Female
Evanka,2017,7,7,0,100.0,0.0,Female
Rielynn,2017,11,11,0,100.0,0.0,Female
Adilynn,2017,270,270,0,100.0,0.0,Female
Aymara,2017,5,5,0,100.0,0.0,Female
Nisha,2017,13,13,0,100.0,0.0,Female
Ahmaya,2017,7,7,0,100.0,0.0,Female
Vannia,2017,14,14,0,100.0,0.0,Female
Winton,2017,8,0,8,0.0,100.0,Male
Ulisses,2017,15,0,15,0.0,100.0,Male
Rojelio,2017,6,0,6,0.0,100.0,Male
Trapper,2017,23,0,23,0.0,100.0,Male
Lashaun,2017,8,0,8,0.0,100.0,Male
Fox,2017,316,10,306,3.1645569620253164,96.83544303797468,Male
Michael,2017,12734,34,12700,0.2670017276582377,99.73299827234176,Male
Goutham,2017,5,0,5,0.0,100.0,Male
Marquell,2017,18,0,18,0.0,100.0,Male
Jaevin,2017,9,0,9,0.0,100.0,Male
Ashkan,2017,9,0,9,0.0,100.0,Male
Farrell,2017,7,0,7,0.0,100.0,Male
Trevan,2017,12,0,12,0.0,100.0,Male
Riad,2017,9,0,9,0.0,100.0,Male
Bashir,2017,27,0,27,0.0,100.0,Male
Zaedyn,2017,56,0,56,0.0,100.0,Male
Karam,2017,109,0,109,0.0,100.0,Male
Nixen,2017,7,0,7,0.0,100.0,Male
Kendrick,2017,787,10,777,1.2706480304955527,98.72935196950444,Male
Oak,2017,36,0,36,0.0,100.0,Male
Jahari,2017,87,10,77,11.494252873563218,88.50574712643679,Male
Jeremyah,2017,35,0,35,0.0,100.0,Male
Tenuun,2017,7,0,7,0.0,100.0,Male
Eziah,2017,32,0,32,0.0,100.0,Male
Aron,2017,307,0,307,0.0,100.0,Male
Iden,2017,26,0,26,0.0,100.0,Male
Amad,2017,11,0,11,0.0,100.0,Male
Kaid,2017,13,0,13,0.0,100.0,Male
Isaias,2017,507,0,507,0.0,100.0,Male
Leib,2017,12,0,12,0.0,100.0,Male
Hser,2017,17,11,6,64.70588235294117,35.294117647058826,Unisex
Sovereign,2017,22,7,15,31.818181818181817,68.18181818181817,Unisex
Vegas,2017,22,5,17,22.727272727272727,77.27272727272727,Unisex
Akhari,2017,17,5,12,29.411764705882355,70.58823529411765,Unisex
Aalijah,2017,26,15,11,57.692307692307686,42.30769230769231,Unisex
Agam,2017,41,7,34,17.073170731707318,82.92682926829268,Unisex
Sloan,2017,589,497,92,84.38030560271646,15.619694397283531,Unisex
Dylann,2017,77,51,26,66.23376623376623,33.76623376623377,Unisex
Sonnie,2017,17,12,5,70.58823529411765,29.411764705882355,Unisex
Amani,2017,438,363,75,82.87671232876713,17.123287671232877,Unisex
Kova,2017,12,7,5,58.333333333333336,41.66666666666667,Unisex
Brixtyn,2017,17,12,5,70.58823529411765,29.411764705882355,Unisex
Oluwasemilore,2017,30,12,18,40.0,60.0,Unisex
Keaghan,2017,16,7,9,43.75,56.25,Unisex
Sani,2017,18,12,6,66.66666666666666,33.33333333333333,Unisex
Ayven,2017,96,23,73,23.958333333333336,76.04166666666666,Unisex
Jaziah,2017,91,38,53,41.75824175824176,58.24175824175825,Unisex
Karsyn,2017,687,533,154,77.58369723435226,22.416302765647742,Unisex
Jalyn,2017,59,36,23,61.01694915254237,38.983050847457626,Unisex
Renly,2017,87,20,67,22.988505747126435,77.01149425287356,Unisex
Yuri,2017,168,83,85,49.40476190476191,50.595238095238095,Unisex
Artemis,2017,171,145,26,84.7953216374269,15.204678362573098,Unisex
Callahan,2017,197,32,165,16.243654822335024,83.75634517766497,Unisex
Carey,2017,32,11,21,34.375,65.625,Unisex
Miko,2017,41,11,30,26.82926829268293,73.17073170731707,Unisex
Basil,2017,84,25,59,29.761904761904763,70.23809523809523,Unisex
Zephaniah,2017,165,27,138,16.363636363636363,83.63636363636363,Unisex
Cameo,2017,10,5,5,50.0,50.0,Unisex
Han,2017,46,17,29,36.95652173913043,63.04347826086957,Unisex
Myers,2017,24,8,16,33.33333333333333,66.66666666666666,Unisex
Arielis,2018,13,13,0,100.0,0.0,Female
Dafne,2018,99,99,0,100.0,0.0,Female
Evaleigh,2018,24,24,0,100.0,0.0,Female
Arjwan,2018,6,6,0,100.0,0.0,Female
Xinyu,2018,6,6,0,100.0,0.0,Female
Deriyah,2018,8,8,0,100.0,0.0,Female
Melana,2018,9,9,0,100.0,0.0,Female
Clair,2018,33,33,0,100.0,0.0,Female
Laynee,2018,60,60,0,100.0,0.0,Female
Mialani,2018,13,13,0,100.0,0.0,Female
Rosibel,2018,5,5,0,100.0,0.0,Female
Margo,2018,270,270,0,100.0,0.0,Female
Taaliah,2018,5,5,0,100.0,0.0,Female
Brin,2018,9,9,0,100.0,0.0,Female
Suzie,2018,24,24,0,100.0,0.0,Female
Vianny,2018,9,9,0,100.0,0.0,Female
Sayla,2018,32,32,0,100.0,0.0,Female
Ellyanah,2018,6,6,0,100.0,0.0,Female
Devynn,2018,29,29,0,100.0,0.0,Female
Lavae,2018,7,7,0,100.0,0.0,Female
Zira,2018,6,6,0,100.0,0.0,Female
Elsi,2018,7,7,0,100.0,0.0,Female
Promisee,2018,5,5,0,100.0,0.0,Female
Mailen,2018,44,44,0,100.0,0.0,Female
Mahani,2018,5,5,0,100.0,0.0,Female
Zafira,2018,13,13,0,100.0,0.0,Female
Autumnrose,2018,12,12,0,100.0,0.0,Female
Priyanshi,2018,7,7,0,100.0,0.0,Female
Iona,2018,68,68,0,100.0,0.0,Female
Rosalynn,2018,145,145,0,100.0,0.0,Female
Nasr,2018,5,0,5,0.0,100.0,Male
Wylde,2018,7,0,7,0.0,100.0,Male
Arteen,2018,6,0,6,0.0,100.0,Male
Travell,2018,14,0,14,0.0,100.0,Male
Lucion,2018,7,0,7,0.0,100.0,Male
Cylan,2018,8,0,8,0.0,100.0,Male
Eidan,2018,50,0,50,0.0,100.0,Male
Demetrio,2018,19,0,19,0.0,100.0,Male
Konstantin,2018,42,0,42,0.0,100.0,Male
Ivyn,2018,5,0,5,0.0,100.0,Male
Johnlucas,2018,7,0,7,0.0,100.0,Male
Keiston,2018,6,0,6,0.0,100.0,Male
Vontrell,2018,5,0,5,0.0,100.0,Male
Zameir,2018,5,0,5,0.0,100.0,Male
Benito,2018,86,0,86,0.0,100.0,Male
Keylon,2018,12,0,12,0.0,100.0,Male
Tralyn,2018,5,0,5,0.0,100.0,Male
Juanito,2018,21,0,21,0.0,100.0,Male
Yamil,2018,28,0,28,0.0,100.0,Male
Yassine,2018,19,0,19,0.0,100.0,Male
Pinchas,2018,32,0,32,0.0,100.0,Male
Kelan,2018,39,0,39,0.0,100.0,Male
Jacolby,2018,23,0,23,0.0,100.0,Male
Aadyant,2018,6,0,6,0.0,100.0,Male
Zyiere,2018,6,0,6,0.0,100.0,Male
Florian,2018,22,0,22,0.0,100.0,Male
Macen,2018,28,0,28,0.0,100.0,Male
Kealan,2018,11,0,11,0.0,100.0,Male
Ace,2018,1446,0,1446,0.0,100.0,Male
Adharv,2018,15,0,15,0.0,100.0,Male
Halen,2018,66,30,36,45.45454545454545,54.54545454545454,Unisex
Hendryx,2018,22,7,15,31.818181818181817,68.18181818181817,Unisex
Austen,2018,133,53,80,39.849624060150376,60.15037593984962,Unisex
Taytum,2018,162,133,29,82.09876543209876,17.901234567901234,Unisex
Caidence,2018,46,37,9,80.43478260869566,19.565217391304348,Unisex
Brighton,2018,249,131,118,52.610441767068274,47.389558232931726,Unisex
Yichen,2018,22,7,15,31.818181818181817,68.18181818181817,Unisex
Yunuen,2018,11,5,6,45.45454545454545,54.54545454545454,Unisex
Quincey,2018,40,22,18,55.00000000000001,45.0,Unisex
Lochlyn,2018,42,33,9,78.57142857142857,21.428571428571427,Unisex
Zoel,2018,10,5,5,50.0,50.0,Unisex
Rowen,2018,773,187,586,24.191461836998705,75.80853816300129,Unisex
Nyx,2018,30,23,7,76.66666666666667,23.33333333333333,Unisex
Kia,2018,21,16,5,76.19047619047619,23.809523809523807,Unisex
Teal,2018,37,21,16,56.75675675675676,43.24324324324324,Unisex
Yarel,2018,16,7,9,43.75,56.25,Unisex
Breeze,2018,48,36,12,75.0,25.0,Unisex
Briar,2018,699,421,278,60.22889842632332,39.77110157367668,Unisex
Rei,2018,61,33,28,54.09836065573771,45.90163934426229,Unisex
Rahil,2018,29,7,22,24.13793103448276,75.86206896551724,Unisex
Laramie,2018,53,36,17,67.9245283018868,32.075471698113205,Unisex
Million,2018,24,5,19,20.833333333333336,79.16666666666666,Unisex
Shadow,2018,18,8,10,44.44444444444444,55.55555555555556,Unisex
Corrin,2018,14,7,7,50.0,50.0,Unisex
Teigen,2018,69,47,22,68.11594202898551,31.88405797101449,Unisex
Kena,2018,22,12,10,54.54545454545454,45.45454545454545,Unisex
Autry,2018,19,12,7,63.1578947368421,36.84210526315789,Unisex
Harley,2018,1708,1409,299,82.49414519906323,17.505854800936767,Unisex
Adel,2018,63,21,42,33.33333333333333,66.66666666666666,Unisex
Rynn,2018,28,20,8,71.42857142857143,28.57142857142857,Unisex
Madisen,2019,19,19,0,100.0,0.0,Female
Lidya,2019,13,13,0,100.0,0.0,Female
Neala,2019,10,10,0,100.0,0.0,Female
Camara,2019,16,16,0,100.0,0.0,Female
Pietra,2019,16,16,0,100.0,0.0,Female
Audra,2019,140,140,0,100.0,0.0,Female
Olivette,2019,8,8,0,100.0,0.0,Female
Journnie,2019,7,7,0,100.0,0.0,Female
Kylana,2019,5,5,0,100.0,0.0,Female
Yaalini,2019,5,5,0,100.0,0.0,Female
Teliah,2019,5,5,0,100.0,0.0,Female
Kelia,2019,17,17,0,100.0,0.0,Female
Naarah,2019,23,23,0,100.0,0.0,Female
Maythe,2019,5,5,0,100.0,0.0,Female
Ruwayda,2019,9,9,0,100.0,0.0,Female
Arai,2019,6,6,0,100.0,0.0,Female
Davinity,2019,7,7,0,100.0,0.0,Female
Storie,2019,27,27,0,100.0,0.0,Female
Arianne,2019,39,39,0,100.0,0.0,Female
Matty,2019,19,19,0,100.0,0.0,Female
Renatta,2019,34,34,0,100.0,0.0,Female
Aleemah,2019,5,5,0,100.0,0.0,Female
Ailey,2019,40,40,0,100.0,0.0,Female
Marlee,2019,713,695,18,97.47545582047684,2.524544179523142,Female
Alyna,2019,93,93,0,100.0,0.0,Female
Maily,2019,23,23,0,100.0,0.0,Female
Ariadne,2019,257,257,0,100.0,0.0,Female
Marielle,2019,89,89,0,100.0,0.0,Female
Anali,2019,52,52,0,100.0,0.0,Female
Amrita,2019,9,9,0,100.0,0.0,Female
Wander,2019,9,0,9,0.0,100.0,Male
Jakob,2019,312,0,312,0.0,100.0,Male
Ismael,2019,874,0,874,0.0,100.0,Male
Lamonte,2019,18,0,18,0.0,100.0,Male
Ikechukwu,2019,11,0,11,0.0,100.0,Male
Zan,2019,5,0,5,0.0,100.0,Male
Ayyan,2019,8,0,8,0.0,100.0,Male
Zeek,2019,25,0,25,0.0,100.0,Male
Jevin,2019,11,0,11,0.0,100.0,Male
Abyan,2019,6,0,6,0.0,100.0,Male
Braxen,2019,7,0,7,0.0,100.0,Male
Reynold,2019,11,0,11,0.0,100.0,Male
Ramesses,2019,22,0,22,0.0,100.0,Male
Ardi,2019,7,0,7,0.0,100.0,Male
Phinehas,2019,33,0,33,0.0,100.0,Male
Joseangel,2019,25,0,25,0.0,100.0,Male
Jkai,2019,8,0,8,0.0,100.0,Male
Yaseen,2019,140,0,140,0.0,100.0,Male
Willard,2019,46,0,46,0.0,100.0,Male
Werner,2019,12,0,12,0.0,100.0,Male
Jeremias,2019,248,0,248,0.0,100.0,Male
Barkon,2019,5,0,5,0.0,100.0,Male
Boyd,2019,97,0,97,0.0,100.0,Male
Ashwin,2019,50,0,50,0.0,100.0,Male
Sabin,2019,10,0,10,0.0,100.0,Male
Ziaan,2019,9,0,9,0.0,100.0,Male
Kahan,2019,7,0,7,0.0,100.0,Male
Alson,2019,7,0,7,0.0,100.0,Male
Khaiden,2019,20,0,20,0.0,100.0,Male
Amadeus,2019,71,0,71,0.0,100.0,Male
Wylee,2019,29,15,14,51.72413793103448,48.27586206896552,Unisex
Armanii,2019,37,20,17,54.054054054054056,45.94594594594595,Unisex
Rune,2019,38,9,29,23.684210526315788,76.31578947368422,Unisex
Ever,2019,266,106,160,39.849624060150376,60.15037593984962,Unisex
Jaidence,2019,14,7,7,50.0,50.0,Unisex
Crosley,2019,26,15,11,57.692307692307686,42.30769230769231,Unisex
Kamsiyochukwu,2019,24,11,13,45.83333333333333,54.16666666666666,Unisex
Breeze,2019,38,30,8,78.94736842105263,21.052631578947366,Unisex
Kalai,2019,19,10,9,52.63157894736842,47.368421052631575,Unisex
Reeve,2019,28,7,21,25.0,75.0,Unisex
Denali,2019,95,67,28,70.52631578947368,29.47368421052631,Unisex
Haiden,2019,153,45,108,29.411764705882355,70.58823529411765,Unisex
Harvest,2019,22,16,6,72.72727272727273,27.27272727272727,Unisex
Suede,2019,17,9,8,52.94117647058824,47.05882352941176,Unisex
Phenix,2019,40,22,18,55.00000000000001,45.0,Unisex
Sage,2019,1843,1172,671,63.59196961475855,36.40803038524145,Unisex
Artie,2019,16,7,9,43.75,56.25,Unisex
Paiden,2019,11,5,6,45.45454545454545,54.54545454545454,Unisex
Codi,2019,61,41,20,67.21311475409836,32.78688524590164,Unisex
Rai,2019,21,5,16,23.809523809523807,76.19047619047619,Unisex
Rory,2019,1598,675,923,42.24030037546934,57.75969962453066,Unisex
Dallis,2019,47,37,10,78.72340425531915,21.27659574468085,Unisex
Layken,2019,89,59,30,66.29213483146067,33.70786516853933,Unisex
Prescott,2019,59,11,48,18.64406779661017,81.35593220338984,Unisex
Juno,2019,124,104,20,83.87096774193549,16.129032258064516,Unisex
Kirin,2019,43,7,36,16.27906976744186,83.72093023255815,Unisex
Amarii,2019,75,40,35,53.333333333333336,46.66666666666666,Unisex
Mikko,2019,34,10,24,29.411764705882355,70.58823529411765,Unisex
Masiyah,2019,24,7,17,29.166666666666668,70.83333333333334,Unisex
Blessed,2019,25,10,15,40.0,60.0,Unisex
Dunya,2020,21,21,0,100.0,0.0,Female
Larayah,2020,7,7,0,100.0,0.0,Female
Grisel,2020,5,5,0,100.0,0.0,Female
Leilani,2020,2882,2882,0,100.0,0.0,Female
Ellyannah,2020,6,6,0,100.0,0.0,Female
Nourah,2020,8,8,0,100.0,0.0,Female
Darleny,2020,15,15,0,100.0,0.0,Female
Andrianna,2020,6,6,0,100.0,0.0,Female
Amatullah,2020,12,12,0,100.0,0.0,Female
Daziyah,2020,13,13,0,100.0,0.0,Female
Hollyn,2020,148,148,0,100.0,0.0,Female
Kylana,2020,5,5,0,100.0,0.0,Female
Arleny,2020,9,9,0,100.0,0.0,Female
Kimberlee,2020,34,34,0,100.0,0.0,Female
Yahra,2020,9,9,0,100.0,0.0,Female
Jaleia,2020,10,10,0,100.0,0.0,Female
Willo,2020,5,5,0,100.0,0.0,Female
Ashleen,2020,6,6,0,100.0,0.0,Female
Arli,2020,5,5,0,100.0,0.0,Female
Kara,2020,426,426,0,100.0,0.0,Female
Aryiah,2020,43,43,0,100.0,0.0,Female
Kataleena,2020,8,8,0,100.0,0.0,Female
Abrielle,2020,116,116,0,100.0,0.0,Female
Ulanni,2020,44,44,0,100.0,0.0,Female
Riella,2020,11,11,0,100.0,0.0,Female
Alyiah,2020,19,19,0,100.0,0.0,Female
Maylynn,2020,26,26,0,100.0,0.0,Female
Marlise,2020,5,5,0,100.0,0.0,Female
Eula,2020,9,9,0,100.0,0.0,Female
Sakshi,2020,6,6,0,100.0,0.0,Female
Nasyr,2020,5,0,5,0.0,100.0,Male
Yakov,2020,121,0,121,0.0,100.0,Male
Hasani,2020,36,0,36,0.0,100.0,Male
Youssouf,2020,7,0,7,0.0,100.0,Male
Kenobi,2020,7,0,7,0.0,100.0,Male
Kunal,2020,7,0,7,0.0,100.0,Male
Lynwood,2020,5,0,5,0.0,100.0,Male
Taimur,2020,14,0,14,0.0,100.0,Male
Renard,2020,6,0,6,0.0,100.0,Male
Cage,2020,21,0,21,0.0,100.0,Male
Mylo,2020,299,10,289,3.3444816053511706,96.65551839464884,Male
Siosiua,2020,7,0,7,0.0,100.0,Male
Aloysius,2020,18,0,18,0.0,100.0,Male
Solo,2020,9,0,9,0.0,100.0,Male
Branch,2020,76,0,76,0.0,100.0,Male
Everett,2020,4082,74,4008,1.8128368446839784,98.18716315531604,Male
Severide,2020,7,0,7,0.0,100.0,Male
Anand,2020,19,0,19,0.0,100.0,Male
Ashaun,2020,7,0,7,0.0,100.0,Male
Bodie,2020,459,12,447,2.6143790849673203,97.38562091503267,Male
Banyan,2020,18,0,18,0.0,100.0,Male
Jair,2020,249,0,249,0.0,100.0,Male
Novak,2020,20,0,20,0.0,100.0,Male
Adiyan,2020,5,0,5,0.0,100.0,Male
Oneil,2020,8,0,8,0.0,100.0,Male
Eluzer,2020,16,0,16,0.0,100.0,Male
Sarang,2020,6,0,6,0.0,100.0,Male
Jasier,2020,11,0,11,0.0,100.0,Male
Tharak,2020,5,0,5,0.0,100.0,Male
Theoden,2020,42,0,42,0.0,100.0,Male
Harvest,2020,33,25,8,75.75757575757575,24.24242424242424,Unisex
Kymani,2020,175,31,144,17.71428571428571,82.28571428571428,Unisex
Arien,2020,27,6,21,22.22222222222222,77.77777777777779,Unisex
Collier,2020,61,22,39,36.0655737704918,63.934426229508205,Unisex
Lyncoln,2020,56,15,41,26.785714285714285,73.21428571428571,Unisex
Nolyn,2020,56,10,46,17.857142857142858,82.14285714285714,Unisex
Dominique,2020,258,88,170,34.10852713178294,65.89147286821705,Unisex
Halen,2020,65,31,34,47.69230769230769,52.30769230769232,Unisex
Surya,2020,37,8,29,21.62162162162162,78.37837837837837,Unisex
Chozyn,2020,22,12,10,54.54545454545454,45.45454545454545,Unisex
Shaddai,2020,24,11,13,45.83333333333333,54.16666666666666,Unisex
Khamari,2020,166,25,141,15.060240963855422,84.93975903614458,Unisex
Kanyon,2020,43,7,36,16.27906976744186,83.72093023255815,Unisex
Ezrah,2020,194,42,152,21.649484536082475,78.35051546391753,Unisex
Johnnie,2020,108,34,74,31.48148148148148,68.51851851851852,Unisex
Kelly,2020,475,365,110,76.84210526315789,23.157894736842103,Unisex
Jael,2020,289,126,163,43.59861591695502,56.40138408304498,Unisex
Jensyn,2020,56,37,19,66.07142857142857,33.92857142857143,Unisex
Juni,2020,26,19,7,73.07692307692307,26.923076923076923,Unisex
Lu,2020,13,7,6,53.84615384615385,46.15384615384615,Unisex
Jaydyn,2020,33,9,24,27.27272727272727,72.72727272727273,Unisex
Drue,2020,39,22,17,56.41025641025641,43.58974358974359,Unisex
Oakley,2020,1837,1127,710,61.35002721829069,38.64997278170931,Unisex
Marlo,2020,163,84,79,51.53374233128834,48.466257668711656,Unisex
Connelly,2020,34,22,12,64.70588235294117,35.294117647058826,Unisex
Khepri,2020,15,10,5,66.66666666666666,33.33333333333333,Unisex
Ihsan,2020,30,5,25,16.666666666666664,83.33333333333334,Unisex
Seven,2020,308,68,240,22.07792207792208,77.92207792207793,Unisex
Aaryn,2020,69,51,18,73.91304347826086,26.08695652173913,Unisex
Sonam,2020,12,7,5,58.333333333333336,41.66666666666667,Unisex
Kinzleigh,2021,23,23,0,100.0,0.0,Female
Mckynzie,2021,6,6,0,100.0,0.0,Female
Lynnae,2021,6,6,0,100.0,0.0,Female
Hildegard,2021,13,13,0,100.0,0.0,Female
Sitara,2021,32,32,0,100.0,0.0,Female
Miyla,2021,6,6,0,100.0,0.0,Female
Nai,2021,6,6,0,100.0,0.0,Female
Maizelynn,2021,5,5,0,100.0,0.0,Female
Avannah,2021,6,6,0,100.0,0.0,Female
Bellamia,2021,7,7,0,100.0,0.0,Female
Mayli,2021,23,23,0,100.0,0.0,Female
Malley,2021,6,6,0,100.0,0.0,Female
Adalynn,2021,2328,2328,0,100.0,0.0,Female
Mirian,2021,21,21,0,100.0,0.0,Female
Azylah,2021,10,10,0,100.0,0.0,Female
Meyah,2021,9,9,0,100.0,0.0,Female
Anneke,2021,9,9,0,100.0,0.0,Female
Debora,2021,74,74,0,100.0,0.0,Female
Ellisen,2021,9,9,0,100.0,0.0,Female
Catie,2021,9,9,0,100.0,0.0,Female
Gabryella,2021,14,14,0,100.0,0.0,Female
Aalya,2021,8,8,0,100.0,0.0,Female
Julietta,2021,136,136,0,100.0,0.0,Female
Annikah,2021,6,6,0,100.0,0.0,Female
Astara,2021,6,6,0,100.0,0.0,Female
Jenesys,2021,10,10,0,100.0,0.0,Female
Teagyn,2021,12,12,0,100.0,0.0,Female
Addy,2021,38,38,0,100.0,0.0,Female
Raghad,2021,25,25,0,100.0,0.0,Female
Mical,2021,6,6,0,100.0,0.0,Female
Makari,2021,166,18,148,10.843373493975903,89.1566265060241,Male
Eliodoro,2021,5,0,5,0.0,100.0,Male
Rogelio,2021,217,0,217,0.0,100.0,Male
Keshawn,2021,67,0,67,0.0,100.0,Male
Delvonte,2021,6,0,6,0.0,100.0,Male
Sanish,2021,6,0,6,0.0,100.0,Male
Jayzion,2021,5,0,5,0.0,100.0,Male
Carnell,2021,7,0,7,0.0,100.0,Male
Caffrey,2021,11,0,11,0.0,100.0,Male
Conor,2021,646,0,646,0.0,100.0,Male
Amunra,2021,5,0,5,0.0,100.0,Male
Darinel,2021,5,0,5,0.0,100.0,Male
Aleksi,2021,7,0,7,0.0,100.0,Male
Dierks,2021,17,0,17,0.0,100.0,Male
Eytan,2021,14,0,14,0.0,100.0,Male
Bernhard,2021,6,0,6,0.0,100.0,Male
Yonah,2021,35,0,35,0.0,100.0,Male
Brydon,2021,12,0,12,0.0,100.0,Male
Jayan,2021,13,0,13,0.0,100.0,Male
Eivan,2021,9,0,9,0.0,100.0,Male
Dominik,2021,241,0,241,0.0,100.0,Male
Nyeir,2021,5,0,5,0.0,100.0,Male
Hamdan,2021,20,0,20,0.0,100.0,Male
Ridhaan,2021,39,0,39,0.0,100.0,Male
Azreal,2021,17,0,17,0.0,100.0,Male
Demond,2021,18,0,18,0.0,100.0,Male
Nico,2021,1389,35,1354,2.51979841612671,97.4802015838733,Male
Gad,2021,5,0,5,0.0,100.0,Male
Kyran,2021,96,0,96,0.0,100.0,Male
Zurich,2021,10,0,10,0.0,100.0,Male
Miko,2021,68,11,57,16.176470588235293,83.82352941176471,Unisex
Crosby,2021,283,43,240,15.19434628975265,84.80565371024736,Unisex
Eztli,2021,22,14,8,63.63636363636363,36.36363636363637,Unisex
Cortland,2021,27,7,20,25.925925925925924,74.07407407407408,Unisex
Dempsey,2021,99,29,70,29.29292929292929,70.70707070707071,Unisex
Sacha,2021,51,8,43,15.68627450980392,84.31372549019608,Unisex
Shadow,2021,25,8,17,32.0,68.0,Unisex
Keller,2021,101,17,84,16.831683168316832,83.16831683168317,Unisex
Bostyn,2021,54,36,18,66.66666666666666,33.33333333333333,Unisex
Nylin,2021,12,5,7,41.66666666666667,58.333333333333336,Unisex
Charlie,2021,4217,2217,2000,52.57291913682712,47.42708086317287,Unisex
Lyric,2021,957,758,199,79.20585161964472,20.79414838035528,Unisex
Landry,2021,489,269,220,55.010224948875255,44.989775051124745,Unisex
Han,2021,35,7,28,20.0,80.0,Unisex
Channing,2021,189,76,113,40.21164021164021,59.78835978835979,Unisex
Berlyn,2021,24,19,5,79.16666666666666,20.833333333333336,Unisex
Sequoia,2021,100,78,22,78.0,22.0,Unisex
Emry,2021,170,126,44,74.11764705882354,25.882352941176475,Unisex
Sol,2021,377,239,138,63.395225464190986,36.60477453580902,Unisex
Mali,2021,59,48,11,81.35593220338984,18.64406779661017,Unisex
Brilliant,2021,11,5,6,45.45454545454545,54.54545454545454,Unisex
Kirby,2021,101,62,39,61.38613861386138,38.613861386138616,Unisex
Creedence,2021,54,12,42,22.22222222222222,77.77777777777779,Unisex
Adel,2021,48,18,30,37.5,62.5,Unisex
Davie,2021,48,39,9,81.25,18.75,Unisex
Rowe,2021,40,15,25,37.5,62.5,Unisex
Khodi,2021,16,10,6,62.5,37.5,Unisex
Carsyn,2021,319,225,94,70.53291536050156,29.46708463949843,Unisex
Asiah,2021,111,25,86,22.52252252252252,77.47747747747748,Unisex
Quincey,2021,48,23,25,47.91666666666667,52.083333333333336,Unisex
Vallerie,2022,5,5,0,100.0,0.0,Female
Oliva,2022,20,20,0,100.0,0.0,Female
Aurelle,2022,6,6,0,100.0,0.0,Female
Sairah,2022,9,9,0,100.0,0.0,Female
Emila,2022,13,13,0,100.0,0.0,Female
Xella,2022,5,5,0,100.0,0.0,Female
Maluhia,2022,5,5,0,100.0,0.0,Female
Addaline,2022,17,17,0,100.0,0.0,Female
Makala,2022,5,5,0,100.0,0.0,Female
Donatella,2022,11,11,0,100.0,0.0,Female
Aleesha,2022,5,5,0,100.0,0.0,Female
Ginger,2022,48,48,0,100.0,0.0,Female
Eliahana,2022,5,5,0,100.0,0.0,Female
Yariela,2022,8,8,0,100.0,0.0,Female
Fynleigh,2022,7,7,0,100.0,0.0,Female
Rosaleigh,2022,57,57,0,100.0,0.0,Female
Noa,2022,1205,1064,141,88.29875518672199,11.701244813278008,Female
Mirai,2022,31,31,0,100.0,0.0,Female
Amika,2022,8,8,0,100.0,0.0,Female
Safiyya,2022,16,16,0,100.0,0.0,Female
Srihitha,2022,10,10,0,100.0,0.0,Female
Deilany,2022,17,17,0,100.0,0.0,Female
Arieya,2022,6,6,0,100.0,0.0,Female
Freida,2022,17,17,0,100.0,0.0,Female
Florecita,2022,5,5,0,100.0,0.0,Female
Ameline,2022,6,6,0,100.0,0.0,Female
Belinda,2022,119,119,0,100.0,0.0,Female
Midori,2022,17,17,0,100.0,0.0,Female
Kiyari,2022,7,7,0,100.0,0.0,Female
Royalti,2022,38,38,0,100.0,0.0,Female
Giovonnie,2022,9,0,9,0.0,100.0,Male
Mohid,2022,6,0,6,0.0,100.0,Male
Tremani,2022,6,0,6,0.0,100.0,Male
Tylor,2022,24,0,24,0.0,100.0,Male
Aric,2022,32,0,32,0.0,100.0,Male
Yordin,2022,7,0,7,0.0,100.0,Male
Santonio,2022,8,0,8,0.0,100.0,Male
Kashe,2022,6,0,6,0.0,100.0,Male
Vonn,2022,20,0,20,0.0,100.0,Male
Gustave,2022,13,0,13,0.0,100.0,Male
Khizer,2022,10,0,10,0.0,100.0,Male
Avrumi,2022,9,0,9,0.0,100.0,Male
Cain,2022,250,0,250,0.0,100.0,Male
Khan,2022,21,0,21,0.0,100.0,Male
Ryaan,2022,8,0,8,0.0,100.0,Male
Larson,2022,56,0,56,0.0,100.0,Male
Koleton,2022,6,0,6,0.0,100.0,Male
Muzamil,2022,12,0,12,0.0,100.0,Male
Azyel,2022,9,0,9,0.0,100.0,Male
Opie,2022,47,0,47,0.0,100.0,Male
Jazon,2022,5,0,5,0.0,100.0,Male
Kevante,2022,5,0,5,0.0,100.0,Male
Nino,2022,49,0,49,0.0,100.0,Male
Keiser,2022,5,0,5,0.0,100.0,Male
Keyler,2022,46,0,46,0.0,100.0,Male
Tait,2022,9,0,9,0.0,100.0,Male
Tribe,2022,5,0,5,0.0,100.0,Male
Kyam,2022,8,0,8,0.0,100.0,Male
Vitaliy,2022,6,0,6,0.0,100.0,Male
Abdulaziz,2022,53,0,53,0.0,100.0,Male
Basil,2022,115,28,87,24.347826086956523,75.65217391304347,Unisex
Lux,2022,331,103,228,31.1178247734139,68.8821752265861,Unisex
Waylynn,2022,59,34,25,57.6271186440678,42.3728813559322,Unisex
Aaryn,2022,64,45,19,70.3125,29.6875,Unisex
Loghan,2022,38,27,11,71.05263157894737,28.94736842105264,Unisex
Hayven,2022,96,80,16,83.33333333333334,16.666666666666664,Unisex
Kendal,2022,100,65,35,65.0,35.0,Unisex
Quincee,2022,25,19,6,76.0,24.0,Unisex
Sammie,2022,42,27,15,64.28571428571429,35.714285714285715,Unisex
Dekota,2022,18,11,7,61.11111111111112,38.88888888888889,Unisex
Aimar,2022,27,6,21,22.22222222222222,77.77777777777779,Unisex
Doha,2022,12,7,5,58.333333333333336,41.66666666666667,Unisex
Kaylen,2022,137,87,50,63.503649635036496,36.496350364963504,Unisex
Chaney,2022,17,12,5,70.58823529411765,29.411764705882355,Unisex
Rigby,2022,39,11,28,28.205128205128204,71.7948717948718,Unisex
Vali,2022,18,7,11,38.88888888888889,61.11111111111112,Unisex
Lenox,2022,202,33,169,16.33663366336634,83.66336633663366,Unisex
Breckyn,2022,41,33,8,80.48780487804879,19.51219512195122,Unisex
Marti,2022,12,7,5,58.333333333333336,41.66666666666667,Unisex
Ryn,2022,37,31,6,83.78378378378379,16.216216216216218,Unisex
Skylan,2022,34,18,16,52.94117647058824,47.05882352941176,Unisex
Maguire,2022,15,6,9,40.0,60.0,Unisex
Phenix,2022,48,21,27,43.75,56.25,Unisex
Aiko,2022,79,57,22,72.15189873417721,27.848101265822784,Unisex
Thierry,2022,27,6,21,22.22222222222222,77.77777777777779,Unisex
Graesyn,2022,18,5,13,27.77777777777778,72.22222222222221,Unisex
Happy,2022,16,9,7,56.25,43.75,Unisex
Itzae,2022,126,56,70,44.44444444444444,55.55555555555556,Unisex
Britton,2022,79,24,55,30.37974683544304,69.62025316455697,Unisex
Rynn,2022,46,39,7,84.78260869565217,15.217391304347828,Unisex
