Name,Year,Total_sum,Female_count,Male_count,Female_percentage,Male_percentage,Gender
Beth,2013,1,1,0,100.0,0.0,Female
Tamara,2013,5,5,0,100.0,0.0,Female
Kensi,2013,2,2,0,100.0,0.0,Female
Aniston,2013,1,1,0,100.0,0.0,Female
Kendal,2013,3,3,0,100.0,0.0,Female
Kate,2013,44,44,0,100.0,0.0,Female
Arianne,2013,6,6,0,100.0,0.0,Female
Giovanna,2013,1,1,0,100.0,0.0,Female
Hillary,2013,3,3,0,100.0,0.0,Female
Morley,2013,1,1,0,100.0,0.0,Female
Georgina,2013,2,2,0,100.0,0.0,Female
Riya,2013,11,11,0,100.0,0.0,Female
Jasnoor,2013,3,3,0,100.0,0.0,Female
Carsen,2013,4,0,4,0.0,100.0,Male
Kuol,2013,2,0,2,0.0,100.0,Male
Suber,2013,1,0,1,0.0,100.0,Male
Red,2013,2,0,2,0.0,100.0,Male
Ryden,2013,5,0,5,0.0,100.0,Male
Afan,2013,1,0,1,0.0,100.0,Male
Warren,2013,6,0,6,0.0,100.0,Male
Aydan,2013,4,0,4,0.0,100.0,Male
Daylen,2013,6,0,6,0.0,100.0,Male
Kirat,2013,1,0,1,0.0,100.0,Male
Cage,2013,1,0,1,0.0,100.0,Male
Vivan,2013,2,0,2,0.0,100.0,Male
Shae,2013,252,178,74,70.63492063492063,29.365079365079367,Unisex
Aven,2013,95,58,37,61.05263157894737,38.94736842105263,Unisex
Myer,2013,21,6,15,28.57142857142857,71.42857142857143,Unisex
Eberle,2013,12,8,4,66.66666666666666,33.33333333333333,Unisex
Sage,2013,529,366,163,69.18714555765595,30.812854442344044,Unisex
Beaux,2013,7,3,4,42.85714285714285,57.14285714285714,Unisex
Storm,2013,89,36,53,40.44943820224719,59.55056179775281,Unisex
Ocean,2013,183,149,34,81.4207650273224,18.5792349726776,Unisex
Rory,2013,743,150,593,20.18842530282637,79.81157469717361,Unisex
Austyn,2013,172,79,93,45.93023255813954,54.06976744186046,Unisex
Reece,2013,482,85,397,17.634854771784234,82.36514522821577,Unisex
Dakota,2013,1265,546,719,43.16205533596838,56.837944664031625,Unisex
Lexington,2013,24,15,9,62.5,37.5,Unisex
Rian,2013,74,40,34,54.054054054054056,45.94594594594595,Unisex
Amari,2013,46,17,29,36.95652173913043,63.04347826086957,Unisex
Kyrie,2013,116,48,68,41.37931034482759,58.620689655172406,Unisex
Channing,2013,67,29,38,43.28358208955223,56.71641791044776,Unisex
Drew,2013,880,147,733,16.704545454545457,83.29545454545455,Unisex
Robin,2013,1019,608,411,59.66633954857704,40.333660451422965,Unisex
Amrit,2013,107,54,53,50.467289719626166,49.53271028037384,Unisex
Shiloh,2013,179,145,34,81.00558659217877,18.994413407821227,Unisex
Taylor,2013,6000,3926,2074,65.43333333333334,34.56666666666667,Unisex
Kasey,2013,198,130,68,65.65656565656566,34.34343434343434,Unisex
Harley,2013,524,171,353,32.63358778625955,67.36641221374046,Unisex
Hargun,2013,60,43,17,71.66666666666667,28.33333333333333,Unisex
Dallas,2013,1335,250,1085,18.726591760299627,81.27340823970037,Unisex
Azariah,2013,48,24,24,50.0,50.0,Unisex
Tristyn,2013,113,61,52,53.98230088495575,46.017699115044245,Unisex
Misha,2013,81,58,23,71.60493827160494,28.39506172839506,Unisex
Sehaj,2013,92,49,43,53.2608695652174,46.73913043478261,Unisex
Arden,2013,165,101,64,61.2121212121212,38.78787878787879,Unisex
Sahej,2013,37,17,20,45.94594594594595,54.054054054054056,Unisex
Collins,2013,38,29,9,76.31578947368422,23.684210526315788,Unisex
Remi,2013,152,84,68,55.26315789473685,44.73684210526316,Unisex
Nakota,2013,15,6,9,40.0,60.0,Unisex
Hennessy,2013,14,9,5,64.28571428571429,35.714285714285715,Unisex
Arrow,2013,17,3,14,17.647058823529413,82.35294117647058,Unisex
Jin,2013,32,7,25,21.875,78.125,Unisex
Rayyan,2013,137,21,116,15.328467153284672,84.67153284671532,Unisex
Micah,2013,751,121,630,16.11185086551265,83.88814913448735,Unisex
Layne,2013,414,80,334,19.32367149758454,80.67632850241546,Unisex
Sina,2013,41,17,24,41.46341463414634,58.53658536585365,Unisex
Locklyn,2013,21,15,6,71.42857142857143,28.57142857142857,Unisex
Regan,2013,317,184,133,58.0441640378549,41.95583596214511,Unisex
Emmerson,2013,65,51,14,78.46153846153847,21.53846153846154,Unisex
Israel,2013,80,12,68,15.0,85.0,Unisex
Noa,2013,67,49,18,73.13432835820896,26.86567164179105,Unisex
Morgan,2013,3134,2222,912,70.89980855137205,29.10019144862795,Unisex
Bailey,2013,1550,1259,291,81.2258064516129,18.774193548387096,Unisex
Mackenzie,2013,3387,2605,782,76.91172128727487,23.088278712725124,Unisex
Emry,2013,53,39,14,73.58490566037736,26.41509433962264,Unisex
Casey,2013,1020,397,623,38.92156862745098,61.07843137254903,Unisex
Kelly,2013,2170,1538,632,70.87557603686636,29.12442396313364,Unisex
Harnoor,2013,80,61,19,76.25,23.75,Unisex
Cedar,2013,67,37,30,55.223880597014926,44.776119402985074,Unisex
Sloan,2013,221,153,68,69.23076923076923,30.76923076923077,Unisex
Saihaj,2013,18,7,11,38.88888888888889,61.11111111111112,Unisex
Adair,2013,11,6,5,54.54545454545454,45.45454545454545,Unisex
Miracle,2013,48,39,9,81.25,18.75,Unisex
Jean,2013,226,84,142,37.16814159292036,62.83185840707964,Unisex
Rylie,2013,283,214,69,75.61837455830388,24.38162544169612,Unisex
Jaiden,2013,354,121,233,34.18079096045198,65.81920903954803,Unisex
Amen,2013,84,37,47,44.04761904761904,55.95238095238096,Unisex
Riley,2013,3875,772,3103,19.92258064516129,80.07741935483871,Unisex
Laine,2013,173,72,101,41.61849710982659,58.38150289017341,Unisex
Leighton,2013,246,103,143,41.86991869918699,58.13008130081301,Unisex
Britton,2013,43,16,27,37.2093023255814,62.7906976744186,Unisex
Adan,2013,43,11,32,25.58139534883721,74.4186046511628,Unisex
Aram,2013,29,5,24,17.24137931034483,82.75862068965517,Unisex
Nael,2013,15,5,10,33.33333333333333,66.66666666666666,Unisex
Frankie,2013,172,121,51,70.34883720930233,29.65116279069768,Unisex
Karsyn,2013,62,41,21,66.12903225806451,33.87096774193548,Unisex
Charlie,2013,1163,511,652,43.93809114359416,56.06190885640585,Unisex
Raven,2013,316,261,55,82.59493670886076,17.405063291139243,Unisex
Krishna,2013,36,7,29,19.444444444444446,80.55555555555556,Unisex
Berkley,2013,104,70,34,67.3076923076923,32.69230769230769,Unisex
Eknoor,2013,39,29,10,74.35897435897436,25.64102564102564,Unisex
Samar,2013,78,39,39,50.0,50.0,Unisex
Skyler,2013,616,155,461,25.162337662337663,74.83766233766234,Unisex
Shea,2013,362,139,223,38.39779005524862,61.60220994475139,Unisex
Gurman,2013,83,19,64,22.89156626506024,77.10843373493977,Unisex
Hayden,2013,2132,398,1734,18.66791744840525,81.33208255159474,Unisex
Ira,2013,121,43,78,35.53719008264463,64.46280991735537,Unisex
Lochlyn,2013,32,21,11,65.625,34.375,Unisex
Kingsley,2013,155,40,115,25.806451612903224,74.19354838709677,Unisex
Ever,2013,23,15,8,65.21739130434783,34.78260869565217,Unisex
Azaria,2013,36,30,6,83.33333333333334,16.666666666666664,Unisex
Rayne,2013,195,159,36,81.53846153846153,18.461538461538463,Unisex
Bryer,2013,53,14,39,26.41509433962264,73.58490566037736,Unisex
Japman,2013,9,2,7,22.22222222222222,77.77777777777779,Unisex
Teagan,2013,759,612,147,80.63241106719367,19.367588932806324,Unisex
Elliott,2013,511,88,423,17.22113502935421,82.7788649706458,Unisex
Rio,2013,94,36,58,38.297872340425535,61.70212765957447,Unisex
Haven,2013,204,161,43,78.92156862745098,21.07843137254902,Unisex
Jia,2013,60,45,15,75.0,25.0,Unisex
Avory,2013,14,7,7,50.0,50.0,Unisex
Sawyer,2013,1252,349,903,27.875399361022364,72.12460063897763,Unisex
Adley,2013,69,58,11,84.05797101449275,15.942028985507244,Unisex
Avery,2013,2875,2124,751,73.87826086956521,26.121739130434783,Unisex
Meyer,2013,17,4,13,23.52941176470588,76.47058823529412,Unisex
Prabhjot,2013,64,32,32,50.0,50.0,Unisex
Levy,2013,13,4,9,30.76923076923077,69.23076923076923,Unisex
Sidney,2013,359,203,156,56.54596100278552,43.45403899721448,Unisex
Isa,2013,46,9,37,19.565217391304348,80.43478260869566,Unisex
Rowen,2013,147,49,98,33.33333333333333,66.66666666666666,Unisex
Maddyn,2013,27,22,5,81.48148148148148,18.51851851851852,Unisex
Ayan,2013,85,20,65,23.52941176470588,76.47058823529412,Unisex
Tegan,2013,370,300,70,81.08108108108108,18.91891891891892,Unisex
Kiran,2013,123,64,59,52.03252032520326,47.96747967479675,Unisex
Mika,2013,148,120,28,81.08108108108108,18.91891891891892,Unisex
Dakoda,2013,71,33,38,46.478873239436616,53.52112676056338,Unisex
Avi,2013,52,18,34,34.61538461538461,65.38461538461539,Unisex
Quinn,2013,1791,973,818,54.32719151312117,45.67280848687884,Unisex
Shay,2013,181,89,92,49.17127071823205,50.82872928176796,Unisex
Malin,2013,30,21,9,70.0,30.0,Unisex
Wren,2013,145,111,34,76.55172413793103,23.448275862068964,Unisex
Mikal,2013,24,10,14,41.66666666666667,58.333333333333336,Unisex
Lennox,2013,182,35,147,19.23076923076924,80.76923076923077,Unisex
Devyn,2013,243,176,67,72.42798353909465,27.57201646090536,Unisex
Sidak,2013,28,10,18,35.714285714285715,64.28571428571429,Unisex
Oakley,2013,215,71,144,33.02325581395349,66.97674418604652,Unisex
Blair,2013,747,149,598,19.94645247657296,80.05354752342704,Unisex
Sunny,2013,105,47,58,44.761904761904766,55.23809523809524,Unisex
Skylar,2013,786,501,285,63.74045801526718,36.25954198473282,Unisex
Jireh,2013,13,5,8,38.46153846153847,61.53846153846154,Unisex
Kacey,2013,158,131,27,82.91139240506328,17.088607594936708,Unisex
London,2013,325,258,67,79.38461538461539,20.615384615384617,Unisex
Lian,2013,38,19,19,50.0,50.0,Unisex
Lyric,2013,159,99,60,62.264150943396224,37.735849056603776,Unisex
Elisha,2013,299,241,58,80.60200668896321,19.39799331103679,Unisex
Eliyah,2013,12,10,2,83.33333333333334,16.666666666666664,Unisex
Adison,2013,70,50,20,71.42857142857143,28.57142857142857,Unisex
Memphis,2013,166,37,129,22.289156626506024,77.71084337349397,Unisex
Jaden,2013,1158,209,949,18.04835924006908,81.95164075993091,Unisex
Alek,2013,36,11,25,30.55555555555556,69.44444444444444,Unisex
Hartley,2013,37,18,19,48.64864864864865,51.35135135135135,Unisex
Berkeley,2013,25,17,8,68.0,32.0,Unisex
Lennon,2013,247,131,116,53.036437246963565,46.96356275303644,Unisex
Henley,2013,73,50,23,68.4931506849315,31.506849315068493,Unisex
Kessler,2013,36,6,30,16.666666666666664,83.33333333333334,Unisex
Ebubechukwu,2013,8,3,5,37.5,62.5,Unisex
Lennix,2013,19,12,7,63.1578947368421,36.84210526315789,Unisex
Agamjot,2013,29,14,15,48.27586206896552,51.72413793103448,Unisex
Gurasees,2013,9,6,3,66.66666666666666,33.33333333333333,Unisex
Brook,2013,144,101,43,70.13888888888889,29.86111111111111,Unisex
Sri,2013,8,3,5,37.5,62.5,Unisex
Cairo,2013,38,9,29,23.684210526315788,76.31578947368422,Unisex
Ryley,2013,757,144,613,19.0224570673712,80.9775429326288,Unisex
Finley,2013,517,229,288,44.294003868471954,55.705996131528046,Unisex
Alexi,2013,92,62,30,67.3913043478261,32.608695652173914,Unisex
Sutton,2013,70,39,31,55.71428571428572,44.285714285714285,Unisex
Rowan,2013,1033,400,633,38.72216844143272,61.27783155856727,Unisex
Mikal,2014,1,1,0,100.0,0.0,Female
Kaylynn,2014,4,4,0,100.0,0.0,Female
Lilyana,2014,1,1,0,100.0,0.0,Female
Daya,2014,1,1,0,100.0,0.0,Female
Aaria,2014,1,1,0,100.0,0.0,Female
Iliana,2014,3,3,0,100.0,0.0,Female
Aileen,2014,6,6,0,100.0,0.0,Female
Kensi,2014,4,4,0,100.0,0.0,Female
Lyka,2014,1,1,0,100.0,0.0,Female
Diamond,2014,4,4,0,100.0,0.0,Female
Rania,2014,4,4,0,100.0,0.0,Female
Mesgana,2014,1,1,0,100.0,0.0,Female
Saraya,2014,1,1,0,100.0,0.0,Female
Keyton,2014,1,1,0,100.0,0.0,Female
Adalind,2014,4,4,0,100.0,0.0,Female
Giovanna,2014,2,2,0,100.0,0.0,Female
Mave,2014,1,1,0,100.0,0.0,Female
Adelyn,2014,27,27,0,100.0,0.0,Female
Aimal,2014,1,1,0,100.0,0.0,Female
Ripley,2014,3,3,0,100.0,0.0,Female
Lovely,2014,1,1,0,100.0,0.0,Female
Petar,2014,2,0,2,0.0,100.0,Male
Daniel,2014,160,0,160,0.0,100.0,Male
Ricky,2014,5,0,5,0.0,100.0,Male
Jadiel,2014,1,0,1,0.0,100.0,Male
Jordy,2014,1,0,1,0.0,100.0,Male
Neer,2014,1,0,1,0.0,100.0,Male
Kaysen,2014,9,0,9,0.0,100.0,Male
Tyrone,2014,4,0,4,0.0,100.0,Male
Bodie,2014,1,0,1,0.0,100.0,Male
Andrei,2014,6,0,6,0.0,100.0,Male
Carsen,2014,1,0,1,0.0,100.0,Male
Valor,2014,1,0,1,0.0,100.0,Male
Daylen,2014,106,8,98,7.547169811320755,92.45283018867924,Male
Leopoldo,2014,1,0,1,0.0,100.0,Male
Ilyas,2014,4,0,4,0.0,100.0,Male
Cage,2014,2,0,2,0.0,100.0,Male
Gray,2014,58,11,47,18.96551724137931,81.03448275862068,Unisex
Hayden,2014,2132,398,1734,18.66791744840525,81.33208255159474,Unisex
Nikita,2014,326,273,53,83.74233128834356,16.257668711656443,Unisex
Shea,2014,362,139,223,38.39779005524862,61.60220994475139,Unisex
Mylo,2014,40,7,33,17.5,82.5,Unisex
Iliya,2014,7,2,5,28.57142857142857,71.42857142857143,Unisex
Berkeley,2014,25,17,8,68.0,32.0,Unisex
Quinn,2014,1791,973,818,54.32719151312117,45.67280848687884,Unisex
Korbyn,2014,52,8,44,15.384615384615383,84.61538461538461,Unisex
Jessie,2014,1214,784,430,64.57990115321252,35.42009884678748,Unisex
Rome,2014,50,8,42,16.0,84.0,Unisex
Micah,2014,751,121,630,16.11185086551265,83.88814913448735,Unisex
Arshia,2014,14,10,4,71.42857142857143,28.57142857142857,Unisex
Emery,2014,519,333,186,64.16184971098265,35.83815028901734,Unisex
Elliott,2014,511,88,423,17.22113502935421,82.7788649706458,Unisex
Sahej,2014,37,17,20,45.94594594594595,54.054054054054056,Unisex
Eberle,2014,12,8,4,66.66666666666666,33.33333333333333,Unisex
Agamjot,2014,29,14,15,48.27586206896552,51.72413793103448,Unisex
Rayan,2014,271,79,192,29.15129151291513,70.84870848708486,Unisex
Jin,2014,32,7,25,21.875,78.125,Unisex
Jamie,2014,2713,1642,1071,60.52340582381128,39.476594176188726,Unisex
Ellis,2014,263,54,209,20.53231939163498,79.46768060836501,Unisex
Ryley,2014,757,144,613,19.0224570673712,80.9775429326288,Unisex
Shalom,2014,47,35,12,74.46808510638297,25.53191489361702,Unisex
Charlie,2014,1163,511,652,43.93809114359416,56.06190885640585,Unisex
Hartley,2014,37,18,19,48.64864864864865,51.35135135135135,Unisex
Anmol,2014,89,48,41,53.93258426966292,46.06741573033708,Unisex
Sina,2014,41,17,24,41.46341463414634,58.53658536585365,Unisex
Sehaj,2014,92,49,43,53.2608695652174,46.73913043478261,Unisex
Sloan,2014,221,153,68,69.23076923076923,30.76923076923077,Unisex
Adel,2014,33,7,26,21.21212121212121,78.78787878787878,Unisex
Kolby,2014,277,44,233,15.884476534296027,84.11552346570397,Unisex
Rory,2014,743,150,593,20.18842530282637,79.81157469717361,Unisex
Elliotte,2014,25,21,4,84.0,16.0,Unisex
Bailey,2014,1550,1259,291,81.2258064516129,18.774193548387096,Unisex
Tegan,2014,370,300,70,81.08108108108108,18.91891891891892,Unisex
Morgan,2014,3134,2222,912,70.89980855137205,29.10019144862795,Unisex
Finley,2014,517,229,288,44.294003868471954,55.705996131528046,Unisex
Rian,2014,74,40,34,54.054054054054056,45.94594594594595,Unisex
Darian,2014,433,110,323,25.40415704387991,74.5958429561201,Unisex
Locklyn,2014,21,15,6,71.42857142857143,28.57142857142857,Unisex
Rowen,2014,147,49,98,33.33333333333333,66.66666666666666,Unisex
Arden,2014,165,101,64,61.2121212121212,38.78787878787879,Unisex
Ren,2014,26,5,21,19.23076923076924,80.76923076923077,Unisex
Scout,2014,40,28,12,70.0,30.0,Unisex
Aikam,2014,64,32,32,50.0,50.0,Unisex
Gursehaj,2014,14,6,8,42.85714285714285,57.14285714285714,Unisex
Alexi,2014,92,62,30,67.3913043478261,32.608695652173914,Unisex
Artemis,2014,22,17,5,77.27272727272727,22.727272727272727,Unisex
Sunny,2014,105,47,58,44.761904761904766,55.23809523809524,Unisex
Karsyn,2014,62,41,21,66.12903225806451,33.87096774193548,Unisex
Leyton,2014,33,5,28,15.151515151515152,84.84848484848484,Unisex
Finnley,2014,136,46,90,33.82352941176471,66.17647058823529,Unisex
Riley,2014,3875,772,3103,19.92258064516129,80.07741935483871,Unisex
Kasey,2014,198,130,68,65.65656565656566,34.34343434343434,Unisex
Kirat,2014,28,21,7,75.0,25.0,Unisex
Nikola,2014,92,24,68,26.08695652173913,73.91304347826086,Unisex
Dakota,2014,1265,546,719,43.16205533596838,56.837944664031625,Unisex
Layne,2014,414,80,334,19.32367149758454,80.67632850241546,Unisex
Breton,2014,57,11,46,19.29824561403509,80.7017543859649,Unisex
Ashtyn,2014,117,88,29,75.21367521367522,24.786324786324787,Unisex
Mackenzie,2014,3387,2605,782,76.91172128727487,23.088278712725124,Unisex
Maddyn,2014,27,22,5,81.48148148148148,18.51851851851852,Unisex
Maneet,2014,26,14,12,53.84615384615385,46.15384615384615,Unisex
Zuriel,2014,13,7,6,53.84615384615385,46.15384615384615,Unisex
Teegan,2014,125,56,69,44.8,55.2,Unisex
Reegan,2014,110,70,40,63.63636363636363,36.36363636363637,Unisex
Mika,2014,148,120,28,81.08108108108108,18.91891891891892,Unisex
Clarke,2014,91,17,74,18.68131868131868,81.31868131868131,Unisex
Everette,2014,25,4,21,16.0,84.0,Unisex
Lemmy,2014,10,3,7,30.0,70.0,Unisex
Sidney,2014,359,203,156,56.54596100278552,43.45403899721448,Unisex
Dallas,2014,1335,250,1085,18.726591760299627,81.27340823970037,Unisex
Levy,2014,13,4,9,30.76923076923077,69.23076923076923,Unisex
River,2014,416,173,243,41.58653846153847,58.41346153846154,Unisex
Reagan,2014,248,186,62,75.0,25.0,Unisex
Payton,2014,1128,936,192,82.97872340425532,17.02127659574468,Unisex
Mikah,2014,27,16,11,59.25925925925925,40.74074074074074,Unisex
Cypress,2014,19,9,10,47.368421052631575,52.63157894736842,Unisex
Jia,2014,60,45,15,75.0,25.0,Unisex
Teagan,2014,759,612,147,80.63241106719367,19.367588932806324,Unisex
Jasnoor,2014,41,30,11,73.17073170731707,26.82926829268293,Unisex
Remi,2014,152,84,68,55.26315789473685,44.73684210526316,Unisex
Riyan,2014,20,9,11,45.0,55.00000000000001,Unisex
Emrys,2014,23,9,14,39.130434782608695,60.86956521739131,Unisex
Henley,2014,73,50,23,68.4931506849315,31.506849315068493,Unisex
Ruari,2014,11,4,7,36.36363636363637,63.63636363636363,Unisex
Emmerson,2014,65,51,14,78.46153846153847,21.53846153846154,Unisex
Saman,2014,8,4,4,50.0,50.0,Unisex
Kenley,2014,57,46,11,80.7017543859649,19.29824561403509,Unisex
Nihal,2014,60,13,47,21.666666666666668,78.33333333333333,Unisex
Lyric,2014,159,99,60,62.264150943396224,37.735849056603776,Unisex
Rylee,2014,830,698,132,84.09638554216868,15.903614457831324,Unisex
Kacey,2014,158,131,27,82.91139240506328,17.088607594936708,Unisex
Harley,2014,524,171,353,32.63358778625955,67.36641221374046,Unisex
Collins,2014,38,29,9,76.31578947368422,23.684210526315788,Unisex
Kena,2014,9,6,3,66.66666666666666,33.33333333333333,Unisex
Salem,2014,62,22,40,35.483870967741936,64.51612903225806,Unisex
Gurman,2014,83,19,64,22.89156626506024,77.10843373493977,Unisex
Kyrie,2014,116,48,68,41.37931034482759,58.620689655172406,Unisex
Japman,2014,9,2,7,22.22222222222222,77.77777777777779,Unisex
Kendell,2014,47,33,14,70.2127659574468,29.78723404255319,Unisex
Sage,2014,529,366,163,69.18714555765595,30.812854442344044,Unisex
Reign,2014,43,17,26,39.53488372093023,60.46511627906976,Unisex
Amrit,2014,107,54,53,50.467289719626166,49.53271028037384,Unisex
Wynn,2014,58,27,31,46.55172413793103,53.44827586206896,Unisex
Jaiden,2014,354,121,233,34.18079096045198,65.81920903954803,Unisex
Eastyn,2014,37,17,20,45.94594594594595,54.054054054054056,Unisex
Avery,2014,2875,2124,751,73.87826086956521,26.121739130434783,Unisex
Mckinley,2014,178,150,28,84.26966292134831,15.730337078651685,Unisex
Jean,2014,226,84,142,37.16814159292036,62.83185840707964,Unisex
Skyler,2014,616,155,461,25.162337662337663,74.83766233766234,Unisex
Emerson,2014,735,303,432,41.224489795918366,58.77551020408164,Unisex
Riel,2014,74,22,52,29.72972972972973,70.27027027027027,Unisex
Raven,2014,316,261,55,82.59493670886076,17.405063291139243,Unisex
Sawyer,2014,1252,349,903,27.875399361022364,72.12460063897763,Unisex
Ayan,2014,85,20,65,23.52941176470588,76.47058823529412,Unisex
Adison,2014,70,50,20,71.42857142857143,28.57142857142857,Unisex
Royal,2014,29,12,17,41.37931034482759,58.620689655172406,Unisex
London,2014,325,258,67,79.38461538461539,20.615384615384617,Unisex
Murphy,2014,45,20,25,44.44444444444444,55.55555555555556,Unisex
Sky,2014,135,86,49,63.70370370370371,36.2962962962963,Unisex
Raine,2014,151,86,65,56.95364238410596,43.04635761589404,Unisex
Casey,2014,1020,397,623,38.92156862745098,61.07843137254903,Unisex
Lochlyn,2014,32,21,11,65.625,34.375,Unisex
Samar,2014,78,39,39,50.0,50.0,Unisex
Elisha,2014,299,241,58,80.60200668896321,19.39799331103679,Unisex
Stirling,2014,36,9,27,25.0,75.0,Unisex
Mehar,2014,79,61,18,77.21518987341773,22.78481012658228,Unisex
Ira,2014,121,43,78,35.53719008264463,64.46280991735537,Unisex
Yael,2014,22,18,4,81.81818181818183,18.181818181818183,Unisex
Storm,2014,89,36,53,40.44943820224719,59.55056179775281,Unisex
Kendall,2014,490,374,116,76.32653061224491,23.6734693877551,Unisex
Aiven,2014,7,2,5,28.57142857142857,71.42857142857143,Unisex
Nyjah,2014,10,2,8,20.0,80.0,Unisex
Regan,2014,317,184,133,58.0441640378549,41.95583596214511,Unisex
Reilly,2014,138,48,90,34.78260869565217,65.21739130434783,Unisex
Remington,2014,125,20,105,16.0,84.0,Unisex
Lian,2014,38,19,19,50.0,50.0,Unisex
Reese,2014,812,536,276,66.00985221674877,33.99014778325123,Unisex
Rowan,2014,1033,400,633,38.72216844143272,61.27783155856727,Unisex
Aydan,2014,63,14,49,22.22222222222222,77.77777777777779,Unisex
Miracle,2014,48,39,9,81.25,18.75,Unisex
Nana,2014,34,19,15,55.88235294117647,44.11764705882353,Unisex
Jensen,2014,177,47,130,26.55367231638418,73.44632768361582,Unisex
Grey,2014,56,10,46,17.857142857142858,82.14285714285714,Unisex
Dominique,2014,412,332,80,80.58252427184466,19.41747572815534,Unisex
Lael,2014,29,19,10,65.51724137931035,34.48275862068966,Unisex
Lennon,2014,247,131,116,53.036437246963565,46.96356275303644,Unisex
Azariah,2014,48,24,24,50.0,50.0,Unisex
Tristen,2014,471,74,397,15.711252653927811,84.28874734607218,Unisex
Ebubechukwu,2014,8,3,5,37.5,62.5,Unisex
Braxtyn,2014,26,9,17,34.61538461538461,65.38461538461539,Unisex
Oluwademilade,2014,9,6,3,66.66666666666666,33.33333333333333,Unisex
Brier,2014,26,15,11,57.692307692307686,42.30769230769231,Unisex
Gurnoor,2014,123,76,47,61.78861788617886,38.21138211382114,Unisex
Kelly,2014,2170,1538,632,70.87557603686636,29.12442396313364,Unisex
Taylor,2014,6000,3926,2074,65.43333333333334,34.56666666666667,Unisex
Adan,2014,43,11,32,25.58139534883721,74.4186046511628,Unisex
Myer,2014,21,6,15,28.57142857142857,71.42857142857143,Unisex
Avi,2014,52,18,34,34.61538461538461,65.38461538461539,Unisex
Lana,2015,20,20,0,100.0,0.0,Female
Atley,2015,1,1,0,100.0,0.0,Female
Pyper,2015,9,9,0,100.0,0.0,Female
Saige,2015,13,13,0,100.0,0.0,Female
Tamara,2015,9,9,0,100.0,0.0,Female
Macy,2015,21,21,0,100.0,0.0,Female
Graceyn,2015,1,1,0,100.0,0.0,Female
Adah,2015,1,1,0,100.0,0.0,Female
Desiree,2015,4,4,0,100.0,0.0,Female
Beth,2015,6,6,0,100.0,0.0,Female
Gurbani,2015,1,1,0,100.0,0.0,Female
Andrei,2015,3,0,3,0.0,100.0,Male
Kolten,2015,5,0,5,0.0,100.0,Male
Afan,2015,1,0,1,0.0,100.0,Male
Suhail,2015,1,0,1,0.0,100.0,Male
Tanay,2015,1,0,1,0.0,100.0,Male
Daniel,2015,9434,9,9425,0.0953996184015263,99.90460038159848,Male
Bodie,2015,4,0,4,0.0,100.0,Male
Yuri,2015,4,0,4,0.0,100.0,Male
Tyreke,2015,2,0,2,0.0,100.0,Male
Emilio,2015,5,0,5,0.0,100.0,Male
Kuol,2015,1,0,1,0.0,100.0,Male
Ilyas,2015,8,0,8,0.0,100.0,Male
Stephen,2015,24,0,24,0.0,100.0,Male
Nathaniel,2015,63,0,63,0.0,100.0,Male
Stryker,2015,2,0,2,0.0,100.0,Male
Saman,2015,1,0,1,0.0,100.0,Male
Jonathan,2015,47,0,47,0.0,100.0,Male
Micah,2015,751,121,630,16.11185086551265,83.88814913448735,Unisex
Emerson,2015,735,303,432,41.224489795918366,58.77551020408164,Unisex
Adair,2015,11,6,5,54.54545454545454,45.45454545454545,Unisex
Yael,2015,22,18,4,81.81818181818183,18.181818181818183,Unisex
Arden,2015,165,101,64,61.2121212121212,38.78787878787879,Unisex
Gurasees,2015,9,6,3,66.66666666666666,33.33333333333333,Unisex
Gurman,2015,83,19,64,22.89156626506024,77.10843373493977,Unisex
Henley,2015,73,50,23,68.4931506849315,31.506849315068493,Unisex
Salem,2015,62,22,40,35.483870967741936,64.51612903225806,Unisex
Toryn,2015,43,13,30,30.23255813953488,69.76744186046511,Unisex
Sky,2015,135,86,49,63.70370370370371,36.2962962962963,Unisex
Skylar,2015,786,501,285,63.74045801526718,36.25954198473282,Unisex
Miracle,2015,48,39,9,81.25,18.75,Unisex
Shae,2015,252,178,74,70.63492063492063,29.365079365079367,Unisex
Rylee,2015,830,698,132,84.09638554216868,15.903614457831324,Unisex
Hollis,2015,30,12,18,40.0,60.0,Unisex
Nikita,2015,326,273,53,83.74233128834356,16.257668711656443,Unisex
Karsyn,2015,62,41,21,66.12903225806451,33.87096774193548,Unisex
River,2015,416,173,243,41.58653846153847,58.41346153846154,Unisex
Eastyn,2015,37,17,20,45.94594594594595,54.054054054054056,Unisex
Sage,2015,529,366,163,69.18714555765595,30.812854442344044,Unisex
Yohanan,2015,6,4,2,66.66666666666666,33.33333333333333,Unisex
Creedence,2015,20,4,16,20.0,80.0,Unisex
An,2015,44,29,15,65.9090909090909,34.090909090909086,Unisex
Emmerson,2015,65,51,14,78.46153846153847,21.53846153846154,Unisex
Lael,2015,29,19,10,65.51724137931035,34.48275862068966,Unisex
Morgan,2015,3134,2222,912,70.89980855137205,29.10019144862795,Unisex
Kaidyn,2015,54,24,30,44.44444444444444,55.55555555555556,Unisex
Blessing,2015,31,24,7,77.41935483870968,22.58064516129032,Unisex
Alexi,2015,92,62,30,67.3913043478261,32.608695652173914,Unisex
Berkeley,2015,25,17,8,68.0,32.0,Unisex
August,2015,166,42,124,25.301204819277107,74.69879518072288,Unisex
Sanjam,2015,9,7,2,77.77777777777779,22.22222222222222,Unisex
Ayan,2015,85,20,65,23.52941176470588,76.47058823529412,Unisex
Leslie,2015,620,425,195,68.54838709677419,31.451612903225808,Unisex
Camdyn,2015,32,26,6,81.25,18.75,Unisex
Ellis,2015,263,54,209,20.53231939163498,79.46768060836501,Unisex
Skyler,2015,616,155,461,25.162337662337663,74.83766233766234,Unisex
Berkley,2015,104,70,34,67.3076923076923,32.69230769230769,Unisex
Elisha,2015,299,241,58,80.60200668896321,19.39799331103679,Unisex
Leighton,2015,246,103,143,41.86991869918699,58.13008130081301,Unisex
Jaskirat,2015,42,17,25,40.47619047619048,59.523809523809526,Unisex
Lennon,2015,247,131,116,53.036437246963565,46.96356275303644,Unisex
Jasnoor,2015,41,30,11,73.17073170731707,26.82926829268293,Unisex
Shiloh,2015,179,145,34,81.00558659217877,18.994413407821227,Unisex
Avory,2015,14,7,7,50.0,50.0,Unisex
Dallas,2015,1335,250,1085,18.726591760299627,81.27340823970037,Unisex
Taylor,2015,6000,3926,2074,65.43333333333334,34.56666666666667,Unisex
Austyn,2015,172,79,93,45.93023255813954,54.06976744186046,Unisex
Kendall,2015,490,374,116,76.32653061224491,23.6734693877551,Unisex
Aven,2015,95,58,37,61.05263157894737,38.94736842105263,Unisex
Jordan,2015,8033,1400,6633,17.428109050168057,82.57189094983194,Unisex
Jessie,2015,1214,784,430,64.57990115321252,35.42009884678748,Unisex
Lennox,2015,182,35,147,19.23076923076924,80.76923076923077,Unisex
Joud,2015,29,5,24,17.24137931034483,82.75862068965517,Unisex
Rowan,2015,1033,400,633,38.72216844143272,61.27783155856727,Unisex
Agamjot,2015,29,14,15,48.27586206896552,51.72413793103448,Unisex
Kingsley,2015,155,40,115,25.806451612903224,74.19354838709677,Unisex
Haven,2015,204,161,43,78.92156862745098,21.07843137254902,Unisex
Tatum,2015,304,230,74,75.6578947368421,24.34210526315789,Unisex
Dakota,2015,1265,546,719,43.16205533596838,56.837944664031625,Unisex
Kyrie,2015,116,48,68,41.37931034482759,58.620689655172406,Unisex
Mika,2015,148,120,28,81.08108108108108,18.91891891891892,Unisex
Teegan,2015,125,56,69,44.8,55.2,Unisex
Rylie,2015,283,214,69,75.61837455830388,24.38162544169612,Unisex
Wren,2015,145,111,34,76.55172413793103,23.448275862068964,Unisex
Xi,2015,5,2,3,40.0,60.0,Unisex
Quincy,2015,118,40,78,33.89830508474576,66.10169491525424,Unisex
Emrys,2015,23,9,14,39.130434782608695,60.86956521739131,Unisex
Lyric,2015,159,99,60,62.264150943396224,37.735849056603776,Unisex
Quinn,2015,1791,973,818,54.32719151312117,45.67280848687884,Unisex
Rio,2015,94,36,58,38.297872340425535,61.70212765957447,Unisex
Anmol,2015,89,48,41,53.93258426966292,46.06741573033708,Unisex
Morley,2015,26,12,14,46.15384615384615,53.84615384615385,Unisex
Elliott,2015,511,88,423,17.22113502935421,82.7788649706458,Unisex
Grey,2015,56,10,46,17.857142857142858,82.14285714285714,Unisex
Casey,2015,1020,397,623,38.92156862745098,61.07843137254903,Unisex
Reese,2015,812,536,276,66.00985221674877,33.99014778325123,Unisex
Indiana,2015,54,31,23,57.407407407407405,42.5925925925926,Unisex
Sidney,2015,359,203,156,56.54596100278552,43.45403899721448,Unisex
Daryn,2015,50,14,36,28.000000000000004,72.0,Unisex
Hayden,2015,2132,398,1734,18.66791744840525,81.33208255159474,Unisex
Reece,2015,482,85,397,17.634854771784234,82.36514522821577,Unisex
Hunar,2015,10,7,3,70.0,30.0,Unisex
Avery,2015,2875,2124,751,73.87826086956521,26.121739130434783,Unisex
Riley,2015,3875,772,3103,19.92258064516129,80.07741935483871,Unisex
London,2015,325,258,67,79.38461538461539,20.615384615384617,Unisex
Rhythm,2015,23,10,13,43.47826086956522,56.52173913043478,Unisex
Reign,2015,43,17,26,39.53488372093023,60.46511627906976,Unisex
Nihal,2015,60,13,47,21.666666666666668,78.33333333333333,Unisex
Imaan,2015,48,36,12,75.0,25.0,Unisex
Clarke,2015,91,17,74,18.68131868131868,81.31868131868131,Unisex
Blair,2015,747,149,598,19.94645247657296,80.05354752342704,Unisex
Rian,2015,74,40,34,54.054054054054056,45.94594594594595,Unisex
Jamie,2015,2713,1642,1071,60.52340582381128,39.476594176188726,Unisex
Lian,2015,38,19,19,50.0,50.0,Unisex
Kirat,2015,28,21,7,75.0,25.0,Unisex
Frankie,2015,172,121,51,70.34883720930233,29.65116279069768,Unisex
Reeve,2015,55,11,44,20.0,80.0,Unisex
Drew,2015,880,147,733,16.704545454545457,83.29545454545455,Unisex
Rory,2015,743,150,593,20.18842530282637,79.81157469717361,Unisex
Mikal,2015,24,10,14,41.66666666666667,58.333333333333336,Unisex
Arie,2015,69,14,55,20.28985507246377,79.71014492753623,Unisex
Hartley,2015,37,18,19,48.64864864864865,51.35135135135135,Unisex
Jaden,2015,1158,209,949,18.04835924006908,81.95164075993091,Unisex
Sloan,2015,221,153,68,69.23076923076923,30.76923076923077,Unisex
Leyton,2015,33,5,28,15.151515151515152,84.84848484848484,Unisex
Lenyx,2015,10,8,2,80.0,20.0,Unisex
Adan,2015,43,11,32,25.58139534883721,74.4186046511628,Unisex
Phoenix,2015,600,248,352,41.333333333333336,58.66666666666666,Unisex
Kena,2015,9,6,3,66.66666666666666,33.33333333333333,Unisex
Rowen,2015,147,49,98,33.33333333333333,66.66666666666666,Unisex
Adriel,2015,93,14,79,15.053763440860216,84.94623655913979,Unisex
Raven,2015,316,261,55,82.59493670886076,17.405063291139243,Unisex
Emry,2015,53,39,14,73.58490566037736,26.41509433962264,Unisex
Gursehaj,2015,14,6,8,42.85714285714285,57.14285714285714,Unisex
Tegan,2015,370,300,70,81.08108108108108,18.91891891891892,Unisex
Scout,2015,40,28,12,70.0,30.0,Unisex
Mehar,2015,79,61,18,77.21518987341773,22.78481012658228,Unisex
Aikam,2015,64,32,32,50.0,50.0,Unisex
Ifeoluwa,2015,15,8,7,53.333333333333336,46.66666666666666,Unisex
Harnoor,2015,80,61,19,76.25,23.75,Unisex
Kasey,2015,198,130,68,65.65656565656566,34.34343434343434,Unisex
Justice,2015,426,159,267,37.32394366197183,62.676056338028175,Unisex
Misha,2015,81,58,23,71.60493827160494,28.39506172839506,Unisex
Harjas,2015,37,13,24,35.13513513513514,64.86486486486487,Unisex
Cedar,2015,67,37,30,55.223880597014926,44.776119402985074,Unisex
Jia,2015,60,45,15,75.0,25.0,Unisex
Bellamy,2015,21,10,11,47.61904761904761,52.38095238095239,Unisex
Harvie,2015,4,2,2,50.0,50.0,Unisex
Krishna,2015,36,7,29,19.444444444444446,80.55555555555556,Unisex
Jensen,2015,177,47,130,26.55367231638418,73.44632768361582,Unisex
Sidak,2015,28,10,18,35.714285714285715,64.28571428571429,Unisex
Charlie,2015,1163,511,652,43.93809114359416,56.06190885640585,Unisex
Jules,2015,97,41,56,42.2680412371134,57.73195876288659,Unisex
Indigo,2015,30,22,8,73.33333333333333,26.666666666666668,Unisex
Hennessy,2015,14,9,5,64.28571428571429,35.714285714285715,Unisex
Gray,2015,58,11,47,18.96551724137931,81.03448275862068,Unisex
Amrit,2015,107,54,53,50.467289719626166,49.53271028037384,Unisex
Shea,2015,362,139,223,38.39779005524862,61.60220994475139,Unisex
Peyton,2015,1282,1021,261,79.6411856474259,20.358814352574104,Unisex
Hargun,2015,60,43,17,71.66666666666667,28.33333333333333,Unisex
Renly,2015,7,3,4,42.85714285714285,57.14285714285714,Unisex
Jaeden,2015,88,21,67,23.863636363636363,76.13636363636364,Unisex
Israel,2015,80,12,68,15.0,85.0,Unisex
Indy,2015,28,14,14,50.0,50.0,Unisex
Shia,2015,22,13,9,59.09090909090909,40.909090909090914,Unisex
Memphis,2015,166,37,129,22.289156626506024,77.71084337349397,Unisex
Anant,2015,21,5,16,23.809523809523807,76.19047619047619,Unisex
Nikola,2015,92,24,68,26.08695652173913,73.91304347826086,Unisex
Eknoor,2015,39,29,10,74.35897435897436,25.64102564102564,Unisex
Shalom,2015,47,35,12,74.46808510638297,25.53191489361702,Unisex
Ezrah,2015,22,11,11,50.0,50.0,Unisex
Kolby,2015,277,44,233,15.884476534296027,84.11552346570397,Unisex
Ocean,2015,183,149,34,81.4207650273224,18.5792349726776,Unisex
Ira,2015,121,43,78,35.53719008264463,64.46280991735537,Unisex
Ripley,2016,3,3,0,100.0,0.0,Female
Franky,2016,1,1,0,100.0,0.0,Female
Gurbani,2016,6,6,0,100.0,0.0,Female
Hillary,2016,1,1,0,100.0,0.0,Female
Desiree,2016,3,3,0,100.0,0.0,Female
Graceyn,2016,1,1,0,100.0,0.0,Female
Kaylynn,2016,2,2,0,100.0,0.0,Female
Zuriel,2016,1,1,0,100.0,0.0,Female
Guinevere,2016,1,1,0,100.0,0.0,Female
Kate,2016,41,41,0,100.0,0.0,Female
Hudsyn,2016,2,2,0,100.0,0.0,Female
Macy,2016,9,9,0,100.0,0.0,Female
Arianne,2016,7,7,0,100.0,0.0,Female
Ever,2016,1,1,0,100.0,0.0,Female
Daya,2016,1,1,0,100.0,0.0,Female
Lyka,2016,7,6,1,85.71428571428571,14.285714285714285,Female
Leslie,2016,1,1,0,100.0,0.0,Female
Silver,2016,2,2,0,100.0,0.0,Female
James,2016,7601,7,7594,0.0920931456387317,99.90790685436129,Male
Tanay,2016,1,0,1,0.0,100.0,Male
Valor,2016,1,0,1,0.0,100.0,Male
Jonathan,2016,40,0,40,0.0,100.0,Male
Lucian,2016,4,0,4,0.0,100.0,Male
Tyreke,2016,1,0,1,0.0,100.0,Male
Ellison,2016,2,0,2,0.0,100.0,Male
Ryden,2016,5,0,5,0.0,100.0,Male
Emilio,2016,6,0,6,0.0,100.0,Male
Jordy,2016,4,0,4,0.0,100.0,Male
Kendell,2016,1,0,1,0.0,100.0,Male
Kurt,2016,7,0,7,0.0,100.0,Male
Sayed,2016,1,0,1,0.0,100.0,Male
Ryerson,2016,3,0,3,0.0,100.0,Male
Vivan,2016,3,0,3,0.0,100.0,Male
Kayden,2016,1080,97,983,8.981481481481483,91.01851851851852,Male
Nyjah,2016,2,0,2,0.0,100.0,Male
Beckam,2016,1,0,1,0.0,100.0,Male
Rhythm,2016,23,10,13,43.47826086956522,56.52173913043478,Unisex
Rowan,2016,1033,400,633,38.72216844143272,61.27783155856727,Unisex
Anmol,2016,89,48,41,53.93258426966292,46.06741573033708,Unisex
Bellamy,2016,21,10,11,47.61904761904761,52.38095238095239,Unisex
Holland,2016,33,28,5,84.84848484848484,15.151515151515152,Unisex
Mackenzie,2016,3387,2605,782,76.91172128727487,23.088278712725124,Unisex
Leighton,2016,246,103,143,41.86991869918699,58.13008130081301,Unisex
Remington,2016,125,20,105,16.0,84.0,Unisex
Finley,2016,517,229,288,44.294003868471954,55.705996131528046,Unisex
Mikah,2016,27,16,11,59.25925925925925,40.74074074074074,Unisex
Sutton,2016,70,39,31,55.71428571428572,44.285714285714285,Unisex
Ihsan,2016,14,4,10,28.57142857142857,71.42857142857143,Unisex
Micah,2016,751,121,630,16.11185086551265,83.88814913448735,Unisex
Avi,2016,52,18,34,34.61538461538461,65.38461538461539,Unisex
Morgan,2016,3134,2222,912,70.89980855137205,29.10019144862795,Unisex
Alek,2016,36,11,25,30.55555555555556,69.44444444444444,Unisex
Elisha,2016,299,241,58,80.60200668896321,19.39799331103679,Unisex
Casey,2016,1020,397,623,38.92156862745098,61.07843137254903,Unisex
Quinn,2016,1791,973,818,54.32719151312117,45.67280848687884,Unisex
Afnan,2016,32,25,7,78.125,21.875,Unisex
Hayden,2016,2132,398,1734,18.66791744840525,81.33208255159474,Unisex
Kessler,2016,36,6,30,16.666666666666664,83.33333333333334,Unisex
Reagan,2016,248,186,62,75.0,25.0,Unisex
Emrys,2016,23,9,14,39.130434782608695,60.86956521739131,Unisex
Daryn,2016,50,14,36,28.000000000000004,72.0,Unisex
Stirling,2016,36,9,27,25.0,75.0,Unisex
Raine,2016,151,86,65,56.95364238410596,43.04635761589404,Unisex
Nikita,2016,326,273,53,83.74233128834356,16.257668711656443,Unisex
Aikam,2016,64,32,32,50.0,50.0,Unisex
Prabhjot,2016,64,32,32,50.0,50.0,Unisex
Bentlee,2016,27,16,11,59.25925925925925,40.74074074074074,Unisex
Wynn,2016,58,27,31,46.55172413793103,53.44827586206896,Unisex
Clarke,2016,91,17,74,18.68131868131868,81.31868131868131,Unisex
Ocean,2016,183,149,34,81.4207650273224,18.5792349726776,Unisex
Kendal,2016,158,125,33,79.11392405063292,20.88607594936709,Unisex
Brier,2016,26,15,11,57.692307692307686,42.30769230769231,Unisex
Salem,2016,62,22,40,35.483870967741936,64.51612903225806,Unisex
Indiana,2016,54,31,23,57.407407407407405,42.5925925925926,Unisex
Kelly,2016,2170,1538,632,70.87557603686636,29.12442396313364,Unisex
Kasey,2016,198,130,68,65.65656565656566,34.34343434343434,Unisex
Jadiel,2016,5,1,4,20.0,80.0,Unisex
Memphis,2016,166,37,129,22.289156626506024,77.71084337349397,Unisex
Quincy,2016,118,40,78,33.89830508474576,66.10169491525424,Unisex
Laine,2016,173,72,101,41.61849710982659,58.38150289017341,Unisex
Brighton,2016,58,12,46,20.6896551724138,79.3103448275862,Unisex
Adan,2016,43,11,32,25.58139534883721,74.4186046511628,Unisex
Gurkirat,2016,26,9,17,34.61538461538461,65.38461538461539,Unisex
Nael,2016,15,5,10,33.33333333333333,66.66666666666666,Unisex
Remy,2016,141,33,108,23.404255319148938,76.59574468085107,Unisex
Israel,2016,80,12,68,15.0,85.0,Unisex
Justice,2016,426,159,267,37.32394366197183,62.676056338028175,Unisex
Wacey,2016,73,11,62,15.068493150684931,84.93150684931507,Unisex
Munachimso,2016,5,2,3,40.0,60.0,Unisex
Jessie,2016,1214,784,430,64.57990115321252,35.42009884678748,Unisex
Rayne,2016,195,159,36,81.53846153846153,18.461538461538463,Unisex
Artemis,2016,22,17,5,77.27272727272727,22.727272727272727,Unisex
Rayan,2016,271,79,192,29.15129151291513,70.84870848708486,Unisex
Shae,2016,252,178,74,70.63492063492063,29.365079365079367,Unisex
Ryley,2016,757,144,613,19.0224570673712,80.9775429326288,Unisex
Gurman,2016,83,19,64,22.89156626506024,77.10843373493977,Unisex
Arian,2016,47,11,36,23.404255319148938,76.59574468085107,Unisex
Juno,2016,40,33,7,82.5,17.5,Unisex
Rome,2016,50,8,42,16.0,84.0,Unisex
Robin,2016,1019,608,411,59.66633954857704,40.333660451422965,Unisex
Anhad,2016,28,10,18,35.714285714285715,64.28571428571429,Unisex
Shiloh,2016,179,145,34,81.00558659217877,18.994413407821227,Unisex
Mckinley,2016,178,150,28,84.26966292134831,15.730337078651685,Unisex
Kalin,2016,52,10,42,19.23076923076924,80.76923076923077,Unisex
Henley,2016,73,50,23,68.4931506849315,31.506849315068493,Unisex
Sidak,2016,28,10,18,35.714285714285715,64.28571428571429,Unisex
Jaskirat,2016,42,17,25,40.47619047619048,59.523809523809526,Unisex
Sidney,2016,359,203,156,56.54596100278552,43.45403899721448,Unisex
Saihaj,2016,18,7,11,38.88888888888889,61.11111111111112,Unisex
Lou,2016,27,16,11,59.25925925925925,40.74074074074074,Unisex
Bristol,2016,26,22,4,84.61538461538461,15.384615384615383,Unisex
Phoenix,2016,600,248,352,41.333333333333336,58.66666666666666,Unisex
Joud,2016,29,5,24,17.24137931034483,82.75862068965517,Unisex
Murphy,2016,45,20,25,44.44444444444444,55.55555555555556,Unisex
Brook,2016,144,101,43,70.13888888888889,29.86111111111111,Unisex
Reegan,2016,110,70,40,63.63636363636363,36.36363636363637,Unisex
Rian,2016,74,40,34,54.054054054054056,45.94594594594595,Unisex
August,2016,166,42,124,25.301204819277107,74.69879518072288,Unisex
Elliott,2016,511,88,423,17.22113502935421,82.7788649706458,Unisex
Emmerson,2016,65,51,14,78.46153846153847,21.53846153846154,Unisex
Jood,2016,14,9,5,64.28571428571429,35.714285714285715,Unisex
Ekam,2016,56,19,37,33.92857142857143,66.07142857142857,Unisex
Sky,2016,135,86,49,63.70370370370371,36.2962962962963,Unisex
Avery,2016,2875,2124,751,73.87826086956521,26.121739130434783,Unisex
Zephaniah,2016,21,4,17,19.047619047619047,80.95238095238095,Unisex
Jordan,2016,8033,1400,6633,17.428109050168057,82.57189094983194,Unisex
Sanjam,2016,9,7,2,77.77777777777779,22.22222222222222,Unisex
Indy,2016,28,14,14,50.0,50.0,Unisex
Amen,2016,84,37,47,44.04761904761904,55.95238095238096,Unisex
Reece,2016,482,85,397,17.634854771784234,82.36514522821577,Unisex
Teagan,2016,759,612,147,80.63241106719367,19.367588932806324,Unisex
Ridley,2016,40,18,22,45.0,55.00000000000001,Unisex
Kona,2016,14,7,7,50.0,50.0,Unisex
Eliyah,2016,12,10,2,83.33333333333334,16.666666666666664,Unisex
Meyer,2016,17,4,13,23.52941176470588,76.47058823529412,Unisex
Kingsley,2016,155,40,115,25.806451612903224,74.19354838709677,Unisex
Charlie,2016,1163,511,652,43.93809114359416,56.06190885640585,Unisex
Dakota,2016,1265,546,719,43.16205533596838,56.837944664031625,Unisex
Rayyan,2016,137,21,116,15.328467153284672,84.67153284671532,Unisex
Rio,2016,94,36,58,38.297872340425535,61.70212765957447,Unisex
Raven,2016,316,261,55,82.59493670886076,17.405063291139243,Unisex
Regan,2016,317,184,133,58.0441640378549,41.95583596214511,Unisex
Remi,2016,152,84,68,55.26315789473685,44.73684210526316,Unisex
Emerson,2016,735,303,432,41.224489795918366,58.77551020408164,Unisex
Riyaan,2016,10,3,7,30.0,70.0,Unisex
Reilly,2016,138,48,90,34.78260869565217,65.21739130434783,Unisex
Reign,2016,43,17,26,39.53488372093023,60.46511627906976,Unisex
Ifeoluwa,2016,15,8,7,53.333333333333336,46.66666666666666,Unisex
Sloan,2016,221,153,68,69.23076923076923,30.76923076923077,Unisex
Koda,2016,75,13,62,17.333333333333336,82.66666666666667,Unisex
Shay,2016,181,89,92,49.17127071823205,50.82872928176796,Unisex
Sage,2016,529,366,163,69.18714555765595,30.812854442344044,Unisex
Elim,2016,21,14,7,66.66666666666666,33.33333333333333,Unisex
Jovi,2016,35,24,11,68.57142857142857,31.428571428571427,Unisex
Jireh,2016,13,5,8,38.46153846153847,61.53846153846154,Unisex
Korbyn,2016,52,8,44,15.384615384615383,84.61538461538461,Unisex
Alexi,2016,92,62,30,67.3913043478261,32.608695652173914,Unisex
Arin,2016,38,17,21,44.73684210526316,55.26315789473685,Unisex
Sunny,2016,105,47,58,44.761904761904766,55.23809523809524,Unisex
Kiran,2016,123,64,59,52.03252032520326,47.96747967479675,Unisex
Briar,2016,178,148,30,83.14606741573034,16.853932584269664,Unisex
Cairo,2016,38,9,29,23.684210526315788,76.31578947368422,Unisex
Taylor,2016,6000,3926,2074,65.43333333333334,34.56666666666667,Unisex
Toryn,2016,43,13,30,30.23255813953488,69.76744186046511,Unisex
Bailey,2016,1550,1259,291,81.2258064516129,18.774193548387096,Unisex
Beaux,2016,7,3,4,42.85714285714285,57.14285714285714,Unisex
Mesgana,2016,6,3,3,50.0,50.0,Unisex
Dominique,2016,412,332,80,80.58252427184466,19.41747572815534,Unisex
Eastyn,2016,37,17,20,45.94594594594595,54.054054054054056,Unisex
Ezrah,2016,22,11,11,50.0,50.0,Unisex
Dakoda,2016,71,33,38,46.478873239436616,53.52112676056338,Unisex
Gurnoor,2016,123,76,47,61.78861788617886,38.21138211382114,Unisex
Imaan,2016,48,36,12,75.0,25.0,Unisex
Creedence,2016,20,4,16,20.0,80.0,Unisex
Sol,2016,23,10,13,43.47826086956522,56.52173913043478,Unisex
Haven,2016,204,161,43,78.92156862745098,21.07843137254902,Unisex
Kyrie,2016,116,48,68,41.37931034482759,58.620689655172406,Unisex
Austyn,2016,172,79,93,45.93023255813954,54.06976744186046,Unisex
London,2016,325,258,67,79.38461538461539,20.615384615384617,Unisex
Marlow,2016,31,16,15,51.61290322580645,48.38709677419355,Unisex
Adel,2016,33,7,26,21.21212121212121,78.78787878787878,Unisex
Sawyer,2016,1252,349,903,27.875399361022364,72.12460063897763,Unisex
Sehaj,2016,92,49,43,53.2608695652174,46.73913043478261,Unisex
Ellis,2016,263,54,209,20.53231939163498,79.46768060836501,Unisex
Milan,2016,155,38,117,24.516129032258064,75.48387096774194,Unisex
Gray,2016,58,11,47,18.96551724137931,81.03448275862068,Unisex
Ren,2016,26,5,21,19.23076923076924,80.76923076923077,Unisex
Noa,2016,67,49,18,73.13432835820896,26.86567164179105,Unisex
Mika,2016,148,120,28,81.08108108108108,18.91891891891892,Unisex
Ayan,2016,85,20,65,23.52941176470588,76.47058823529412,Unisex
Rylee,2016,830,698,132,84.09638554216868,15.903614457831324,Unisex
Laken,2016,44,20,24,45.45454545454545,54.54545454545454,Unisex
Frankie,2016,172,121,51,70.34883720930233,29.65116279069768,Unisex
Emery,2016,519,333,186,64.16184971098265,35.83815028901734,Unisex
Dallas,2016,1335,250,1085,18.726591760299627,81.27340823970037,Unisex
Kolby,2016,277,44,233,15.884476534296027,84.11552346570397,Unisex
Wren,2016,145,111,34,76.55172413793103,23.448275862068964,Unisex
Amar,2016,91,22,69,24.17582417582417,75.82417582417582,Unisex
Krisha,2017,1,1,0,100.0,0.0,Female
Kylie,2017,27,27,0,100.0,0.0,Female
Pyper,2017,3,3,0,100.0,0.0,Female
Mave,2017,1,1,0,100.0,0.0,Female
Tali,2017,1,1,0,100.0,0.0,Female
Adalind,2017,2,2,0,100.0,0.0,Female
Adah,2017,1,1,0,100.0,0.0,Female
Amiya,2017,2,2,0,100.0,0.0,Female
Elham,2017,1,1,0,100.0,0.0,Female
Morley,2017,1,1,0,100.0,0.0,Female
Saige,2017,10,10,0,100.0,0.0,Female
Alaiza,2017,1,1,0,100.0,0.0,Female
Aileen,2017,1,1,0,100.0,0.0,Female
Aneet,2017,1,1,0,100.0,0.0,Female
Liara,2017,1,1,0,100.0,0.0,Female
Aniston,2017,4,4,0,100.0,0.0,Female
Lovely,2017,1,1,0,100.0,0.0,Female
Guinevere,2017,2,2,0,100.0,0.0,Female
Myer,2017,1,0,1,0.0,100.0,Male
Beckam,2017,3,0,3,0.0,100.0,Male
Sayed,2017,1,0,1,0.0,100.0,Male
Nicholas,2017,48,0,48,0.0,100.0,Male
Kolten,2017,4,0,4,0.0,100.0,Male
Aram,2017,3,0,3,0.0,100.0,Male
Kolby,2017,2,0,2,0.0,100.0,Male
Red,2017,1,0,1,0.0,100.0,Male
Josh,2017,7,0,7,0.0,100.0,Male
Nyjah,2017,1,0,1,0.0,100.0,Male
Kurt,2017,5,0,5,0.0,100.0,Male
Stephen,2017,12,0,12,0.0,100.0,Male
Hadi,2017,8,0,8,0.0,100.0,Male
Aimal,2017,1,0,1,0.0,100.0,Male
James,2017,7601,7,7594,0.0920931456387317,99.90790685436129,Male
Eddy,2017,3,0,3,0.0,100.0,Male
Areez,2017,1,0,1,0.0,100.0,Male
Lucian,2017,5,0,5,0.0,100.0,Male
Leopoldo,2017,2,0,2,0.0,100.0,Male
Sidak,2017,28,10,18,35.714285714285715,64.28571428571429,Unisex
Oakley,2017,215,71,144,33.02325581395349,66.97674418604652,Unisex
Iliya,2017,7,2,5,28.57142857142857,71.42857142857143,Unisex
Tatum,2017,304,230,74,75.6578947368421,24.34210526315789,Unisex
Royal,2017,29,12,17,41.37931034482759,58.620689655172406,Unisex
Rylee,2017,830,698,132,84.09638554216868,15.903614457831324,Unisex
Ayan,2017,85,20,65,23.52941176470588,76.47058823529412,Unisex
Zuriel,2017,13,7,6,53.84615384615385,46.15384615384615,Unisex
Shiloh,2017,179,145,34,81.00558659217877,18.994413407821227,Unisex
Elliotte,2017,25,21,4,84.0,16.0,Unisex
Braxtyn,2017,26,9,17,34.61538461538461,65.38461538461539,Unisex
Shay,2017,181,89,92,49.17127071823205,50.82872928176796,Unisex
Lael,2017,29,19,10,65.51724137931035,34.48275862068966,Unisex
Harvie,2017,4,2,2,50.0,50.0,Unisex
Laine,2017,173,72,101,41.61849710982659,58.38150289017341,Unisex
Alexi,2017,92,62,30,67.3913043478261,32.608695652173914,Unisex
Kenley,2017,57,46,11,80.7017543859649,19.29824561403509,Unisex
Shia,2017,22,13,9,59.09090909090909,40.909090909090914,Unisex
Agamjot,2017,29,14,15,48.27586206896552,51.72413793103448,Unisex
Cypress,2017,19,9,10,47.368421052631575,52.63157894736842,Unisex
Nakota,2017,15,6,9,40.0,60.0,Unisex
Harnoor,2017,80,61,19,76.25,23.75,Unisex
Rayne,2017,195,159,36,81.53846153846153,18.461538461538463,Unisex
Sina,2017,41,17,24,41.46341463414634,58.53658536585365,Unisex
Milan,2017,155,38,117,24.516129032258064,75.48387096774194,Unisex
Tenzin,2017,92,38,54,41.30434782608695,58.69565217391305,Unisex
Bryer,2017,53,14,39,26.41509433962264,73.58490566037736,Unisex
Maneet,2017,26,14,12,53.84615384615385,46.15384615384615,Unisex
Hayden,2017,2132,398,1734,18.66791744840525,81.33208255159474,Unisex
Arrow,2017,17,3,14,17.647058823529413,82.35294117647058,Unisex
Rey,2017,18,5,13,27.77777777777778,72.22222222222221,Unisex
Ellis,2017,263,54,209,20.53231939163498,79.46768060836501,Unisex
Channing,2017,67,29,38,43.28358208955223,56.71641791044776,Unisex
Toryn,2017,43,13,30,30.23255813953488,69.76744186046511,Unisex
Taylor,2017,6000,3926,2074,65.43333333333334,34.56666666666667,Unisex
Arian,2017,47,11,36,23.404255319148938,76.59574468085107,Unisex
Sloan,2017,221,153,68,69.23076923076923,30.76923076923077,Unisex
Adley,2017,69,58,11,84.05797101449275,15.942028985507244,Unisex
Frankie,2017,172,121,51,70.34883720930233,29.65116279069768,Unisex
Camdyn,2017,32,26,6,81.25,18.75,Unisex
Jamie,2017,2713,1642,1071,60.52340582381128,39.476594176188726,Unisex
Finley,2017,517,229,288,44.294003868471954,55.705996131528046,Unisex
Isa,2017,46,9,37,19.565217391304348,80.43478260869566,Unisex
Sol,2017,23,10,13,43.47826086956522,56.52173913043478,Unisex
Yael,2017,22,18,4,81.81818181818183,18.181818181818183,Unisex
Brighton,2017,58,12,46,20.6896551724138,79.3103448275862,Unisex
Amar,2017,91,22,69,24.17582417582417,75.82417582417582,Unisex
Gurnoor,2017,123,76,47,61.78861788617886,38.21138211382114,Unisex
Ellison,2017,25,14,11,56.00000000000001,44.0,Unisex
Sutton,2017,70,39,31,55.71428571428572,44.285714285714285,Unisex
Murphy,2017,45,20,25,44.44444444444444,55.55555555555556,Unisex
Amari,2017,46,17,29,36.95652173913043,63.04347826086957,Unisex
Indy,2017,28,14,14,50.0,50.0,Unisex
Salem,2017,62,22,40,35.483870967741936,64.51612903225806,Unisex
Aiven,2017,7,2,5,28.57142857142857,71.42857142857143,Unisex
Indigo,2017,30,22,8,73.33333333333333,26.666666666666668,Unisex
Casey,2017,1020,397,623,38.92156862745098,61.07843137254903,Unisex
Layne,2017,414,80,334,19.32367149758454,80.67632850241546,Unisex
Avery,2017,2875,2124,751,73.87826086956521,26.121739130434783,Unisex
Tristyn,2017,113,61,52,53.98230088495575,46.017699115044245,Unisex
Zephaniah,2017,21,4,17,19.047619047619047,80.95238095238095,Unisex
Sage,2017,529,366,163,69.18714555765595,30.812854442344044,Unisex
Kacey,2017,158,131,27,82.91139240506328,17.088607594936708,Unisex
Skyler,2017,616,155,461,25.162337662337663,74.83766233766234,Unisex
Mayar,2017,28,22,6,78.57142857142857,21.428571428571427,Unisex
Kaidyn,2017,54,24,30,44.44444444444444,55.55555555555556,Unisex
Emery,2017,519,333,186,64.16184971098265,35.83815028901734,Unisex
Lenyx,2017,10,8,2,80.0,20.0,Unisex
Harley,2017,524,171,353,32.63358778625955,67.36641221374046,Unisex
Lake,2017,26,7,19,26.923076923076923,73.07692307692307,Unisex
Bentlee,2017,27,16,11,59.25925925925925,40.74074074074074,Unisex
Arden,2017,165,101,64,61.2121212121212,38.78787878787879,Unisex
Ruari,2017,11,4,7,36.36363636363637,63.63636363636363,Unisex
Ezrah,2017,22,11,11,50.0,50.0,Unisex
Wren,2017,145,111,34,76.55172413793103,23.448275862068964,Unisex
Lyric,2017,159,99,60,62.264150943396224,37.735849056603776,Unisex
Dominique,2017,412,332,80,80.58252427184466,19.41747572815534,Unisex
Raine,2017,151,86,65,56.95364238410596,43.04635761589404,Unisex
Dallas,2017,1335,250,1085,18.726591760299627,81.27340823970037,Unisex
Quinn,2017,1791,973,818,54.32719151312117,45.67280848687884,Unisex
Yohanan,2017,6,4,2,66.66666666666666,33.33333333333333,Unisex
Renly,2017,7,3,4,42.85714285714285,57.14285714285714,Unisex
Bellamy,2017,21,10,11,47.61904761904761,52.38095238095239,Unisex
Clarke,2017,91,17,74,18.68131868131868,81.31868131868131,Unisex
Rian,2017,74,40,34,54.054054054054056,45.94594594594595,Unisex
Shea,2017,362,139,223,38.39779005524862,61.60220994475139,Unisex
Sawyer,2017,1252,349,903,27.875399361022364,72.12460063897763,Unisex
Raven,2017,316,261,55,82.59493670886076,17.405063291139243,Unisex
Phoenix,2017,600,248,352,41.333333333333336,58.66666666666666,Unisex
Shae,2017,252,178,74,70.63492063492063,29.365079365079367,Unisex
Ashtyn,2017,117,88,29,75.21367521367522,24.786324786324787,Unisex
August,2017,166,42,124,25.301204819277107,74.69879518072288,Unisex
Sidney,2017,359,203,156,56.54596100278552,43.45403899721448,Unisex
Hamdi,2017,28,12,16,42.85714285714285,57.14285714285714,Unisex
Jaskirat,2017,42,17,25,40.47619047619048,59.523809523809526,Unisex
Rio,2017,94,36,58,38.297872340425535,61.70212765957447,Unisex
Jaden,2017,1158,209,949,18.04835924006908,81.95164075993091,Unisex
Morgan,2017,3134,2222,912,70.89980855137205,29.10019144862795,Unisex
Emerson,2017,735,303,432,41.224489795918366,58.77551020408164,Unisex
Rowan,2017,1033,400,633,38.72216844143272,61.27783155856727,Unisex
Peyton,2017,1282,1021,261,79.6411856474259,20.358814352574104,Unisex
Juno,2017,40,33,7,82.5,17.5,Unisex
Anhad,2017,28,10,18,35.714285714285715,64.28571428571429,Unisex
Jessie,2017,1214,784,430,64.57990115321252,35.42009884678748,Unisex
Ryley,2017,757,144,613,19.0224570673712,80.9775429326288,Unisex
Amrit,2017,107,54,53,50.467289719626166,49.53271028037384,Unisex
Oluwademilade,2017,9,6,3,66.66666666666666,33.33333333333333,Unisex
Wynn,2017,58,27,31,46.55172413793103,53.44827586206896,Unisex
Adriel,2017,93,14,79,15.053763440860216,84.94623655913979,Unisex
Robin,2017,1019,608,411,59.66633954857704,40.333660451422965,Unisex
Skylar,2017,786,501,285,63.74045801526718,36.25954198473282,Unisex
London,2017,325,258,67,79.38461538461539,20.615384615384617,Unisex
Lennon,2017,247,131,116,53.036437246963565,46.96356275303644,Unisex
Dakota,2017,1265,546,719,43.16205533596838,56.837944664031625,Unisex
Gurkirat,2017,26,9,17,34.61538461538461,65.38461538461539,Unisex
Mehar,2017,79,61,18,77.21518987341773,22.78481012658228,Unisex
Remington,2017,125,20,105,16.0,84.0,Unisex
Ekam,2017,56,19,37,33.92857142857143,66.07142857142857,Unisex
Leyton,2017,33,5,28,15.151515151515152,84.84848484848484,Unisex
Lochlyn,2017,32,21,11,65.625,34.375,Unisex
Micah,2017,751,121,630,16.11185086551265,83.88814913448735,Unisex
Sehaj,2017,92,49,43,53.2608695652174,46.73913043478261,Unisex
Sky,2017,135,86,49,63.70370370370371,36.2962962962963,Unisex
Reign,2017,43,17,26,39.53488372093023,60.46511627906976,Unisex
Riyan,2017,20,9,11,45.0,55.00000000000001,Unisex
Jordan,2017,8033,1400,6633,17.428109050168057,82.57189094983194,Unisex
Breton,2017,57,11,46,19.29824561403509,80.7017543859649,Unisex
Jireh,2017,13,5,8,38.46153846153847,61.53846153846154,Unisex
Wacey,2017,73,11,62,15.068493150684931,84.93150684931507,Unisex
Lennox,2017,182,35,147,19.23076923076924,80.76923076923077,Unisex
Laken,2017,44,20,24,45.45454545454545,54.54545454545454,Unisex
Haven,2017,204,161,43,78.92156862745098,21.07843137254902,Unisex
Azaria,2017,36,30,6,83.33333333333334,16.666666666666664,Unisex
Henley,2017,73,50,23,68.4931506849315,31.506849315068493,Unisex
Reagan,2017,248,186,62,75.0,25.0,Unisex
Anant,2017,21,5,16,23.809523809523807,76.19047619047619,Unisex
Jovi,2017,35,24,11,68.57142857142857,31.428571428571427,Unisex
Leighton,2017,246,103,143,41.86991869918699,58.13008130081301,Unisex
Jules,2017,97,41,56,42.2680412371134,57.73195876288659,Unisex
Rayan,2017,271,79,192,29.15129151291513,70.84870848708486,Unisex
Samar,2017,78,39,39,50.0,50.0,Unisex
Ira,2017,121,43,78,35.53719008264463,64.46280991735537,Unisex
Hollis,2017,30,12,18,40.0,60.0,Unisex
Finnley,2017,136,46,90,33.82352941176471,66.17647058823529,Unisex
Kalin,2017,52,10,42,19.23076923076924,80.76923076923077,Unisex
Blair,2017,747,149,598,19.94645247657296,80.05354752342704,Unisex
Reece,2017,482,85,397,17.634854771784234,82.36514522821577,Unisex
Blessing,2017,31,24,7,77.41935483870968,22.58064516129032,Unisex
An,2017,44,29,15,65.9090909090909,34.090909090909086,Unisex
Hanley,2017,9,6,3,66.66666666666666,33.33333333333333,Unisex
Lemmy,2017,10,3,7,30.0,70.0,Unisex
Teegan,2017,125,56,69,44.8,55.2,Unisex
Gursehaj,2017,14,6,8,42.85714285714285,57.14285714285714,Unisex
Loxley,2017,11,6,5,54.54545454545454,45.45454545454545,Unisex
Emrys,2017,23,9,14,39.130434782608695,60.86956521739131,Unisex
Kit,2017,33,15,18,45.45454545454545,54.54545454545454,Unisex
Ripley,2017,32,25,7,78.125,21.875,Unisex
Hartley,2017,37,18,19,48.64864864864865,51.35135135135135,Unisex
Jaskirat,2018,1,1,0,100.0,0.0,Female
Malin,2018,1,1,0,100.0,0.0,Female
Kylie,2018,36,36,0,100.0,0.0,Female
Laken,2018,2,2,0,100.0,0.0,Female
Aaria,2018,2,2,0,100.0,0.0,Female
Lennix,2018,1,1,0,100.0,0.0,Female
Iliana,2018,3,3,0,100.0,0.0,Female
Karolyn,2018,1,1,0,100.0,0.0,Female
Lana,2018,8,8,0,100.0,0.0,Female
Japleen,2018,2,2,0,100.0,0.0,Female
Lilyana,2018,4,4,0,100.0,0.0,Female
Hudsyn,2018,2,2,0,100.0,0.0,Female
Rania,2018,3,3,0,100.0,0.0,Female
Tali,2018,1,1,0,100.0,0.0,Female
Kacey,2018,2,2,0,100.0,0.0,Female
Georgina,2018,4,4,0,100.0,0.0,Female
Liara,2018,1,1,0,100.0,0.0,Female
Dominique,2018,3,3,0,100.0,0.0,Female
Riya,2018,2,2,0,100.0,0.0,Female
Adelyn,2018,21,21,0,100.0,0.0,Female
Hanley,2018,1,0,1,0.0,100.0,Male
Keyton,2018,1,0,1,0.0,100.0,Male
Kayden,2018,1080,97,983,8.981481481481483,91.01851851851852,Male
Nathaniel,2018,49,0,49,0.0,100.0,Male
Kaysen,2018,9,0,9,0.0,100.0,Male
Tristen,2018,5,0,5,0.0,100.0,Male
Hadi,2018,4,0,4,0.0,100.0,Male
Warren,2018,5,0,5,0.0,100.0,Male
Nicholas,2018,50,0,50,0.0,100.0,Male
Riel,2018,1,0,1,0.0,100.0,Male
Josh,2018,3,0,3,0.0,100.0,Male
Arshia,2018,1,0,1,0.0,100.0,Male
Suber,2018,1,0,1,0.0,100.0,Male
Stryker,2018,1,0,1,0.0,100.0,Male
Eddy,2018,1,0,1,0.0,100.0,Male
Jaeden,2018,2,0,2,0.0,100.0,Male
Ryerson,2018,5,0,5,0.0,100.0,Male
Suhail,2018,2,0,2,0.0,100.0,Male
Cedar,2018,67,37,30,55.223880597014926,44.776119402985074,Unisex
Taylor,2018,6000,3926,2074,65.43333333333334,34.56666666666667,Unisex
Peyton,2018,1282,1021,261,79.6411856474259,20.358814352574104,Unisex
Remy,2018,141,33,108,23.404255319148938,76.59574468085107,Unisex
Dakoda,2018,71,33,38,46.478873239436616,53.52112676056338,Unisex
Drew,2018,880,147,733,16.704545454545457,83.29545454545455,Unisex
Phoenix,2018,600,248,352,41.333333333333336,58.66666666666666,Unisex
Nael,2018,15,5,10,33.33333333333333,66.66666666666666,Unisex
Shalom,2018,47,35,12,74.46808510638297,25.53191489361702,Unisex
Nana,2018,34,19,15,55.88235294117647,44.11764705882353,Unisex
Aven,2018,95,58,37,61.05263157894737,38.94736842105263,Unisex
Lochlyn,2018,32,21,11,65.625,34.375,Unisex
Jean,2018,226,84,142,37.16814159292036,62.83185840707964,Unisex
Toryn,2018,43,13,30,30.23255813953488,69.76744186046511,Unisex
Munachimso,2018,5,2,3,40.0,60.0,Unisex
Arden,2018,165,101,64,61.2121212121212,38.78787878787879,Unisex
Lexington,2018,24,15,9,62.5,37.5,Unisex
Amen,2018,84,37,47,44.04761904761904,55.95238095238096,Unisex
Jessie,2018,1214,784,430,64.57990115321252,35.42009884678748,Unisex
Brook,2018,144,101,43,70.13888888888889,29.86111111111111,Unisex
Elham,2018,20,12,8,60.0,40.0,Unisex
Marlow,2018,31,16,15,51.61290322580645,48.38709677419355,Unisex
Justice,2018,426,159,267,37.32394366197183,62.676056338028175,Unisex
Arian,2018,47,11,36,23.404255319148938,76.59574468085107,Unisex
Murphy,2018,45,20,25,44.44444444444444,55.55555555555556,Unisex
Miracle,2018,48,39,9,81.25,18.75,Unisex
Ellison,2018,25,14,11,56.00000000000001,44.0,Unisex
Renly,2018,7,3,4,42.85714285714285,57.14285714285714,Unisex
Karsyn,2018,62,41,21,66.12903225806451,33.87096774193548,Unisex
Nikita,2018,326,273,53,83.74233128834356,16.257668711656443,Unisex
Koda,2018,75,13,62,17.333333333333336,82.66666666666667,Unisex
Ridley,2018,40,18,22,45.0,55.00000000000001,Unisex
Rowan,2018,1033,400,633,38.72216844143272,61.27783155856727,Unisex
Mayar,2018,28,22,6,78.57142857142857,21.428571428571427,Unisex
Collins,2018,38,29,9,76.31578947368422,23.684210526315788,Unisex
Oakley,2018,215,71,144,33.02325581395349,66.97674418604652,Unisex
Kona,2018,14,7,7,50.0,50.0,Unisex
Finnley,2018,136,46,90,33.82352941176471,66.17647058823529,Unisex
Azariah,2018,48,24,24,50.0,50.0,Unisex
Ira,2018,121,43,78,35.53719008264463,64.46280991735537,Unisex
Dakota,2018,1265,546,719,43.16205533596838,56.837944664031625,Unisex
Rio,2018,94,36,58,38.297872340425535,61.70212765957447,Unisex
Britton,2018,43,16,27,37.2093023255814,62.7906976744186,Unisex
Mackenzie,2018,3387,2605,782,76.91172128727487,23.088278712725124,Unisex
Bailey,2018,1550,1259,291,81.2258064516129,18.774193548387096,Unisex
Rome,2018,50,8,42,16.0,84.0,Unisex
Bellamy,2018,21,10,11,47.61904761904761,52.38095238095239,Unisex
Cairo,2018,38,9,29,23.684210526315788,76.31578947368422,Unisex
Elim,2018,21,14,7,66.66666666666666,33.33333333333333,Unisex
Kingsley,2018,155,40,115,25.806451612903224,74.19354838709677,Unisex
Mika,2018,148,120,28,81.08108108108108,18.91891891891892,Unisex
Imaan,2018,48,36,12,75.0,25.0,Unisex
Casey,2018,1020,397,623,38.92156862745098,61.07843137254903,Unisex
Clarke,2018,91,17,74,18.68131868131868,81.31868131868131,Unisex
Avery,2018,2875,2124,751,73.87826086956521,26.121739130434783,Unisex
Mikal,2018,24,10,14,41.66666666666667,58.333333333333336,Unisex
Lake,2018,26,7,19,26.923076923076923,73.07692307692307,Unisex
Sidak,2018,28,10,18,35.714285714285715,64.28571428571429,Unisex
Everette,2018,25,4,21,16.0,84.0,Unisex
Riyaan,2018,10,3,7,30.0,70.0,Unisex
Silver,2018,57,44,13,77.19298245614034,22.807017543859647,Unisex
London,2018,325,258,67,79.38461538461539,20.615384615384617,Unisex
Frankie,2018,172,121,51,70.34883720930233,29.65116279069768,Unisex
Shea,2018,362,139,223,38.39779005524862,61.60220994475139,Unisex
Atley,2018,28,14,14,50.0,50.0,Unisex
Dallas,2018,1335,250,1085,18.726591760299627,81.27340823970037,Unisex
Adriel,2018,93,14,79,15.053763440860216,84.94623655913979,Unisex
Scout,2018,40,28,12,70.0,30.0,Unisex
Brier,2018,26,15,11,57.692307692307686,42.30769230769231,Unisex
Briar,2018,178,148,30,83.14606741573034,16.853932584269664,Unisex
Sri,2018,8,3,5,37.5,62.5,Unisex
Hunar,2018,10,7,3,70.0,30.0,Unisex
Haven,2018,204,161,43,78.92156862745098,21.07843137254902,Unisex
Emerson,2018,735,303,432,41.224489795918366,58.77551020408164,Unisex
Lennon,2018,247,131,116,53.036437246963565,46.96356275303644,Unisex
Sutton,2018,70,39,31,55.71428571428572,44.285714285714285,Unisex
August,2018,166,42,124,25.301204819277107,74.69879518072288,Unisex
Milan,2018,155,38,117,24.516129032258064,75.48387096774194,Unisex
Rylie,2018,283,214,69,75.61837455830388,24.38162544169612,Unisex
Arie,2018,69,14,55,20.28985507246377,79.71014492753623,Unisex
Kit,2018,33,15,18,45.45454545454545,54.54545454545454,Unisex
Ellis,2018,263,54,209,20.53231939163498,79.46768060836501,Unisex
Raven,2018,316,261,55,82.59493670886076,17.405063291139243,Unisex
Micah,2018,751,121,630,16.11185086551265,83.88814913448735,Unisex
Reese,2018,812,536,276,66.00985221674877,33.99014778325123,Unisex
Sunny,2018,105,47,58,44.761904761904766,55.23809523809524,Unisex
Riley,2018,3875,772,3103,19.92258064516129,80.07741935483871,Unisex
Wren,2018,145,111,34,76.55172413793103,23.448275862068964,Unisex
Amari,2018,46,17,29,36.95652173913043,63.04347826086957,Unisex
Juno,2018,40,33,7,82.5,17.5,Unisex
Henley,2018,73,50,23,68.4931506849315,31.506849315068493,Unisex
Aikam,2018,64,32,32,50.0,50.0,Unisex
Lyric,2018,159,99,60,62.264150943396224,37.735849056603776,Unisex
Aram,2018,29,5,24,17.24137931034483,82.75862068965517,Unisex
Holland,2018,33,28,5,84.84848484848484,15.151515151515152,Unisex
Reeve,2018,55,11,44,20.0,80.0,Unisex
Rylee,2018,830,698,132,84.09638554216868,15.903614457831324,Unisex
Royal,2018,29,12,17,41.37931034482759,58.620689655172406,Unisex
Hartley,2018,37,18,19,48.64864864864865,51.35135135135135,Unisex
Mckinley,2018,178,150,28,84.26966292134831,15.730337078651685,Unisex
Sage,2018,529,366,163,69.18714555765595,30.812854442344044,Unisex
Sidney,2018,359,203,156,56.54596100278552,43.45403899721448,Unisex
Azaria,2018,36,30,6,83.33333333333334,16.666666666666664,Unisex
Elisha,2018,299,241,58,80.60200668896321,19.39799331103679,Unisex
Sky,2018,135,86,49,63.70370370370371,36.2962962962963,Unisex
Neer,2018,5,2,3,40.0,60.0,Unisex
Darian,2018,433,110,323,25.40415704387991,74.5958429561201,Unisex
Arin,2018,38,17,21,44.73684210526316,55.26315789473685,Unisex
Storm,2018,89,36,53,40.44943820224719,59.55056179775281,Unisex
Lou,2018,27,16,11,59.25925925925925,40.74074074074074,Unisex
Wynn,2018,58,27,31,46.55172413793103,53.44827586206896,Unisex
Reagan,2018,248,186,62,75.0,25.0,Unisex
Skylar,2018,786,501,285,63.74045801526718,36.25954198473282,Unisex
Teegan,2018,125,56,69,44.8,55.2,Unisex
Rian,2018,74,40,34,54.054054054054056,45.94594594594595,Unisex
Riyan,2018,20,9,11,45.0,55.00000000000001,Unisex
Diamond,2018,81,67,14,82.71604938271605,17.28395061728395,Unisex
Ocean,2018,183,149,34,81.4207650273224,18.5792349726776,Unisex
Amar,2018,91,22,69,24.17582417582417,75.82417582417582,Unisex
Leslie,2018,620,425,195,68.54838709677419,31.451612903225808,Unisex
Franky,2018,19,5,14,26.31578947368421,73.68421052631578,Unisex
Bristol,2018,26,22,4,84.61538461538461,15.384615384615383,Unisex
Jamie,2018,2713,1642,1071,60.52340582381128,39.476594176188726,Unisex
Rayyan,2018,137,21,116,15.328467153284672,84.67153284671532,Unisex
Ezrah,2018,22,11,11,50.0,50.0,Unisex
Hayden,2018,2132,398,1734,18.66791744840525,81.33208255159474,Unisex
Rory,2018,743,150,593,20.18842530282637,79.81157469717361,Unisex
Regan,2018,317,184,133,58.0441640378549,41.95583596214511,Unisex
Devyn,2018,243,176,67,72.42798353909465,27.57201646090536,Unisex
Mylo,2018,40,7,33,17.5,82.5,Unisex
Anhad,2018,28,10,18,35.714285714285715,64.28571428571429,Unisex
Ayan,2018,85,20,65,23.52941176470588,76.47058823529412,Unisex
Brighton,2018,58,12,46,20.6896551724138,79.3103448275862,Unisex
Jood,2018,14,9,5,64.28571428571429,35.714285714285715,Unisex
Kendall,2018,490,374,116,76.32653061224491,23.6734693877551,Unisex
Payton,2018,1128,936,192,82.97872340425532,17.02127659574468,Unisex
Remington,2018,125,20,105,16.0,84.0,Unisex
Rey,2018,18,5,13,27.77777777777778,72.22222222222221,Unisex
Jensen,2018,177,47,130,26.55367231638418,73.44632768361582,Unisex
Noa,2018,67,49,18,73.13432835820896,26.86567164179105,Unisex
Loxley,2018,11,6,5,54.54545454545454,45.45454545454545,Unisex
Morgan,2018,3134,2222,912,70.89980855137205,29.10019144862795,Unisex
Misha,2018,81,58,23,71.60493827160494,28.39506172839506,Unisex
Rayne,2018,195,159,36,81.53846153846153,18.461538461538463,Unisex
Bentlee,2018,27,16,11,59.25925925925925,40.74074074074074,Unisex
Indy,2018,28,14,14,50.0,50.0,Unisex
Sehaj,2018,92,49,43,53.2608695652174,46.73913043478261,Unisex
Myer,2018,21,6,15,28.57142857142857,71.42857142857143,Unisex
Ryley,2018,757,144,613,19.0224570673712,80.9775429326288,Unisex
Kolby,2018,277,44,233,15.884476534296027,84.11552346570397,Unisex
Skyler,2018,616,155,461,25.162337662337663,74.83766233766234,Unisex
Finley,2018,517,229,288,44.294003868471954,55.705996131528046,Unisex
Lake ,2019,1,1,0,100.0,0.0,Female
Saraya,2019,2,2,0,100.0,0.0,Female
Karolyn,2019,2,2,0,100.0,0.0,Female
Amiya,2019,1,1,0,100.0,0.0,Female
Japleen,2019,2,2,0,100.0,0.0,Female
Tyrone,2019,2,0,2,0.0,100.0,Male
Emory ,2019,2,0,2,0.0,100.0,Male
Xi,2019,1,0,1,0.0,100.0,Male
Petar,2019,1,0,1,0.0,100.0,Male
Ricky,2019,7,0,7,0.0,100.0,Male
Areez,2019,1,0,1,0.0,100.0,Male
Hamdi,2019,1,0,1,0.0,100.0,Male
Ihsan,2019,1,0,1,0.0,100.0,Male
Anhad ,2019,20,4,16,20.0,80.0,Unisex
Ramsey ,2019,4,2,2,50.0,50.0,Unisex
Davi ,2019,4,3,1,75.0,25.0,Unisex
Arrow ,2019,5,3,2,60.0,40.0,Unisex
Saige ,2019,16,13,3,81.25,18.75,Unisex
Memphis ,2019,28,6,22,21.428571428571427,78.57142857142857,Unisex
Shelby ,2019,13,11,2,84.61538461538461,15.384615384615383,Unisex
Renn ,2019,8,6,2,75.0,25.0,Unisex
Remy ,2019,49,12,37,24.489795918367346,75.51020408163265,Unisex
Haven ,2019,24,20,4,83.33333333333334,16.666666666666664,Unisex
Blake ,2019,198,101,97,51.010101010101,48.98989898989899,Unisex
Lux ,2019,12,8,4,66.66666666666666,33.33333333333333,Unisex
Gian ,2019,9,2,7,22.22222222222222,77.77777777777779,Unisex
Zariah ,2019,7,5,2,71.42857142857143,28.57142857142857,Unisex
Aries ,2019,10,2,8,20.0,80.0,Unisex
Shalom,2019,47,35,12,74.46808510638297,25.53191489361702,Unisex
Sutton ,2019,23,18,5,78.26086956521739,21.73913043478261,Unisex
Rian ,2019,6,2,4,33.33333333333333,66.66666666666666,Unisex
Nikita,2019,326,273,53,83.74233128834356,16.257668711656443,Unisex
Finlay ,2019,7,2,5,28.57142857142857,71.42857142857143,Unisex
Bryn ,2019,12,9,3,75.0,25.0,Unisex
Bow ,2019,5,1,4,20.0,80.0,Unisex
Robin ,2019,21,7,14,33.33333333333333,66.66666666666666,Unisex
Ryden ,2019,6,2,4,33.33333333333333,66.66666666666666,Unisex
Avery ,2019,266,201,65,75.56390977443608,24.43609022556391,Unisex
Grey ,2019,17,4,13,23.52941176470588,76.47058823529412,Unisex
Nadar ,2019,9,5,4,55.55555555555556,44.44444444444444,Unisex
Madden ,2019,16,3,13,18.75,81.25,Unisex
Ekam ,2019,19,3,16,15.789473684210526,84.21052631578947,Unisex
Arie ,2019,11,4,7,36.36363636363637,63.63636363636363,Unisex
Jaxyn ,2019,7,2,5,28.57142857142857,71.42857142857143,Unisex
Eliyah ,2019,6,4,2,66.66666666666666,33.33333333333333,Unisex
Sawyer ,2019,171,68,103,39.76608187134503,60.23391812865497,Unisex
Skyler ,2019,39,11,28,28.205128205128204,71.7948717948718,Unisex
Elliott ,2019,92,20,72,21.73913043478261,78.26086956521739,Unisex
Taylor ,2019,64,50,14,78.125,21.875,Unisex
Brett ,2019,9,3,6,33.33333333333333,66.66666666666666,Unisex
Reese ,2019,68,56,12,82.35294117647058,17.647058823529413,Unisex
Rudi ,2019,3,2,1,66.66666666666666,33.33333333333333,Unisex
Callahan ,2019,13,6,7,46.15384615384615,53.84615384615385,Unisex
Tatum ,2019,20,10,10,50.0,50.0,Unisex
Parker ,2019,217,71,146,32.71889400921659,67.2811059907834,Unisex
Indiana ,2019,9,6,3,66.66666666666666,33.33333333333333,Unisex
Sina,2019,41,17,24,41.46341463414634,58.53658536585365,Unisex
Amari ,2019,29,20,9,68.96551724137932,31.03448275862069,Unisex
Shay ,2019,15,10,5,66.66666666666666,33.33333333333333,Unisex
Joey ,2019,14,9,5,64.28571428571429,35.714285714285715,Unisex
Kyrie ,2019,38,7,31,18.421052631578945,81.57894736842105,Unisex
Cypress ,2019,9,4,5,44.44444444444444,55.55555555555556,Unisex
Harjas,2019,37,13,24,35.13513513513514,64.86486486486487,Unisex
Bobby ,2019,6,2,4,33.33333333333333,66.66666666666666,Unisex
Cedar ,2019,7,2,5,28.57142857142857,71.42857142857143,Unisex
Azariah ,2019,16,5,11,31.25,68.75,Unisex
Drew ,2019,38,16,22,42.10526315789473,57.89473684210527,Unisex
Kingsley ,2019,34,12,22,35.294117647058826,64.70588235294117,Unisex
Spencer ,2019,57,15,42,26.31578947368421,73.68421052631578,Unisex
Silver ,2019,7,4,3,57.14285714285714,42.85714285714285,Unisex
Onyx ,2019,14,3,11,21.428571428571427,78.57142857142857,Unisex
Kona ,2019,4,2,2,50.0,50.0,Unisex
Devon ,2019,13,2,11,15.384615384615383,84.61538461538461,Unisex
Hayden ,2019,137,36,101,26.277372262773724,73.72262773722628,Unisex
Berkley ,2019,23,16,7,69.56521739130434,30.434782608695656,Unisex
Huntley ,2019,6,4,2,66.66666666666666,33.33333333333333,Unisex
Austen ,2019,7,4,3,57.14285714285714,42.85714285714285,Unisex
Bryer ,2019,10,3,7,30.0,70.0,Unisex
Leighton ,2019,28,21,7,75.0,25.0,Unisex
Sloan ,2019,41,33,8,80.48780487804879,19.51219512195122,Unisex
Logyn ,2019,4,2,2,50.0,50.0,Unisex
Kasey ,2019,15,10,5,66.66666666666666,33.33333333333333,Unisex
Dallas ,2019,33,6,27,18.181818181818183,81.81818181818183,Unisex
Indy ,2019,8,3,5,37.5,62.5,Unisex
Krisha,2020,2,2,0,100.0,0.0,Female
Joey ,2020,4,4,0,100.0,0.0,Female
Davi ,2020,2,2,0,100.0,0.0,Female
Yuri,2020,1,1,0,100.0,0.0,Female
Rudi ,2020,1,1,0,100.0,0.0,Female
Aneet,2020,2,2,0,100.0,0.0,Female
Gurkirat,2020,2,2,0,100.0,0.0,Female
Alaiza,2020,1,1,0,100.0,0.0,Female
Bow ,2020,1,0,1,0.0,100.0,Male
Aries ,2020,3,0,3,0.0,100.0,Male
Kona ,2020,4,2,2,50.0,50.0,Unisex
Lake ,2020,4,3,1,75.0,25.0,Unisex
Hamdi,2020,28,12,16,42.85714285714285,57.14285714285714,Unisex
Skyler ,2020,39,11,28,28.205128205128204,71.7948717948718,Unisex
Ekam ,2020,19,3,16,15.789473684210526,84.21052631578947,Unisex
Jaxyn ,2020,7,2,5,28.57142857142857,71.42857142857143,Unisex
An,2020,44,29,15,65.9090909090909,34.090909090909086,Unisex
Shelby ,2020,13,11,2,84.61538461538461,15.384615384615383,Unisex
Cedar ,2020,7,2,5,28.57142857142857,71.42857142857143,Unisex
Reese ,2020,68,56,12,82.35294117647058,17.647058823529413,Unisex
Dallas ,2020,33,6,27,18.181818181818183,81.81818181818183,Unisex
Rian ,2020,6,2,4,33.33333333333333,66.66666666666666,Unisex
Nadar ,2020,9,5,4,55.55555555555556,44.44444444444444,Unisex
Gian ,2020,9,2,7,22.22222222222222,77.77777777777779,Unisex
Kyrie ,2020,38,7,31,18.421052631578945,81.57894736842105,Unisex
Spencer ,2020,57,15,42,26.31578947368421,73.68421052631578,Unisex
Onyx ,2020,14,3,11,21.428571428571427,78.57142857142857,Unisex
Sutton ,2020,23,18,5,78.26086956521739,21.73913043478261,Unisex
Azariah ,2020,16,5,11,31.25,68.75,Unisex
Emory ,2020,6,3,3,50.0,50.0,Unisex
Robin ,2020,21,7,14,33.33333333333333,66.66666666666666,Unisex
Drew ,2020,38,16,22,42.10526315789473,57.89473684210527,Unisex
Rayan,2020,271,79,192,29.15129151291513,70.84870848708486,Unisex
Arrow ,2020,5,3,2,60.0,40.0,Unisex
Devon ,2020,13,2,11,15.384615384615383,84.61538461538461,Unisex
Kingsley ,2020,34,12,22,35.294117647058826,64.70588235294117,Unisex
Arie ,2020,11,4,7,36.36363636363637,63.63636363636363,Unisex
Austen ,2020,7,4,3,57.14285714285714,42.85714285714285,Unisex
Cypress ,2020,9,4,5,44.44444444444444,55.55555555555556,Unisex
Avery ,2020,266,201,65,75.56390977443608,24.43609022556391,Unisex
Brett ,2020,9,3,6,33.33333333333333,66.66666666666666,Unisex
Madden ,2020,16,3,13,18.75,81.25,Unisex
Zariah ,2020,7,5,2,71.42857142857143,28.57142857142857,Unisex
Parker ,2020,217,71,146,32.71889400921659,67.2811059907834,Unisex
Rayyan,2020,137,21,116,15.328467153284672,84.67153284671532,Unisex
Krishna,2020,36,7,29,19.444444444444446,80.55555555555556,Unisex
Logyn ,2020,4,2,2,50.0,50.0,Unisex
Hayden ,2020,137,36,101,26.277372262773724,73.72262773722628,Unisex
Blake ,2020,198,101,97,51.010101010101,48.98989898989899,Unisex
Ryden ,2020,6,2,4,33.33333333333333,66.66666666666666,Unisex
Tenzin,2020,92,38,54,41.30434782608695,58.69565217391305,Unisex
Ramsey ,2020,4,2,2,50.0,50.0,Unisex
Elliott ,2020,92,20,72,21.73913043478261,78.26086956521739,Unisex
Afnan,2020,32,25,7,78.125,21.875,Unisex
Haven ,2020,24,20,4,83.33333333333334,16.666666666666664,Unisex
Anhad ,2020,20,4,16,20.0,80.0,Unisex
Leighton ,2020,28,21,7,75.0,25.0,Unisex
Indy ,2020,8,3,5,37.5,62.5,Unisex
Bryn ,2020,12,9,3,75.0,25.0,Unisex
Dominique,2020,412,332,80,80.58252427184466,19.41747572815534,Unisex
Amari ,2020,29,20,9,68.96551724137932,31.03448275862069,Unisex
Tatum ,2020,20,10,10,50.0,50.0,Unisex
Renn ,2020,8,6,2,75.0,25.0,Unisex
Saige ,2020,16,13,3,81.25,18.75,Unisex
Taylor ,2020,64,50,14,78.125,21.875,Unisex
Finlay ,2020,7,2,5,28.57142857142857,71.42857142857143,Unisex
Eliyah ,2020,6,4,2,66.66666666666666,33.33333333333333,Unisex
Sloan ,2020,41,33,8,80.48780487804879,19.51219512195122,Unisex
Remy ,2020,49,12,37,24.489795918367346,75.51020408163265,Unisex
Sawyer ,2020,171,68,103,39.76608187134503,60.23391812865497,Unisex
Callahan ,2020,13,6,7,46.15384615384615,53.84615384615385,Unisex
Memphis ,2020,28,6,22,21.428571428571427,78.57142857142857,Unisex
Lux ,2020,12,8,4,66.66666666666666,33.33333333333333,Unisex
Bobby ,2020,6,2,4,33.33333333333333,66.66666666666666,Unisex
Huntley ,2020,6,4,2,66.66666666666666,33.33333333333333,Unisex
Bryer ,2020,10,3,7,30.0,70.0,Unisex
Shay ,2020,15,10,5,66.66666666666666,33.33333333333333,Unisex
Grey ,2020,17,4,13,23.52941176470588,76.47058823529412,Unisex
Silver ,2020,7,4,3,57.14285714285714,42.85714285714285,Unisex
Kasey ,2020,15,10,5,66.66666666666666,33.33333333333333,Unisex
Indiana ,2020,9,6,3,66.66666666666666,33.33333333333333,Unisex
Berkley ,2020,23,16,7,69.56521739130434,30.434782608695656,Unisex
