Name,Year,Total_sum,Female_count,Male_count,Female_percentage,Male_percentage,Gender
Bobbye,1914,5,5,0,100.0,0.0,Female
Ethelyn,1914,95,95,0,100.0,0.0,Female
Mildred,1914,11686,11649,37,99.68338182440527,0.3166181755947287,Female
Jerlean,1914,5,5,0,100.0,0.0,Female
Clementina,1914,30,30,0,100.0,0.0,Female
Loucinda,1914,5,5,0,100.0,0.0,Female
Corabelle,1914,11,11,0,100.0,0.0,Female
Hassie,1914,41,41,0,100.0,0.0,Female
Lona,1914,139,139,0,100.0,0.0,Female
Rochester,1914,6,0,6,0.0,100.0,Male
Domenick,1914,46,0,46,0.0,100.0,Male
Donovan,1914,35,0,35,0.0,100.0,Male
Salvador,1914,72,0,72,0.0,100.0,Male
Gentry,1914,12,0,12,0.0,100.0,Male
Halbert,1914,21,0,21,0.0,100.0,Male
Romie,1914,31,0,31,0.0,100.0,Male
Ferrell,1914,23,0,23,0.0,100.0,Male
Sheppard,1914,5,0,5,0.0,100.0,Male
Clair,1914,237,33,204,13.924050632911392,86.07594936708861,Male
Marsden,1914,5,0,5,0.0,100.0,Male
Erby,1914,8,0,8,0.0,100.0,Male
Calvin,1914,536,5,531,0.9328358208955224,99.06716417910448,Male
Art,1914,28,0,28,0.0,100.0,Male
Ramiro,1914,10,0,10,0.0,100.0,Male
Saint,1914,14,6,8,42.85714285714285,57.14285714285714,Unisex
Othel,1914,27,10,17,37.03703703703704,62.96296296296296,Unisex
Otha,1914,101,21,80,20.7920792079208,79.20792079207921,Unisex
Odell,1914,302,122,180,40.397350993377486,59.60264900662252,Unisex
Doyne,1914,12,5,7,41.66666666666667,58.333333333333336,Unisex
Connie,1914,356,293,63,82.30337078651685,17.696629213483146,Unisex
Dana,1914,103,39,64,37.86407766990291,62.13592233009708,Unisex
Massie,1914,15,6,9,40.0,60.0,Unisex
Luby,1914,10,5,5,50.0,50.0,Unisex
Artie,1914,167,134,33,80.23952095808383,19.760479041916167,Unisex
Jan,1914,29,8,21,27.58620689655172,72.41379310344827,Unisex
Trinidad,1914,35,23,12,65.71428571428571,34.285714285714285,Unisex
Bobbie,1914,178,148,30,83.14606741573034,16.853932584269664,Unisex
Macy,1914,22,17,5,77.27272727272727,22.727272727272727,Unisex
Jessie,1914,3810,2861,949,75.09186351706036,24.908136482939632,Unisex
Ara,1914,49,40,9,81.63265306122449,18.367346938775512,Unisex
Ozie,1914,34,24,10,70.58823529411765,29.411764705882355,Unisex
Orva,1914,16,9,7,56.25,43.75,Unisex
Carman,1914,18,5,13,27.77777777777778,72.22222222222221,Unisex
Vertis,1914,15,6,9,40.0,60.0,Unisex
Waverly,1914,21,5,16,23.809523809523807,76.19047619047619,Unisex
Beryl,1914,221,180,41,81.44796380090497,18.552036199095024,Unisex
Donnie,1914,102,76,26,74.50980392156863,25.49019607843137,Unisex
Jackie,1914,66,47,19,71.21212121212122,28.78787878787879,Unisex
Hassie,1915,53,53,0,100.0,0.0,Female
Nila,1915,43,43,0,100.0,0.0,Female
Harryette,1915,8,8,0,100.0,0.0,Female
Elda,1915,241,241,0,100.0,0.0,Female
Claudia,1915,395,387,8,97.9746835443038,2.0253164556962027,Female
Marcelino,1915,27,0,27,0.0,100.0,Male
Sol,1915,272,0,272,0.0,100.0,Male
Oval,1915,20,0,20,0.0,100.0,Male
Marshall,1915,715,0,715,0.0,100.0,Male
Burl,1915,130,0,130,0.0,100.0,Male
Darby,1915,5,0,5,0.0,100.0,Male
Rapheal,1915,9,0,9,0.0,100.0,Male
Boyd,1915,335,0,335,0.0,100.0,Male
Gustave,1915,152,0,152,0.0,100.0,Male
Jomes,1915,5,0,5,0.0,100.0,Male
Veryl,1915,26,10,16,38.46153846153847,61.53846153846154,Unisex
Ollie,1915,1143,855,288,74.80314960629921,25.196850393700785,Unisex
Doyne,1915,16,6,10,37.5,62.5,Unisex
Golden,1915,92,47,45,51.08695652173913,48.91304347826087,Unisex
Elba,1915,35,27,8,77.14285714285715,22.857142857142858,Unisex
Caryl,1915,39,33,6,84.61538461538461,15.384615384615383,Unisex
Loye,1915,13,6,7,46.15384615384615,53.84615384615385,Unisex
Unknown,1915,43,19,24,44.18604651162791,55.81395348837209,Unisex
Jonnie,1915,85,50,35,58.82352941176471,41.17647058823529,Unisex
Curlie,1915,12,6,6,50.0,50.0,Unisex
Burdette,1915,49,8,41,16.3265306122449,83.6734693877551,Unisex
Vernell,1915,74,60,14,81.08108108108108,18.91891891891892,Unisex
Carmon,1915,51,16,35,31.37254901960784,68.62745098039215,Unisex
Ivon,1915,15,7,8,46.66666666666666,53.333333333333336,Unisex
Velmer,1915,20,11,9,55.00000000000001,45.0,Unisex
France,1915,21,12,9,57.14285714285714,42.85714285714285,Unisex
Marcell,1915,21,9,12,42.85714285714285,57.14285714285714,Unisex
Lovell,1915,42,13,29,30.95238095238096,69.04761904761905,Unisex
Merril,1915,23,5,18,21.73913043478261,78.26086956521739,Unisex
Dennie,1915,29,6,23,20.6896551724138,79.3103448275862,Unisex
Ronnie,1915,30,20,10,66.66666666666666,33.33333333333333,Unisex
Mannie,1915,32,11,21,34.375,65.625,Unisex
Lavell,1915,18,6,12,33.33333333333333,66.66666666666666,Unisex
Sherrill,1915,16,5,11,31.25,68.75,Unisex
Osa,1915,24,17,7,70.83333333333334,29.166666666666668,Unisex
Lorain,1915,23,13,10,56.52173913043478,43.47826086956522,Unisex
Lanell,1916,14,14,0,100.0,0.0,Female
Juliana,1916,75,75,0,100.0,0.0,Female
Lelah,1916,37,37,0,100.0,0.0,Female
Olympia,1916,39,39,0,100.0,0.0,Female
Shirlee,1916,8,8,0,100.0,0.0,Female
Amie,1916,45,45,0,100.0,0.0,Female
Haru,1916,6,6,0,100.0,0.0,Female
Vada,1916,202,202,0,100.0,0.0,Female
Fenton,1916,26,0,26,0.0,100.0,Male
Steven,1916,367,0,367,0.0,100.0,Male
Clem,1916,92,0,92,0.0,100.0,Male
Birt,1916,13,0,13,0.0,100.0,Male
Ramiro,1916,11,0,11,0.0,100.0,Male
Yvon,1916,6,0,6,0.0,100.0,Male
Ewin,1916,7,0,7,0.0,100.0,Male
Quincey,1916,5,0,5,0.0,100.0,Male
Arden,1916,81,0,81,0.0,100.0,Male
Olavi,1916,7,0,7,0.0,100.0,Male
Bowman,1916,5,0,5,0.0,100.0,Male
Irven,1916,23,0,23,0.0,100.0,Male
Obbie,1916,8,0,8,0.0,100.0,Male
Dell,1916,86,43,43,50.0,50.0,Unisex
Dennie,1916,40,12,28,30.0,70.0,Unisex
Ival,1916,20,8,12,40.0,60.0,Unisex
Veryl,1916,32,14,18,43.75,56.25,Unisex
Meredith,1916,135,66,69,48.888888888888886,51.11111111111111,Unisex
Nealy,1916,14,5,9,35.714285714285715,64.28571428571429,Unisex
Udell,1916,26,11,15,42.30769230769231,57.692307692307686,Unisex
Cleo,1916,1350,1031,319,76.37037037037037,23.62962962962963,Unisex
Elon,1916,23,8,15,34.78260869565217,65.21739130434783,Unisex
Quincy,1916,45,8,37,17.77777777777778,82.22222222222221,Unisex
Nieves,1916,18,10,8,55.55555555555556,44.44444444444444,Unisex
Pilar,1916,29,20,9,68.96551724137932,31.03448275862069,Unisex
Ladell,1916,13,6,7,46.15384615384615,53.84615384615385,Unisex
Garnet,1916,252,209,43,82.93650793650794,17.063492063492063,Unisex
Lorenza,1916,70,39,31,55.71428571428572,44.285714285714285,Unisex
Aris,1916,11,5,6,45.45454545454545,54.54545454545454,Unisex
Hiawatha,1916,18,7,11,38.88888888888889,61.11111111111112,Unisex
Maryland,1916,24,16,8,66.66666666666666,33.33333333333333,Unisex
Verner,1916,61,12,49,19.672131147540984,80.32786885245902,Unisex
Melvina,1917,112,112,0,100.0,0.0,Female
Edythe,1917,561,561,0,100.0,0.0,Female
Lona,1917,165,159,6,96.36363636363636,3.636363636363636,Female
Yvette,1917,117,117,0,100.0,0.0,Female
Christal,1917,6,6,0,100.0,0.0,Female
Maryanne,1917,17,17,0,100.0,0.0,Female
Faris,1917,6,0,6,0.0,100.0,Male
Willey,1917,8,0,8,0.0,100.0,Male
Carle,1917,12,0,12,0.0,100.0,Male
Scott,1917,170,0,170,0.0,100.0,Male
Bueford,1917,10,0,10,0.0,100.0,Male
Ettore,1917,17,0,17,0.0,100.0,Male
Alan,1917,310,0,310,0.0,100.0,Male
Dail,1917,7,0,7,0.0,100.0,Male
Domenick,1917,71,0,71,0.0,100.0,Male
Willmer,1917,14,0,14,0.0,100.0,Male
Carmello,1917,22,0,22,0.0,100.0,Male
Colman,1917,10,0,10,0.0,100.0,Male
Watson,1917,61,0,61,0.0,100.0,Male
Columbus,1917,145,0,145,0.0,100.0,Male
Alex,1917,1088,7,1081,0.6433823529411764,99.35661764705884,Male
Ferris,1917,44,5,39,11.363636363636363,88.63636363636364,Male
Rosendo,1917,15,0,15,0.0,100.0,Male
Dossie,1917,32,19,13,59.375,40.625,Unisex
Gradie,1917,32,10,22,31.25,68.75,Unisex
Valentine,1917,156,52,104,33.33333333333333,66.66666666666666,Unisex
Jule,1917,73,53,20,72.6027397260274,27.3972602739726,Unisex
Ivy,1917,214,154,60,71.96261682242991,28.03738317757009,Unisex
Merle,1917,1061,360,701,33.93025447690858,66.06974552309143,Unisex
Lovell,1917,43,18,25,41.86046511627907,58.13953488372093,Unisex
Rene,1917,170,35,135,20.588235294117645,79.41176470588235,Unisex
Meryl,1917,38,29,9,76.31578947368422,23.684210526315788,Unisex
Neville,1917,23,5,18,21.73913043478261,78.26086956521739,Unisex
Tracy,1917,111,28,83,25.225225225225223,74.77477477477478,Unisex
Cruz,1917,66,28,38,42.42424242424242,57.57575757575758,Unisex
Argie,1917,20,15,5,75.0,25.0,Unisex
Othello,1917,15,7,8,46.66666666666666,53.333333333333336,Unisex
Marvel,1917,152,127,25,83.55263157894737,16.447368421052634,Unisex
Bliss,1917,17,8,9,47.05882352941176,52.94117647058824,Unisex
Burlie,1917,16,7,9,43.75,56.25,Unisex
Elgie,1917,26,12,14,46.15384615384615,53.84615384615385,Unisex
Orie,1917,58,16,42,27.58620689655172,72.41379310344827,Unisex
Wadie,1917,14,7,7,50.0,50.0,Unisex
Cloyce,1917,28,5,23,17.857142857142858,82.14285714285714,Unisex
Fay,1917,832,690,142,82.9326923076923,17.067307692307693,Unisex
Dorsie,1917,24,13,11,54.16666666666666,45.83333333333333,Unisex
Tonie,1917,17,7,10,41.17647058823529,58.82352941176471,Unisex
Alvia,1917,21,9,12,42.85714285714285,57.14285714285714,Unisex
Mella,1918,10,10,0,100.0,0.0,Female
Auda,1918,12,12,0,100.0,0.0,Female
Gracy,1918,11,11,0,100.0,0.0,Female
Clementina,1918,29,29,0,100.0,0.0,Female
Juanita,1918,3272,3260,12,99.63325183374084,0.3667481662591687,Female
Selwyn,1918,20,0,20,0.0,100.0,Male
Saint,1918,16,0,16,0.0,100.0,Male
Conrad,1918,323,0,323,0.0,100.0,Male
Fremont,1918,20,0,20,0.0,100.0,Male
Coye,1918,6,0,6,0.0,100.0,Male
Alvah,1918,48,7,41,14.583333333333334,85.41666666666666,Male
Roosevelt,1918,337,6,331,1.7804154302670625,98.21958456973294,Male
Elroy,1918,145,0,145,0.0,100.0,Male
Birt,1918,11,0,11,0.0,100.0,Male
Wells,1918,17,0,17,0.0,100.0,Male
Artis,1918,72,14,58,19.444444444444446,80.55555555555556,Unisex
Diamond,1918,24,12,12,50.0,50.0,Unisex
Carlee,1918,23,14,9,60.86956521739131,39.130434782608695,Unisex
Donnie,1918,129,96,33,74.4186046511628,25.58139534883721,Unisex
Laverne,1918,1308,965,343,73.77675840978594,26.22324159021407,Unisex
Geo,1918,32,6,26,18.75,81.25,Unisex
Lee,1918,2666,507,2159,19.017254313578395,80.98274568642161,Unisex
Azzie,1918,31,25,6,80.64516129032258,19.35483870967742,Unisex
Scottie,1918,16,9,7,56.25,43.75,Unisex
Clemmie,1918,70,56,14,80.0,20.0,Unisex
Verdell,1918,49,34,15,69.38775510204081,30.612244897959183,Unisex
Pat,1918,285,70,215,24.561403508771928,75.43859649122807,Unisex
Pernell,1918,22,8,14,36.36363636363637,63.63636363636363,Unisex
Dana,1918,174,66,108,37.93103448275862,62.06896551724138,Unisex
Curlie,1918,13,8,5,61.53846153846154,38.46153846153847,Unisex
Jene,1918,20,13,7,65.0,35.0,Unisex
Neville,1918,33,6,27,18.181818181818183,81.81818181818183,Unisex
Lavell,1918,12,6,6,50.0,50.0,Unisex
Ardell,1918,105,73,32,69.52380952380952,30.47619047619048,Unisex
Bobbie,1918,343,266,77,77.55102040816327,22.448979591836736,Unisex
Reyes,1918,29,11,18,37.93103448275862,62.06896551724138,Unisex
Theo,1918,192,105,87,54.6875,45.3125,Unisex
Connie,1918,547,439,108,80.25594149908592,19.74405850091408,Unisex
Onnie,1918,43,32,11,74.4186046511628,25.58139534883721,Unisex
Osie,1918,54,38,16,70.37037037037037,29.629629629629623,Unisex
Zola,1919,172,172,0,100.0,0.0,Female
Florina,1919,10,10,0,100.0,0.0,Female
Lue,1919,176,160,16,90.9090909090909,9.090909090909092,Female
Elda,1919,241,236,5,97.9253112033195,2.0746887966804977,Female
Lorell,1919,10,10,0,100.0,0.0,Female
Terrie,1919,6,6,0,100.0,0.0,Female
Yvette,1919,115,115,0,100.0,0.0,Female
Columbia,1919,26,26,0,100.0,0.0,Female
Emilie,1919,168,168,0,100.0,0.0,Female
Mildred,1919,17344,17300,44,99.74630996309963,0.253690036900369,Female
Grover,1919,686,6,680,0.8746355685131195,99.12536443148689,Male
Carson,1919,103,0,103,0.0,100.0,Male
Carmello,1919,13,0,13,0.0,100.0,Male
Udell,1919,15,0,15,0.0,100.0,Male
Geary,1919,6,0,6,0.0,100.0,Male
Graham,1919,93,0,93,0.0,100.0,Male
Leston,1919,10,0,10,0.0,100.0,Male
Milburn,1919,71,0,71,0.0,100.0,Male
Justice,1919,16,0,16,0.0,100.0,Male
Levern,1919,23,0,23,0.0,100.0,Male
Rafael,1919,108,0,108,0.0,100.0,Male
Domingo,1919,136,5,131,3.6764705882352944,96.32352941176472,Male
Alwin,1919,24,0,24,0.0,100.0,Male
Nolen,1919,35,0,35,0.0,100.0,Male
Edd,1919,169,6,163,3.5502958579881656,96.44970414201184,Male
Erby,1919,16,0,16,0.0,100.0,Male
Luverne,1919,81,43,38,53.086419753086425,46.913580246913575,Unisex
Montie,1919,29,16,13,55.172413793103445,44.82758620689656,Unisex
Lavell,1919,18,6,12,33.33333333333333,66.66666666666666,Unisex
Dennie,1919,28,6,22,21.428571428571427,78.57142857142857,Unisex
Lannie,1919,33,20,13,60.60606060606061,39.39393939393939,Unisex
Christie,1919,36,14,22,38.88888888888889,61.11111111111112,Unisex
Climmie,1919,17,11,6,64.70588235294117,35.294117647058826,Unisex
Arie,1919,40,20,20,50.0,50.0,Unisex
Bennie,1919,1013,179,834,17.67028627838105,82.32971372161896,Unisex
Meredith,1919,143,66,77,46.15384615384615,53.84615384615385,Unisex
Ivie,1919,21,15,6,71.42857142857143,28.57142857142857,Unisex
Oval,1919,30,6,24,20.0,80.0,Unisex
Clemmie,1919,58,47,11,81.03448275862068,18.96551724137931,Unisex
Arliss,1919,12,7,5,58.333333333333336,41.66666666666667,Unisex
Theo,1919,201,109,92,54.22885572139303,45.77114427860697,Unisex
Freddy,1919,26,5,21,19.23076923076924,80.76923076923077,Unisex
Elba,1919,42,29,13,69.04761904761905,30.95238095238096,Unisex
Oda,1919,49,39,10,79.59183673469387,20.40816326530612,Unisex
Audie,1919,89,52,37,58.42696629213483,41.57303370786517,Unisex
Burnell,1919,57,13,44,22.807017543859647,77.19298245614034,Unisex
Olie,1919,30,15,15,50.0,50.0,Unisex
Bertis,1919,20,7,13,35.0,65.0,Unisex
Golden,1919,128,62,66,48.4375,51.5625,Unisex
Ronnie,1919,35,18,17,51.42857142857142,48.57142857142857,Unisex
Jonnie,1919,127,54,73,42.51968503937008,57.48031496062992,Unisex
Verlyn,1919,15,5,10,33.33333333333333,66.66666666666666,Unisex
Lorena,1920,440,440,0,100.0,0.0,Female
Vera,1920,3795,3785,10,99.7364953886693,0.2635046113306983,Female
Petrina,1920,20,20,0,100.0,0.0,Female
Maurine,1920,266,266,0,100.0,0.0,Female
Orlean,1920,20,20,0,100.0,0.0,Female
Silva,1920,13,13,0,100.0,0.0,Female
Noemi,1920,6,6,0,100.0,0.0,Female
Everlean,1920,14,14,0,100.0,0.0,Female
Avalon,1920,11,11,0,100.0,0.0,Female
Greta,1920,62,62,0,100.0,0.0,Female
Vilma,1920,35,35,0,100.0,0.0,Female
Lazaro,1920,10,0,10,0.0,100.0,Male
Owen,1920,598,0,598,0.0,100.0,Male
Lindley,1920,17,0,17,0.0,100.0,Male
Olavi,1920,9,0,9,0.0,100.0,Male
Wyley,1920,5,0,5,0.0,100.0,Male
Gayland,1920,13,0,13,0.0,100.0,Male
Camilo,1920,11,0,11,0.0,100.0,Male
Malcolm,1920,556,0,556,0.0,100.0,Male
Terrel,1920,8,0,8,0.0,100.0,Male
Arnoldo,1920,6,0,6,0.0,100.0,Male
Willmer,1920,13,0,13,0.0,100.0,Male
Ivory,1920,137,57,80,41.6058394160584,58.3941605839416,Unisex
Artis,1920,71,14,57,19.718309859154928,80.28169014084507,Unisex
Ferrell,1920,36,6,30,16.666666666666664,83.33333333333334,Unisex
Dannie,1920,76,33,43,43.42105263157895,56.57894736842105,Unisex
Santos,1920,147,59,88,40.13605442176871,59.863945578231295,Unisex
Darnell,1920,21,8,13,38.095238095238095,61.90476190476191,Unisex
Orla,1920,27,17,10,62.96296296296296,37.03703703703704,Unisex
Lesley,1920,65,15,50,23.07692307692308,76.92307692307693,Unisex
Johnie,1920,854,148,706,17.330210772833723,82.66978922716628,Unisex
Autry,1920,17,7,10,41.17647058823529,58.82352941176471,Unisex
Dossie,1920,31,17,14,54.83870967741935,45.16129032258064,Unisex
Carey,1920,79,16,63,20.253164556962027,79.74683544303798,Unisex
Lupe,1920,346,284,62,82.08092485549133,17.91907514450867,Unisex
Arlis,1920,39,9,30,23.07692307692308,76.92307692307693,Unisex
Audy,1920,17,5,12,29.411764705882355,70.58823529411765,Unisex
Cardell,1920,14,5,9,35.714285714285715,64.28571428571429,Unisex
Clemence,1920,33,11,22,33.33333333333333,66.66666666666666,Unisex
Waverly,1920,30,5,25,16.666666666666664,83.33333333333334,Unisex
Ivey,1920,45,16,29,35.55555555555556,64.44444444444444,Unisex
Elia,1920,45,35,10,77.77777777777779,22.22222222222222,Unisex
Irby,1920,31,5,26,16.129032258064516,83.87096774193549,Unisex
Merle,1920,1222,403,819,32.97872340425532,67.02127659574468,Unisex
Arlen,1920,27,5,22,18.51851851851852,81.48148148148148,Unisex
Georgean,1921,6,6,0,100.0,0.0,Female
Feliz,1921,7,7,0,100.0,0.0,Female
Maxcine,1921,12,12,0,100.0,0.0,Female
Imo,1921,24,24,0,100.0,0.0,Female
Caroll,1921,12,0,12,0.0,100.0,Male
Haven,1921,16,0,16,0.0,100.0,Male
Brit,1921,6,0,6,0.0,100.0,Male
Sanford,1921,250,0,250,0.0,100.0,Male
Graham,1921,129,0,129,0.0,100.0,Male
Alan,1921,380,5,375,1.3157894736842104,98.68421052631578,Male
Erle,1921,21,0,21,0.0,100.0,Male
Lenzie,1921,11,0,11,0.0,100.0,Male
Levon,1921,18,0,18,0.0,100.0,Male
Winston,1921,289,0,289,0.0,100.0,Male
Reyes,1921,32,9,23,28.125,71.875,Unisex
Claudie,1921,187,97,90,51.87165775401069,48.1283422459893,Unisex
Karol,1921,25,8,17,32.0,68.0,Unisex
Massie,1921,17,10,7,58.82352941176471,41.17647058823529,Unisex
Bela,1921,12,6,6,50.0,50.0,Unisex
Lacey,1921,30,7,23,23.33333333333333,76.66666666666667,Unisex
Cleotha,1921,21,13,8,61.90476190476191,38.095238095238095,Unisex
Carmel,1921,160,121,39,75.625,24.375,Unisex
Olie,1921,22,7,15,31.818181818181817,68.18181818181817,Unisex
Oval,1921,30,8,22,26.666666666666668,73.33333333333333,Unisex
Ysabel,1921,22,14,8,63.63636363636363,36.36363636363637,Unisex
Carlin,1921,16,5,11,31.25,68.75,Unisex
Mackie,1921,15,9,6,60.0,40.0,Unisex
Cornie,1921,15,8,7,53.333333333333336,46.66666666666666,Unisex
Foye,1921,14,9,5,64.28571428571429,35.714285714285715,Unisex
Udell,1921,15,7,8,46.66666666666666,53.333333333333336,Unisex
Clemence,1921,34,16,18,47.05882352941176,52.94117647058824,Unisex
Salome,1921,39,24,15,61.53846153846154,38.46153846153847,Unisex
Lavelle,1921,62,50,12,80.64516129032258,19.35483870967742,Unisex
Ivy,1921,208,143,65,68.75,31.25,Unisex
Marrion,1921,28,11,17,39.285714285714285,60.71428571428571,Unisex
Jonnie,1921,120,76,44,63.33333333333333,36.66666666666666,Unisex
Arie,1921,51,35,16,68.62745098039215,31.37254901960784,Unisex
Luby,1921,17,6,11,35.294117647058826,64.70588235294117,Unisex
Paz,1922,8,8,0,100.0,0.0,Female
Nila,1922,64,64,0,100.0,0.0,Female
Edell,1922,15,15,0,100.0,0.0,Female
Emilie,1922,169,169,0,100.0,0.0,Female
Evlyn,1922,19,19,0,100.0,0.0,Female
Wynema,1922,19,19,0,100.0,0.0,Female
Anette,1922,8,8,0,100.0,0.0,Female
Vilma,1922,37,37,0,100.0,0.0,Female
Creighton,1922,16,0,16,0.0,100.0,Male
Dorian,1922,8,0,8,0.0,100.0,Male
Jarrett,1922,15,0,15,0.0,100.0,Male
Dorance,1922,8,0,8,0.0,100.0,Male
Gaylon,1922,12,0,12,0.0,100.0,Male
Stan,1922,17,0,17,0.0,100.0,Male
Uriel,1922,7,0,7,0.0,100.0,Male
Cliffton,1922,8,0,8,0.0,100.0,Male
Harris,1922,233,0,233,0.0,100.0,Male
Wesley,1922,1297,10,1287,0.7710100231303008,99.2289899768697,Male
Kent,1922,98,0,98,0.0,100.0,Male
Bobie,1922,12,5,7,41.66666666666667,58.333333333333336,Unisex
Cary,1922,73,13,60,17.80821917808219,82.1917808219178,Unisex
Otha,1922,163,45,118,27.607361963190183,72.39263803680981,Unisex
Texas,1922,19,11,8,57.89473684210527,42.10526315789473,Unisex
Roby,1922,32,5,27,15.625,84.375,Unisex
Robin,1922,70,33,37,47.14285714285714,52.85714285714286,Unisex
Vonnie,1922,42,35,7,83.33333333333334,16.666666666666664,Unisex
Elia,1922,33,27,6,81.81818181818183,18.181818181818183,Unisex
Vernis,1922,24,11,13,45.83333333333333,54.16666666666666,Unisex
Glennis,1922,48,40,8,83.33333333333334,16.666666666666664,Unisex
Arliss,1922,34,22,12,64.70588235294117,35.294117647058826,Unisex
Odell,1922,534,167,367,31.273408239700373,68.72659176029963,Unisex
Diamond,1922,16,5,11,31.25,68.75,Unisex
Johnie,1922,792,184,608,23.232323232323232,76.76767676767676,Unisex
Marty,1922,26,5,21,19.23076923076924,80.76923076923077,Unisex
Burnice,1922,105,64,41,60.95238095238096,39.04761904761905,Unisex
Bonny,1922,20,15,5,75.0,25.0,Unisex
Lannie,1922,29,24,5,82.75862068965517,17.24137931034483,Unisex
Clois,1922,28,12,16,42.85714285714285,57.14285714285714,Unisex
Arie,1922,50,32,18,64.0,36.0,Unisex
Lattie,1922,18,13,5,72.22222222222221,27.77777777777778,Unisex
Dee,1922,159,36,123,22.641509433962263,77.35849056603774,Unisex
Nollie,1922,16,10,6,62.5,37.5,Unisex
Bennie,1922,1127,212,915,18.81100266193434,81.18899733806566,Unisex
Collette,1923,11,11,0,100.0,0.0,Female
Binnie,1923,6,6,0,100.0,0.0,Female
Patrice,1923,10,10,0,100.0,0.0,Female
Genia,1923,5,5,0,100.0,0.0,Female
Pheobe,1923,9,9,0,100.0,0.0,Female
Phoebe,1923,194,194,0,100.0,0.0,Female
Equilla,1923,11,11,0,100.0,0.0,Female
Vanna,1923,9,9,0,100.0,0.0,Female
Josie,1923,413,413,0,100.0,0.0,Female
Domenic,1923,123,0,123,0.0,100.0,Male
Maxey,1923,8,0,8,0.0,100.0,Male
Lenzie,1923,9,0,9,0.0,100.0,Male
Colman,1923,10,0,10,0.0,100.0,Male
Olden,1923,22,0,22,0.0,100.0,Male
Forest,1923,276,6,270,2.1739130434782608,97.82608695652172,Male
Sheppard,1923,6,0,6,0.0,100.0,Male
Wells,1923,15,0,15,0.0,100.0,Male
Shirl,1923,10,0,10,0.0,100.0,Male
Lars,1923,17,0,17,0.0,100.0,Male
Lehman,1923,17,0,17,0.0,100.0,Male
Rudie,1923,7,0,7,0.0,100.0,Male
Allison,1923,72,21,51,29.166666666666668,70.83333333333334,Unisex
Jimmie,1923,1553,391,1162,25.17707662588538,74.82292337411461,Unisex
Dorris,1923,346,290,56,83.8150289017341,16.184971098265898,Unisex
Elza,1923,63,13,50,20.63492063492064,79.36507936507937,Unisex
Lattie,1923,23,14,9,60.86956521739131,39.130434782608695,Unisex
Ivon,1923,16,10,6,62.5,37.5,Unisex
Jonnie,1923,132,81,51,61.36363636363637,38.63636363636363,Unisex
Cruz,1923,155,84,71,54.19354838709678,45.80645161290322,Unisex
Vernis,1923,26,15,11,57.692307692307686,42.30769230769231,Unisex
Carmello,1923,28,5,23,17.857142857142858,82.14285714285714,Unisex
Hiawatha,1923,26,8,18,30.76923076923077,69.23076923076923,Unisex
Teddie,1923,17,6,11,35.294117647058826,64.70588235294117,Unisex
Tracey,1923,12,5,7,41.66666666666667,58.333333333333336,Unisex
Le,1923,17,5,12,29.411764705882355,70.58823529411765,Unisex
Orris,1923,40,6,34,15.0,85.0,Unisex
Carey,1923,83,15,68,18.072289156626507,81.92771084337349,Unisex
Lovell,1923,57,22,35,38.59649122807017,61.40350877192983,Unisex
Orla,1923,21,10,11,47.61904761904761,52.38095238095239,Unisex
Rea,1923,28,19,9,67.85714285714286,32.142857142857146,Unisex
Johnnie,1923,2598,946,1652,36.41262509622787,63.58737490377213,Unisex
Delma,1923,230,189,41,82.17391304347827,17.82608695652174,Unisex
Lyndell,1923,27,15,12,55.55555555555556,44.44444444444444,Unisex
Sherrill,1923,24,5,19,20.833333333333336,79.16666666666666,Unisex
Loyce,1923,96,74,22,77.08333333333334,22.916666666666664,Unisex
Kelsie,1923,12,7,5,58.333333333333336,41.66666666666667,Unisex
Rita,1924,5393,5381,12,99.77748933803078,0.2225106619692193,Female
Lovely,1924,8,8,0,100.0,0.0,Female
Lauris,1924,5,5,0,100.0,0.0,Female
Germaine,1924,164,164,0,100.0,0.0,Female
Garnell,1924,11,11,0,100.0,0.0,Female
Almira,1924,29,29,0,100.0,0.0,Female
Saralyn,1924,5,5,0,100.0,0.0,Female
Leola,1924,764,757,7,99.08376963350786,0.9162303664921464,Female
Clementina,1924,37,37,0,100.0,0.0,Female
Milburn,1924,53,0,53,0.0,100.0,Male
Carmin,1924,10,0,10,0.0,100.0,Male
Rosendo,1924,30,0,30,0.0,100.0,Male
Satoshi,1924,12,0,12,0.0,100.0,Male
Bliss,1924,6,0,6,0.0,100.0,Male
Pierre,1924,61,0,61,0.0,100.0,Male
Odis,1924,187,5,182,2.6737967914438503,97.32620320855617,Male
Doyle,1924,474,6,468,1.2658227848101269,98.73417721518987,Male
Gradie,1924,23,5,18,21.73913043478261,78.26086956521739,Unisex
Orris,1924,40,6,34,15.0,85.0,Unisex
Billie,1924,2481,1599,882,64.44981862152358,35.55018137847642,Unisex
Courtney,1924,65,16,49,24.615384615384617,75.38461538461539,Unisex
Carlee,1924,24,14,10,58.333333333333336,41.66666666666667,Unisex
Jule,1924,60,36,24,60.0,40.0,Unisex
Toby,1924,82,59,23,71.95121951219512,28.04878048780488,Unisex
Rennie,1924,16,8,8,50.0,50.0,Unisex
Brownie,1924,47,28,19,59.57446808510638,40.42553191489361,Unisex
Rozell,1924,26,11,15,42.30769230769231,57.692307692307686,Unisex
Caroll,1924,14,5,9,35.714285714285715,64.28571428571429,Unisex
Carnell,1924,42,16,26,38.095238095238095,61.90476190476191,Unisex
Jamie,1924,89,54,35,60.67415730337079,39.325842696629216,Unisex
Larrie,1924,11,6,5,54.54545454545454,45.45454545454545,Unisex
Refugio,1924,101,32,69,31.683168316831683,68.31683168316832,Unisex
Joey,1924,23,9,14,39.130434782608695,60.86956521739131,Unisex
Nieves,1924,29,17,12,58.620689655172406,41.37931034482759,Unisex
Rene,1924,223,38,185,17.040358744394617,82.95964125560538,Unisex
Clare,1924,301,217,84,72.09302325581395,27.906976744186046,Unisex
Elvie,1924,91,68,23,74.72527472527473,25.27472527472528,Unisex
France,1924,37,28,9,75.67567567567568,24.324324324324326,Unisex
Salome,1924,35,19,16,54.285714285714285,45.71428571428572,Unisex
Bell,1925,34,34,0,100.0,0.0,Female
Evie,1925,84,84,0,100.0,0.0,Female
Judith,1925,554,554,0,100.0,0.0,Female
Vera,1925,3292,3280,12,99.63547995139731,0.3645200486026731,Female
Farrell,1925,55,6,49,10.909090909090908,89.0909090909091,Male
Aubry,1925,36,0,36,0.0,100.0,Male
Gilmore,1925,26,0,26,0.0,100.0,Male
Selwyn,1925,21,0,21,0.0,100.0,Male
Jerome,1925,1574,11,1563,0.6988564167725541,99.30114358322744,Male
Gentry,1925,11,0,11,0.0,100.0,Male
Harper,1925,21,0,21,0.0,100.0,Male
Junior,1925,1558,13,1545,0.8344030808729139,99.16559691912708,Male
Sanford,1925,273,0,273,0.0,100.0,Male
Nealy,1925,12,6,6,50.0,50.0,Unisex
Trinidad,1925,114,64,50,56.14035087719298,43.85964912280701,Unisex
Laverne,1925,1736,1335,401,76.90092165898618,23.099078341013826,Unisex
Avon,1925,41,17,24,41.46341463414634,58.53658536585365,Unisex
Edell,1925,13,8,5,61.53846153846154,38.46153846153847,Unisex
Ferol,1925,24,19,5,79.16666666666666,20.833333333333336,Unisex
Stacy,1925,53,13,40,24.52830188679245,75.47169811320755,Unisex
Rossie,1925,53,43,10,81.13207547169812,18.867924528301888,Unisex
Val,1925,54,14,40,25.925925925925924,74.07407407407408,Unisex
Varnell,1925,12,5,7,41.66666666666667,58.333333333333336,Unisex
Teddie,1925,24,6,18,25.0,75.0,Unisex
Kelsie,1925,12,6,6,50.0,50.0,Unisex
Dorsie,1925,24,15,9,62.5,37.5,Unisex
Maryland,1925,34,27,7,79.41176470588235,20.588235294117645,Unisex
Toby,1925,66,39,27,59.09090909090909,40.909090909090914,Unisex
Lavaughn,1925,40,31,9,77.5,22.5,Unisex
Clois,1925,32,14,18,43.75,56.25,Unisex
Jerre,1925,12,7,5,58.333333333333336,41.66666666666667,Unisex
Ermal,1925,22,15,7,68.18181818181817,31.818181818181817,Unisex
Rosario,1925,150,40,110,26.666666666666668,73.33333333333333,Unisex
Jene,1925,32,12,20,37.5,62.5,Unisex
Merlyn,1925,120,41,79,34.166666666666664,65.83333333333333,Unisex
Roe,1925,21,7,14,33.33333333333333,66.66666666666666,Unisex
Ysabel,1925,26,15,11,57.692307692307686,42.30769230769231,Unisex
Natividad,1925,76,41,35,53.94736842105263,46.05263157894737,Unisex
Gwynn,1925,11,5,6,45.45454545454545,54.54545454545454,Unisex
Artie,1925,182,129,53,70.87912087912088,29.120879120879124,Unisex
Metha,1926,9,9,0,100.0,0.0,Female
Penelope,1926,64,64,0,100.0,0.0,Female
Annemarie,1926,12,12,0,100.0,0.0,Female
Estelle,1926,1121,1113,8,99.28635147190008,0.7136485280999109,Female
Ella,1926,2870,2852,18,99.37282229965156,0.627177700348432,Female
Ace,1926,16,0,16,0.0,100.0,Male
Oral,1926,62,5,57,8.064516129032258,91.93548387096774,Male
Barney,1926,219,5,214,2.28310502283105,97.71689497716896,Male
Buren,1926,22,0,22,0.0,100.0,Male
Rayfield,1926,27,0,27,0.0,100.0,Male
Dick,1926,650,0,650,0.0,100.0,Male
Kai,1926,6,0,6,0.0,100.0,Male
Rollie,1926,50,0,50,0.0,100.0,Male
Standley,1926,5,0,5,0.0,100.0,Male
Ansel,1926,35,0,35,0.0,100.0,Male
Camilo,1926,14,0,14,0.0,100.0,Male
Dirk,1926,12,0,12,0.0,100.0,Male
Cletus,1926,213,13,200,6.103286384976526,93.89671361502349,Male
Primitivo,1926,10,0,10,0.0,100.0,Male
Candido,1926,19,0,19,0.0,100.0,Male
Christie,1926,33,18,15,54.54545454545454,45.45454545454545,Unisex
Audry,1926,88,70,18,79.54545454545455,20.454545454545457,Unisex
Murl,1926,69,19,50,27.536231884057973,72.46376811594203,Unisex
Bernie,1926,138,33,105,23.91304347826087,76.08695652173914,Unisex
Merrell,1926,24,7,17,29.166666666666668,70.83333333333334,Unisex
Victory,1926,11,6,5,54.54545454545454,45.45454545454545,Unisex
Rue,1926,14,7,7,50.0,50.0,Unisex
Orla,1926,20,14,6,70.0,30.0,Unisex
Lyndall,1926,15,8,7,53.333333333333336,46.66666666666666,Unisex
Mell,1926,18,9,9,50.0,50.0,Unisex
Alva,1926,415,156,259,37.59036144578313,62.40963855421688,Unisex
Hilary,1926,53,8,45,15.09433962264151,84.90566037735849,Unisex
Columbia,1926,21,16,5,76.19047619047619,23.809523809523807,Unisex
Raye,1926,27,21,6,77.77777777777779,22.22222222222222,Unisex
Dell,1926,80,37,43,46.25,53.75,Unisex
Santos,1926,164,68,96,41.46341463414634,58.53658536585365,Unisex
Dorian,1926,12,7,5,58.333333333333336,41.66666666666667,Unisex
Mickey,1926,153,89,64,58.16993464052288,41.830065359477125,Unisex
Allison,1926,108,37,71,34.25925925925926,65.74074074074075,Unisex
Azzie,1926,30,25,5,83.33333333333334,16.666666666666664,Unisex
Vernis,1926,12,6,6,50.0,50.0,Unisex
Ysabel,1926,22,11,11,50.0,50.0,Unisex
Johnnie,1926,2804,1073,1731,38.26676176890157,61.73323823109843,Unisex
Nieves,1926,35,26,9,74.28571428571429,25.71428571428571,Unisex
Richie,1926,12,7,5,58.333333333333336,41.66666666666667,Unisex
Curlie,1926,23,18,5,78.26086956521739,21.73913043478261,Unisex
Elzie,1926,107,17,90,15.887850467289718,84.11214953271028,Unisex
Mabeline,1927,6,6,0,100.0,0.0,Female
Jeannette,1927,910,910,0,100.0,0.0,Female
Greta,1927,146,146,0,100.0,0.0,Female
Maurine,1927,244,244,0,100.0,0.0,Female
Maryanne,1927,46,46,0,100.0,0.0,Female
Kathlee,1927,5,5,0,100.0,0.0,Female
Maryella,1927,6,6,0,100.0,0.0,Female
Alethia,1927,21,21,0,100.0,0.0,Female
Matilde,1927,74,65,9,87.83783783783784,12.162162162162163,Female
Leontine,1927,12,12,0,100.0,0.0,Female
Benetta,1927,10,10,0,100.0,0.0,Female
Leslie,1927,1567,126,1441,8.040842373962986,91.959157626037,Male
Harris,1927,212,0,212,0.0,100.0,Male
Jerome,1927,1702,16,1686,0.9400705052878966,99.05992949471212,Male
Cosme,1927,12,0,12,0.0,100.0,Male
Gerome,1927,7,0,7,0.0,100.0,Male
Dempsey,1927,75,0,75,0.0,100.0,Male
Irven,1927,40,0,40,0.0,100.0,Male
Rual,1927,14,0,14,0.0,100.0,Male
Satoshi,1927,8,0,8,0.0,100.0,Male
Wiliam,1927,5,0,5,0.0,100.0,Male
Cedric,1927,51,0,51,0.0,100.0,Male
Shelby,1927,135,11,124,8.148148148148149,91.85185185185183,Male
Arliss,1927,27,18,9,66.66666666666666,33.33333333333333,Unisex
Jonnie,1927,142,79,63,55.633802816901415,44.36619718309859,Unisex
Climmie,1927,28,15,13,53.57142857142857,46.42857142857143,Unisex
Mickey,1927,175,84,91,48.0,52.0,Unisex
Kaye,1927,37,25,12,67.56756756756756,32.432432432432435,Unisex
Lindell,1927,30,7,23,23.33333333333333,76.66666666666667,Unisex
Temple,1927,19,7,12,36.84210526315789,63.1578947368421,Unisex
Odell,1927,414,114,300,27.536231884057973,72.46376811594203,Unisex
Augustine,1927,225,64,161,28.444444444444443,71.55555555555554,Unisex
Oda,1927,29,23,6,79.3103448275862,20.6896551724138,Unisex
Roby,1927,32,8,24,25.0,75.0,Unisex
Dayle,1927,17,6,11,35.294117647058826,64.70588235294117,Unisex
Cruz,1927,137,62,75,45.25547445255474,54.74452554744526,Unisex
Lexie,1927,40,32,8,80.0,20.0,Unisex
Ival,1927,21,7,14,33.33333333333333,66.66666666666666,Unisex
Orrie,1927,20,8,12,40.0,60.0,Unisex
Pernell,1927,13,6,7,46.15384615384615,53.84615384615385,Unisex
Garnet,1927,185,138,47,74.5945945945946,25.405405405405407,Unisex
Hiawatha,1927,24,8,16,33.33333333333333,66.66666666666666,Unisex
Lattie,1927,17,10,7,58.82352941176471,41.17647058823529,Unisex
Encarnacion,1927,27,9,18,33.33333333333333,66.66666666666666,Unisex
Norvell,1927,20,8,12,40.0,60.0,Unisex
Murl,1927,84,26,58,30.95238095238096,69.04761904761905,Unisex
Cathryn,1928,80,80,0,100.0,0.0,Female
Benetta,1928,5,5,0,100.0,0.0,Female
Hope,1928,284,279,5,98.23943661971832,1.7605633802816902,Female
Francena,1928,12,12,0,100.0,0.0,Female
Luanna,1928,7,7,0,100.0,0.0,Female
Wendy,1928,5,5,0,100.0,0.0,Female
Domingo,1928,164,0,164,0.0,100.0,Male
Mc,1928,11,0,11,0.0,100.0,Male
Wyley,1928,5,0,5,0.0,100.0,Male
Cletus,1928,169,9,160,5.325443786982249,94.67455621301777,Male
Enos,1928,48,0,48,0.0,100.0,Male
Swanson,1928,8,0,8,0.0,100.0,Male
Hector,1928,186,0,186,0.0,100.0,Male
Arthur,1928,8975,94,8881,1.0473537604456824,98.95264623955433,Male
Lander,1928,7,0,7,0.0,100.0,Male
Ace,1928,17,0,17,0.0,100.0,Male
Jc,1928,15,0,15,0.0,100.0,Male
Odis,1928,187,0,187,0.0,100.0,Male
Ike,1928,61,0,61,0.0,100.0,Male
Valley,1928,15,6,9,40.0,60.0,Unisex
Osa,1928,12,5,7,41.66666666666667,58.333333333333336,Unisex
Norvell,1928,21,6,15,28.57142857142857,71.42857142857143,Unisex
Ludie,1928,46,39,7,84.78260869565217,15.217391304347828,Unisex
Merlyn,1928,132,35,97,26.51515151515152,73.48484848484848,Unisex
Nickie,1928,16,6,10,37.5,62.5,Unisex
Robin,1928,90,36,54,40.0,60.0,Unisex
Gerry,1928,157,115,42,73.24840764331209,26.751592356687897,Unisex
Natividad,1928,84,41,43,48.80952380952381,51.19047619047619,Unisex
Luverne,1928,62,35,27,56.451612903225815,43.54838709677419,Unisex
Kaye,1928,33,25,8,75.75757575757575,24.24242424242424,Unisex
Billie,1928,4093,2776,1317,67.82311263132176,32.17688736867823,Unisex
Trinidad,1928,137,76,61,55.47445255474452,44.52554744525548,Unisex
Nyle,1928,29,6,23,20.6896551724138,79.3103448275862,Unisex
Bobie,1928,24,9,15,37.5,62.5,Unisex
Burnell,1928,70,19,51,27.142857142857142,72.85714285714285,Unisex
Delaine,1928,28,20,8,71.42857142857143,28.57142857142857,Unisex
Verle,1928,79,21,58,26.58227848101265,73.41772151898735,Unisex
Carmie,1928,14,9,5,64.28571428571429,35.714285714285715,Unisex
Bertis,1928,19,7,12,36.84210526315789,63.1578947368421,Unisex
Lannie,1928,27,16,11,59.25925925925925,40.74074074074074,Unisex
Carrol,1928,195,35,160,17.94871794871795,82.05128205128204,Unisex
Curlee,1928,12,6,6,50.0,50.0,Unisex
Beth,1929,262,262,0,100.0,0.0,Female
Danna,1929,12,12,0,100.0,0.0,Female
Cloa,1929,6,6,0,100.0,0.0,Female
Margie,1929,2351,2337,14,99.40450871969377,0.5954912803062526,Female
Rosalia,1929,56,56,0,100.0,0.0,Female
Sudie,1929,51,51,0,100.0,0.0,Female
Everlean,1929,10,10,0,100.0,0.0,Female
Eduard,1929,10,0,10,0.0,100.0,Male
Kerwin,1929,6,0,6,0.0,100.0,Male
Swanson,1929,9,0,9,0.0,100.0,Male
Rex,1929,492,0,492,0.0,100.0,Male
Luke,1929,153,0,153,0.0,100.0,Male
Kenneth,1929,10930,89,10841,0.8142726440988106,99.1857273559012,Male
Haywood,1929,86,0,86,0.0,100.0,Male
Clem,1929,71,0,71,0.0,100.0,Male
Gerald,1929,6016,49,5967,0.8144946808510639,99.18550531914892,Male
Bengamin,1929,5,0,5,0.0,100.0,Male
Ira,1929,728,74,654,10.164835164835164,89.83516483516483,Male
Rolland,1929,245,0,245,0.0,100.0,Male
Jacque,1929,36,15,21,41.66666666666667,58.333333333333336,Unisex
Edell,1929,16,7,9,43.75,56.25,Unisex
Ludie,1929,38,32,6,84.21052631578947,15.789473684210526,Unisex
Refugio,1929,80,28,52,35.0,65.0,Unisex
Bennie,1929,1215,256,959,21.069958847736626,78.93004115226337,Unisex
Cordell,1929,25,7,18,28.000000000000004,72.0,Unisex
Carlee,1929,22,15,7,68.18181818181817,31.818181818181817,Unisex
Laverne,1929,1562,1194,368,76.4404609475032,23.5595390524968,Unisex
Jule,1929,44,19,25,43.18181818181818,56.81818181818182,Unisex
Page,1929,28,8,20,28.57142857142857,71.42857142857143,Unisex
Ardie,1929,28,15,13,53.57142857142857,46.42857142857143,Unisex
Jammie,1929,10,5,5,50.0,50.0,Unisex
Bernie,1929,109,19,90,17.431192660550458,82.56880733944955,Unisex
Marty,1929,40,18,22,45.0,55.00000000000001,Unisex
Otha,1929,144,29,115,20.13888888888889,79.86111111111111,Unisex
Ival,1929,11,6,5,54.54545454545454,45.45454545454545,Unisex
Joey,1929,22,6,16,27.27272727272727,72.72727272727273,Unisex
Sunny,1929,25,17,8,68.0,32.0,Unisex
Dorian,1929,14,7,7,50.0,50.0,Unisex
Ermal,1929,11,6,5,54.54545454545454,45.45454545454545,Unisex
Precious,1929,26,21,5,80.76923076923077,19.23076923076924,Unisex
Vernis,1929,15,8,7,53.333333333333336,46.66666666666666,Unisex
Richie,1929,14,6,8,42.85714285714285,57.14285714285714,Unisex
Dell,1929,67,23,44,34.32835820895522,65.67164179104478,Unisex
Ova,1929,30,17,13,56.66666666666666,43.333333333333336,Unisex
Macie,1930,40,40,0,100.0,0.0,Female
Shella,1930,5,5,0,100.0,0.0,Female
Ferol,1930,11,11,0,100.0,0.0,Female
Leotha,1930,10,10,0,100.0,0.0,Female
Rea,1930,18,18,0,100.0,0.0,Female
Nettie,1930,662,657,5,99.24471299093656,0.7552870090634441,Female
Laveda,1930,17,17,0,100.0,0.0,Female
Suzette,1930,12,12,0,100.0,0.0,Female
Zoltan,1930,9,0,9,0.0,100.0,Male
Perry,1930,598,17,581,2.842809364548495,97.15719063545151,Male
Lendon,1930,9,0,9,0.0,100.0,Male
Ivo,1930,10,0,10,0.0,100.0,Male
Justice,1930,7,0,7,0.0,100.0,Male
Laban,1930,5,0,5,0.0,100.0,Male
Erich,1930,31,0,31,0.0,100.0,Male
Burlie,1930,6,0,6,0.0,100.0,Male
Bertrand,1930,61,0,61,0.0,100.0,Male
Eli,1930,190,0,190,0.0,100.0,Male
Lowery,1930,10,0,10,0.0,100.0,Male
Woodard,1930,8,0,8,0.0,100.0,Male
Jene,1930,20,6,14,30.0,70.0,Unisex
Clemence,1930,18,9,9,50.0,50.0,Unisex
Burnette,1930,18,12,6,66.66666666666666,33.33333333333333,Unisex
Carmel,1930,121,94,27,77.68595041322314,22.31404958677686,Unisex
Joie,1930,16,9,7,56.25,43.75,Unisex
Merle,1930,948,237,711,25.0,75.0,Unisex
Carmie,1930,11,6,5,54.54545454545454,45.45454545454545,Unisex
Carmen,1930,1318,1044,274,79.21092564491654,20.789074355083457,Unisex
Pilar,1930,26,20,6,76.92307692307693,23.07692307692308,Unisex
Onie,1930,31,23,8,74.19354838709677,25.806451612903224,Unisex
Arlis,1930,58,28,30,48.27586206896552,51.72413793103448,Unisex
Barrie,1930,19,6,13,31.57894736842105,68.42105263157895,Unisex
Artie,1930,143,95,48,66.43356643356644,33.56643356643357,Unisex
Berry,1930,72,11,61,15.27777777777778,84.72222222222221,Unisex
Elgie,1930,27,15,12,55.55555555555556,44.44444444444444,Unisex
Ronnie,1930,167,26,141,15.568862275449105,84.4311377245509,Unisex
Bobbie,1930,2460,1765,695,71.7479674796748,28.252032520325205,Unisex
Farris,1930,68,14,54,20.588235294117645,79.41176470588235,Unisex
Augustine,1930,173,51,122,29.47976878612717,70.52023121387283,Unisex
Marty,1930,38,6,32,15.789473684210526,84.21052631578947,Unisex
Montie,1930,33,12,21,36.36363636363637,63.63636363636363,Unisex
Oda,1930,23,14,9,60.86956521739131,39.130434782608695,Unisex
Paz,1930,18,6,12,33.33333333333333,66.66666666666666,Unisex
Velmer,1930,15,10,5,66.66666666666666,33.33333333333333,Unisex
Curley,1930,42,9,33,21.428571428571427,78.57142857142857,Unisex
Myrle,1930,63,47,16,74.60317460317461,25.396825396825395,Unisex
Starr,1931,7,7,0,100.0,0.0,Female
Metha,1931,6,6,0,100.0,0.0,Female
Gilda,1931,179,179,0,100.0,0.0,Female
Lucy,1931,1844,1827,17,99.07809110629069,0.9219088937093276,Female
Dreama,1931,6,6,0,100.0,0.0,Female
Hope,1931,201,193,8,96.01990049751244,3.9800995024875614,Female
Kristine,1931,7,7,0,100.0,0.0,Female
Hubbard,1931,12,0,12,0.0,100.0,Male
Creighton,1931,29,0,29,0.0,100.0,Male
Bowman,1931,5,0,5,0.0,100.0,Male
Malcolm,1931,589,5,584,0.8488964346349746,99.15110356536503,Male
Cornie,1931,9,0,9,0.0,100.0,Male
Ewin,1931,7,0,7,0.0,100.0,Male
Sylvio,1931,9,0,9,0.0,100.0,Male
Aniceto,1931,12,0,12,0.0,100.0,Male
Adalberto,1931,17,0,17,0.0,100.0,Male
Timmie,1931,14,6,8,42.85714285714285,57.14285714285714,Unisex
Jene,1931,25,8,17,32.0,68.0,Unisex
Maryland,1931,27,17,10,62.96296296296296,37.03703703703704,Unisex
Carmen,1931,1180,934,246,79.15254237288136,20.847457627118644,Unisex
Gerry,1931,205,139,66,67.8048780487805,32.19512195121951,Unisex
Larue,1931,127,102,25,80.31496062992126,19.68503937007874,Unisex
Dorris,1931,221,178,43,80.54298642533936,19.457013574660635,Unisex
Guadalupe,1931,664,348,316,52.40963855421686,47.59036144578313,Unisex
Alison,1931,27,21,6,77.77777777777779,22.22222222222222,Unisex
Marvell,1931,13,6,7,46.15384615384615,53.84615384615385,Unisex
Levern,1931,27,8,19,29.629629629629623,70.37037037037037,Unisex
Audie,1931,42,28,14,66.66666666666666,33.33333333333333,Unisex
Luverne,1931,62,21,41,33.87096774193548,66.12903225806451,Unisex
Othel,1931,22,6,16,27.27272727272727,72.72727272727273,Unisex
Algie,1931,26,8,18,30.76923076923077,69.23076923076923,Unisex
Orva,1931,20,15,5,75.0,25.0,Unisex
Freddie,1931,1011,206,805,20.375865479723046,79.62413452027695,Unisex
Arvis,1931,23,5,18,21.73913043478261,78.26086956521739,Unisex
Paris,1931,35,7,28,20.0,80.0,Unisex
Vernell,1931,199,166,33,83.41708542713567,16.582914572864322,Unisex
Ossie,1931,85,56,29,65.88235294117646,34.11764705882353,Unisex
Stacy,1931,42,12,30,28.57142857142857,71.42857142857143,Unisex
Deane,1931,76,18,58,23.684210526315788,76.31578947368422,Unisex
Rozell,1931,15,10,5,66.66666666666666,33.33333333333333,Unisex
Bernie,1931,137,24,113,17.51824817518248,82.48175182481752,Unisex
Lyn,1931,35,26,9,74.28571428571429,25.71428571428571,Unisex
Senaida,1932,8,8,0,100.0,0.0,Female
Darleen,1932,109,109,0,100.0,0.0,Female
Maretta,1932,11,11,0,100.0,0.0,Female
Francena,1932,15,15,0,100.0,0.0,Female
Pansy,1932,210,210,0,100.0,0.0,Female
Brigid,1932,7,7,0,100.0,0.0,Female
Marijo,1932,9,9,0,100.0,0.0,Female
Auda,1932,5,5,0,100.0,0.0,Female
Alayne,1932,5,5,0,100.0,0.0,Female
Cloa,1932,6,6,0,100.0,0.0,Female
Delaney,1932,6,0,6,0.0,100.0,Male
Rual,1932,5,0,5,0.0,100.0,Male
Francisco,1932,349,8,341,2.292263610315186,97.7077363896848,Male
Nicola,1932,10,0,10,0.0,100.0,Male
Dick,1932,1053,0,1053,0.0,100.0,Male
Zachary,1932,17,0,17,0.0,100.0,Male
Lehman,1932,27,0,27,0.0,100.0,Male
Elroy,1932,123,0,123,0.0,100.0,Male
Jones,1932,24,0,24,0.0,100.0,Male
Clinton,1932,705,5,700,0.7092198581560284,99.29078014184395,Male
Dempsey,1932,40,0,40,0.0,100.0,Male
Glenwood,1932,48,0,48,0.0,100.0,Male
Thermon,1932,17,0,17,0.0,100.0,Male
Andy,1932,217,0,217,0.0,100.0,Male
Freddy,1932,125,0,125,0.0,100.0,Male
Reyes,1932,54,17,37,31.48148148148148,68.51851851851852,Unisex
Cledith,1932,15,8,7,53.333333333333336,46.66666666666666,Unisex
Romie,1932,30,10,20,33.33333333333333,66.66666666666666,Unisex
Tomie,1932,29,8,21,27.58620689655172,72.41379310344827,Unisex
Ladell,1932,20,11,9,55.00000000000001,45.0,Unisex
Karol,1932,30,20,10,66.66666666666666,33.33333333333333,Unisex
Larue,1932,136,109,27,80.14705882352942,19.852941176470587,Unisex
Shelly,1932,40,17,23,42.5,57.49999999999999,Unisex
Climmie,1932,21,15,6,71.42857142857143,28.57142857142857,Unisex
Valery,1932,12,7,5,58.333333333333336,41.66666666666667,Unisex
Sammie,1932,482,135,347,28.00829875518672,71.99170124481327,Unisex
Marlen,1932,18,6,12,33.33333333333333,66.66666666666666,Unisex
Theo,1932,117,41,76,35.04273504273504,64.95726495726495,Unisex
Mannie,1932,32,15,17,46.875,53.125,Unisex
Alvia,1932,19,8,11,42.10526315789473,57.89473684210527,Unisex
Doyne,1932,17,5,12,29.411764705882355,70.58823529411765,Unisex
Bee,1932,11,6,5,54.54545454545454,45.45454545454545,Unisex
Bernis,1932,18,7,11,38.88888888888889,61.11111111111112,Unisex
Garnet,1932,128,101,27,78.90625,21.09375,Unisex
Page,1932,30,8,22,26.666666666666668,73.33333333333333,Unisex
Marlyn,1932,212,134,78,63.20754716981132,36.79245283018868,Unisex
Lavaughn,1932,27,19,8,70.37037037037037,29.629629629629623,Unisex
Carlee,1932,30,19,11,63.33333333333333,36.66666666666666,Unisex
Gennie,1932,31,26,5,83.87096774193549,16.129032258064516,Unisex
Starr,1932,17,12,5,70.58823529411765,29.411764705882355,Unisex
Ardell,1932,109,63,46,57.798165137614674,42.201834862385326,Unisex
Ardis,1933,184,167,17,90.7608695652174,9.239130434782608,Female
Thalia,1933,37,37,0,100.0,0.0,Female
Annemarie,1933,20,20,0,100.0,0.0,Female
Marge,1933,52,52,0,100.0,0.0,Female
Dorothie,1933,9,9,0,100.0,0.0,Female
Nettie,1933,543,543,0,100.0,0.0,Female
Delfino,1933,11,0,11,0.0,100.0,Male
Manly,1933,9,0,9,0.0,100.0,Male
Lyndal,1933,7,0,7,0.0,100.0,Male
Crayton,1933,6,0,6,0.0,100.0,Male
Acie,1933,34,0,34,0.0,100.0,Male
Bennett,1933,110,0,110,0.0,100.0,Male
Obbie,1933,6,0,6,0.0,100.0,Male
Victory,1933,6,0,6,0.0,100.0,Male
Bueford,1933,8,0,8,0.0,100.0,Male
Patrick,1933,1584,11,1573,0.6944444444444444,99.30555555555556,Male
Quinten,1933,6,0,6,0.0,100.0,Male
Walker,1933,66,0,66,0.0,100.0,Male
Alexander,1933,659,0,659,0.0,100.0,Male
Tandy,1933,5,0,5,0.0,100.0,Male
Andreas,1933,5,0,5,0.0,100.0,Male
Woodard,1933,9,0,9,0.0,100.0,Male
Verlyn,1933,52,10,42,19.23076923076924,80.76923076923077,Unisex
Loris,1933,39,28,11,71.7948717948718,28.205128205128204,Unisex
Jacque,1933,49,31,18,63.26530612244898,36.734693877551024,Unisex
Allison,1933,55,15,40,27.27272727272727,72.72727272727273,Unisex
Arley,1933,50,8,42,16.0,84.0,Unisex
Carmon,1933,25,6,19,24.0,76.0,Unisex
Val,1933,85,18,67,21.176470588235293,78.82352941176471,Unisex
Lennis,1933,27,10,17,37.03703703703704,62.96296296296296,Unisex
Ova,1933,37,21,16,56.75675675675676,43.24324324324324,Unisex
Rolla,1933,28,5,23,17.857142857142858,82.14285714285714,Unisex
Rickie,1933,11,6,5,54.54545454545454,45.45454545454545,Unisex
Gale,1933,253,40,213,15.810276679841898,84.18972332015811,Unisex
Glennis,1933,41,30,11,73.17073170731707,26.82926829268293,Unisex
Gennie,1933,42,35,7,83.33333333333334,16.666666666666664,Unisex
Myrle,1933,60,43,17,71.66666666666667,28.33333333333333,Unisex
Lattie,1933,12,7,5,58.333333333333336,41.66666666666667,Unisex
Cloyce,1933,27,5,22,18.51851851851852,81.48148148148148,Unisex
Lupe,1933,489,376,113,76.89161554192229,23.108384458077712,Unisex
Maryland,1933,25,19,6,76.0,24.0,Unisex
Pernell,1933,25,14,11,56.00000000000001,44.0,Unisex
Cruz,1933,102,38,64,37.25490196078432,62.74509803921568,Unisex
Curley,1933,36,8,28,22.22222222222222,77.77777777777779,Unisex
Montie,1933,38,13,25,34.21052631578947,65.78947368421053,Unisex
Lindy,1933,25,7,18,28.000000000000004,72.0,Unisex
Glennie,1933,37,29,8,78.37837837837837,21.62162162162162,Unisex
Arliss,1933,68,44,24,64.70588235294117,35.294117647058826,Unisex
Equilla,1934,5,5,0,100.0,0.0,Female
Roma,1934,151,139,12,92.05298013245032,7.947019867549669,Female
Jannet,1934,10,10,0,100.0,0.0,Female
Roxie,1934,196,196,0,100.0,0.0,Female
Loye,1934,6,6,0,100.0,0.0,Female
Charletta,1934,6,6,0,100.0,0.0,Female
Lander,1934,8,0,8,0.0,100.0,Male
Adrian,1934,232,28,204,12.06896551724138,87.93103448275862,Male
Bennett,1934,109,0,109,0.0,100.0,Male
Olden,1934,9,0,9,0.0,100.0,Male
Rondel,1934,12,0,12,0.0,100.0,Male
Theadore,1934,72,0,72,0.0,100.0,Male
Rudie,1934,6,0,6,0.0,100.0,Male
Linn,1934,11,0,11,0.0,100.0,Male
Marvin,1934,4237,20,4217,0.4720320981826764,99.52796790181732,Male
Alto,1934,10,0,10,0.0,100.0,Male
Edmund,1934,600,0,600,0.0,100.0,Male
Darby,1934,10,0,10,0.0,100.0,Male
Kerwin,1934,5,0,5,0.0,100.0,Male
Jerry,1934,7515,382,7133,5.083166999334663,94.91683300066532,Male
Ottie,1934,21,13,8,61.90476190476191,38.095238095238095,Unisex
Drue,1934,13,6,7,46.15384615384615,53.84615384615385,Unisex
Ivy,1934,108,76,32,70.37037037037037,29.629629629629623,Unisex
Marcell,1934,21,11,10,52.38095238095239,47.61904761904761,Unisex
Laney,1934,13,7,6,53.84615384615385,46.15384615384615,Unisex
Robbie,1934,360,301,59,83.61111111111111,16.38888888888889,Unisex
Larrie,1934,26,5,21,19.23076923076924,80.76923076923077,Unisex
Lavern,1934,353,105,248,29.745042492917843,70.25495750708215,Unisex
Matilde,1934,47,35,12,74.46808510638297,25.53191489361702,Unisex
Audie,1934,29,8,21,27.58620689655172,72.41379310344827,Unisex
Montie,1934,40,15,25,37.5,62.5,Unisex
Texas,1934,14,7,7,50.0,50.0,Unisex
Onie,1934,22,17,5,77.27272727272727,22.727272727272727,Unisex
Brooke,1934,17,7,10,41.17647058823529,58.82352941176471,Unisex
Jaye,1934,15,9,6,60.0,40.0,Unisex
Elba,1934,41,29,12,70.73170731707317,29.268292682926827,Unisex
Delaine,1934,41,25,16,60.97560975609756,39.02439024390244,Unisex
Dorris,1934,196,153,43,78.06122448979592,21.93877551020408,Unisex
Climmie,1934,15,8,7,53.333333333333336,46.66666666666666,Unisex
Elvie,1934,34,28,6,82.35294117647058,17.647058823529413,Unisex
Cleo,1934,654,448,206,68.50152905198776,31.49847094801223,Unisex
Lyn,1934,46,28,18,60.86956521739131,39.130434782608695,Unisex
Roxy,1934,23,15,8,65.21739130434783,34.78260869565217,Unisex
Del,1934,42,10,32,23.809523809523807,76.19047619047619,Unisex
Orlean,1935,9,9,0,100.0,0.0,Female
Jonell,1935,44,44,0,100.0,0.0,Female
Corabelle,1935,5,5,0,100.0,0.0,Female
Catalina,1935,55,55,0,100.0,0.0,Female
Donie,1935,7,7,0,100.0,0.0,Female
Mella,1935,10,10,0,100.0,0.0,Female
Marigold,1935,6,6,0,100.0,0.0,Female
Georgean,1935,5,5,0,100.0,0.0,Female
Oliver,1935,655,9,646,1.3740458015267176,98.62595419847328,Male
Rondel,1935,7,0,7,0.0,100.0,Male
Dusty,1935,5,0,5,0.0,100.0,Male
Lacy,1935,117,17,100,14.529914529914532,85.47008547008546,Male
Alto,1935,11,0,11,0.0,100.0,Male
Sherrel,1935,12,0,12,0.0,100.0,Male
Melvyn,1935,90,0,90,0.0,100.0,Male
Lamont,1935,23,0,23,0.0,100.0,Male
Merwyn,1935,28,0,28,0.0,100.0,Male
Gorden,1935,56,0,56,0.0,100.0,Male
Doyle,1935,635,6,629,0.9448818897637796,99.05511811023622,Male
Edd,1935,84,0,84,0.0,100.0,Male
Brownie,1935,25,10,15,40.0,60.0,Unisex
Lovell,1935,50,16,34,32.0,68.0,Unisex
Verle,1935,52,8,44,15.384615384615383,84.61538461538461,Unisex
Lesley,1935,65,28,37,43.07692307692308,56.92307692307692,Unisex
Lugene,1935,16,9,7,56.25,43.75,Unisex
Sammie,1935,458,125,333,27.292576419213976,72.70742358078603,Unisex
Binnie,1935,24,17,7,70.83333333333334,29.166666666666668,Unisex
Ivey,1935,31,11,20,35.483870967741936,64.51612903225806,Unisex
Jacque,1935,52,43,9,82.6923076923077,17.307692307692307,Unisex
Otha,1935,111,22,89,19.81981981981982,80.18018018018019,Unisex
Love,1935,15,6,9,40.0,60.0,Unisex
Myrl,1935,45,19,26,42.22222222222222,57.77777777777777,Unisex
Lennie,1935,70,47,23,67.14285714285714,32.857142857142854,Unisex
Encarnacion,1935,13,5,8,38.46153846153847,61.53846153846154,Unisex
Ladell,1935,13,7,6,53.84615384615385,46.15384615384615,Unisex
Athel,1935,12,5,7,41.66666666666667,58.333333333333336,Unisex
Lavone,1935,27,21,6,77.77777777777779,22.22222222222222,Unisex
Cleo,1935,593,426,167,71.8381112984823,28.161888701517707,Unisex
Bonny,1935,32,26,6,81.25,18.75,Unisex
Leverne,1935,16,7,9,43.75,56.25,Unisex
Orva,1935,16,11,5,68.75,31.25,Unisex
Pernell,1935,17,7,10,41.17647058823529,58.82352941176471,Unisex
Verlyn,1935,61,17,44,27.86885245901639,72.1311475409836,Unisex
Henri,1935,34,10,24,29.411764705882355,70.58823529411765,Unisex
Lavelle,1935,41,32,9,78.04878048780488,21.951219512195124,Unisex
Marrion,1935,16,10,6,62.5,37.5,Unisex
Deane,1935,61,16,45,26.229508196721312,73.77049180327869,Unisex
Morna,1936,7,7,0,100.0,0.0,Female
Ophelia,1936,171,171,0,100.0,0.0,Female
Rachel,1936,1224,1207,17,98.61111111111111,1.3888888888888888,Female
Evelyne,1936,37,37,0,100.0,0.0,Female
Vera,1936,1517,1511,6,99.6044825313118,0.3955174686882004,Female
Ivie,1936,9,9,0,100.0,0.0,Female
Meryle,1936,5,5,0,100.0,0.0,Female
Milly,1936,6,6,0,100.0,0.0,Female
Darleen,1936,112,112,0,100.0,0.0,Female
Leontine,1936,12,12,0,100.0,0.0,Female
Talbert,1936,12,0,12,0.0,100.0,Male
Junius,1936,54,0,54,0.0,100.0,Male
Len,1936,32,0,32,0.0,100.0,Male
Allyn,1936,43,5,38,11.627906976744184,88.37209302325581,Male
Camilo,1936,14,0,14,0.0,100.0,Male
Enos,1936,37,0,37,0.0,100.0,Male
Marsh,1936,5,0,5,0.0,100.0,Male
Hilbert,1936,33,0,33,0.0,100.0,Male
Cory,1936,5,0,5,0.0,100.0,Male
Rodolfo,1936,131,0,131,0.0,100.0,Male
Ventura,1936,5,0,5,0.0,100.0,Male
Duval,1936,7,0,7,0.0,100.0,Male
Ronaldo,1936,5,0,5,0.0,100.0,Male
Ettore,1936,6,0,6,0.0,100.0,Male
Rayfield,1936,22,0,22,0.0,100.0,Male
Curlee,1936,7,0,7,0.0,100.0,Male
Merwyn,1936,31,0,31,0.0,100.0,Male
Claudie,1936,108,41,67,37.96296296296296,62.03703703703704,Unisex
Maxie,1936,175,63,112,36.0,64.0,Unisex
Lynn,1936,998,384,614,38.476953907815634,61.523046092184366,Unisex
Lee,1936,2857,439,2418,15.365768288414422,84.63423171158558,Unisex
Darnell,1936,32,8,24,25.0,75.0,Unisex
Dell,1936,68,28,40,41.17647058823529,58.82352941176471,Unisex
Mozell,1936,60,48,12,80.0,20.0,Unisex
Gale,1936,372,122,250,32.795698924731184,67.20430107526882,Unisex
Del,1936,54,13,41,24.07407407407408,75.92592592592592,Unisex
Whitney,1936,25,6,19,24.0,76.0,Unisex
Argie,1936,26,19,7,73.07692307692307,26.923076923076923,Unisex
Cledith,1936,24,12,12,50.0,50.0,Unisex
Roxy,1936,26,18,8,69.23076923076923,30.76923076923077,Unisex
Ova,1936,16,9,7,56.25,43.75,Unisex
Beryl,1936,175,138,37,78.85714285714286,21.142857142857142,Unisex
Clois,1936,23,7,16,30.434782608695656,69.56521739130434,Unisex
Darby,1936,12,5,7,41.66666666666667,58.333333333333336,Unisex
Myrle,1936,52,42,10,80.76923076923077,19.23076923076924,Unisex
Lyn,1936,42,23,19,54.761904761904766,45.23809523809524,Unisex
Caroll,1936,47,26,21,55.319148936170215,44.680851063829785,Unisex
Elza,1936,35,8,27,22.857142857142858,77.14285714285715,Unisex
Arlee,1936,23,13,10,56.52173913043478,43.47826086956522,Unisex
Dorris,1936,156,118,38,75.64102564102564,24.35897435897436,Unisex
Benita,1937,112,112,0,100.0,0.0,Female
Erline,1937,16,16,0,100.0,0.0,Female
Mimi,1937,52,52,0,100.0,0.0,Female
Morene,1937,11,11,0,100.0,0.0,Female
Lysbeth,1937,11,11,0,100.0,0.0,Female
Brigid,1937,7,7,0,100.0,0.0,Female
Billye,1937,67,67,0,100.0,0.0,Female
Carle,1937,8,0,8,0.0,100.0,Male
Fabian,1937,21,0,21,0.0,100.0,Male
Mackey,1937,10,0,10,0.0,100.0,Male
Foster,1937,102,0,102,0.0,100.0,Male
Dino,1937,30,0,30,0.0,100.0,Male
Ronaldo,1937,8,0,8,0.0,100.0,Male
Arvis,1937,9,0,9,0.0,100.0,Male
Aniceto,1937,7,0,7,0.0,100.0,Male
Augustin,1937,23,0,23,0.0,100.0,Male
Albert,1937,5694,29,5665,0.5093080435546189,99.49069195644536,Male
Jomes,1937,9,0,9,0.0,100.0,Male
Lamont,1937,41,0,41,0.0,100.0,Male
Cresencio,1937,12,0,12,0.0,100.0,Male
Denzel,1937,21,0,21,0.0,100.0,Male
Hartley,1937,21,0,21,0.0,100.0,Male
Scottie,1937,47,17,30,36.17021276595745,63.82978723404256,Unisex
Garnet,1937,129,104,25,80.62015503875969,19.37984496124032,Unisex
Lesley,1937,75,36,39,48.0,52.0,Unisex
Algie,1937,23,5,18,21.73913043478261,78.26086956521739,Unisex
Elvie,1937,51,33,18,64.70588235294117,35.294117647058826,Unisex
Burnice,1937,49,26,23,53.06122448979592,46.93877551020408,Unisex
Binnie,1937,27,20,7,74.07407407407408,25.925925925925924,Unisex
Carlie,1937,33,11,22,33.33333333333333,66.66666666666666,Unisex
Sydney,1937,184,91,93,49.45652173913043,50.54347826086957,Unisex
Oral,1937,30,6,24,20.0,80.0,Unisex
Freddie,1937,1410,245,1165,17.375886524822697,82.62411347517731,Unisex
Bethel,1937,72,47,25,65.27777777777779,34.72222222222222,Unisex
Arnell,1937,22,11,11,50.0,50.0,Unisex
Osie,1937,21,15,6,71.42857142857143,28.57142857142857,Unisex
Donie,1937,13,6,7,46.15384615384615,53.84615384615385,Unisex
Mozell,1937,50,41,9,82.0,18.0,Unisex
Joey,1937,49,11,38,22.448979591836736,77.55102040816327,Unisex
Montie,1937,36,14,22,38.88888888888889,61.11111111111112,Unisex
Avon,1937,38,15,23,39.47368421052632,60.526315789473685,Unisex
Burnette,1937,21,13,8,61.90476190476191,38.095238095238095,Unisex
Tracey,1937,11,5,6,45.45454545454545,54.54545454545454,Unisex
Meredith,1937,205,152,53,74.14634146341463,25.853658536585368,Unisex
Shirl,1937,19,5,14,26.31578947368421,73.68421052631578,Unisex
Marvis,1937,40,28,12,70.0,30.0,Unisex
Vertis,1937,19,7,12,36.84210526315789,63.1578947368421,Unisex
Arrie,1937,27,21,6,77.77777777777779,22.22222222222222,Unisex
Jolly,1937,21,11,10,52.38095238095239,47.61904761904761,Unisex
Genia,1938,6,6,0,100.0,0.0,Female
Catalina,1938,43,43,0,100.0,0.0,Female
Tonie,1938,12,12,0,100.0,0.0,Female
Janita,1938,7,7,0,100.0,0.0,Female
Ila,1938,299,299,0,100.0,0.0,Female
Carolynn,1938,70,70,0,100.0,0.0,Female
Sharyn,1938,24,24,0,100.0,0.0,Female
Seth,1938,65,0,65,0.0,100.0,Male
Ottie,1938,5,0,5,0.0,100.0,Male
Sylvio,1938,13,0,13,0.0,100.0,Male
Gerald,1938,10009,37,9972,0.3696672994305125,99.6303327005695,Male
Hubbard,1938,18,0,18,0.0,100.0,Male
Marice,1938,6,0,6,0.0,100.0,Male
Carvin,1938,5,0,5,0.0,100.0,Male
Perry,1938,598,19,579,3.177257525083612,96.8227424749164,Male
Quinten,1938,6,0,6,0.0,100.0,Male
Eleazar,1938,5,0,5,0.0,100.0,Male
Larson,1938,5,0,5,0.0,100.0,Male
Gorden,1938,43,0,43,0.0,100.0,Male
Wheeler,1938,17,0,17,0.0,100.0,Male
Page,1938,25,9,16,36.0,64.0,Unisex
Delma,1938,162,126,36,77.77777777777779,22.22222222222222,Unisex
Ivey,1938,31,7,24,22.58064516129032,77.41935483870968,Unisex
Temple,1938,20,12,8,60.0,40.0,Unisex
Frankie,1938,897,527,370,58.75139353400223,41.248606465997774,Unisex
Brownie,1938,21,11,10,52.38095238095239,47.61904761904761,Unisex
Afton,1938,24,14,10,58.333333333333336,41.66666666666667,Unisex
Audie,1938,33,15,18,45.45454545454545,54.54545454545454,Unisex
Zollie,1938,16,6,10,37.5,62.5,Unisex
Garnet,1938,110,93,17,84.54545454545455,15.454545454545451,Unisex
Teddie,1938,38,13,25,34.21052631578947,65.78947368421053,Unisex
Matilde,1938,30,21,9,70.0,30.0,Unisex
Carrol,1938,310,140,170,45.16129032258064,54.83870967741935,Unisex
Sunny,1938,44,30,14,68.18181818181817,31.818181818181817,Unisex
Dossie,1938,12,6,6,50.0,50.0,Unisex
Donnis,1938,40,31,9,77.5,22.5,Unisex
Cloyce,1938,30,6,24,20.0,80.0,Unisex
Dannie,1938,128,26,102,20.3125,79.6875,Unisex
Collie,1938,17,9,8,52.94117647058824,47.05882352941176,Unisex
Vinnie,1938,36,30,6,83.33333333333334,16.666666666666664,Unisex
Jolly,1938,14,6,8,42.85714285714285,57.14285714285714,Unisex
Vernie,1938,83,52,31,62.65060240963856,37.34939759036144,Unisex
Deane,1938,51,16,35,31.37254901960784,68.62745098039215,Unisex
Lexie,1938,34,27,7,79.41176470588235,20.588235294117645,Unisex
Catalina,1939,49,49,0,100.0,0.0,Female
Madeline,1939,888,888,0,100.0,0.0,Female
Mildred,1939,4157,4137,20,99.51888381044022,0.4811161895597786,Female
Vada,1939,98,98,0,100.0,0.0,Female
Saralyn,1939,13,13,0,100.0,0.0,Female
Ariel,1939,7,7,0,100.0,0.0,Female
Bethany,1939,29,29,0,100.0,0.0,Female
Micky,1939,10,0,10,0.0,100.0,Male
Hansford,1939,10,0,10,0.0,100.0,Male
Athel,1939,8,0,8,0.0,100.0,Male
Hiram,1939,89,0,89,0.0,100.0,Male
Scott,1939,276,0,276,0.0,100.0,Male
Delwin,1939,31,0,31,0.0,100.0,Male
Rudi,1939,5,0,5,0.0,100.0,Male
Harris,1939,143,0,143,0.0,100.0,Male
Camilo,1939,7,0,7,0.0,100.0,Male
Willey,1939,7,0,7,0.0,100.0,Male
Roye,1939,6,0,6,0.0,100.0,Male
Donnis,1939,33,24,9,72.72727272727273,27.27272727272727,Unisex
Nicola,1939,14,6,8,42.85714285714285,57.14285714285714,Unisex
Shawn,1939,18,7,11,38.88888888888889,61.11111111111112,Unisex
Rennie,1939,23,10,13,43.47826086956522,56.52173913043478,Unisex
Tracy,1939,133,23,110,17.293233082706767,82.70676691729322,Unisex
Audry,1939,65,49,16,75.38461538461539,24.615384615384617,Unisex
Teddie,1939,32,13,19,40.625,59.375,Unisex
Vernie,1939,78,45,33,57.692307692307686,42.30769230769231,Unisex
Sandy,1939,329,260,69,79.0273556231003,20.97264437689969,Unisex
Collie,1939,19,7,12,36.84210526315789,63.1578947368421,Unisex
Audie,1939,36,12,24,33.33333333333333,66.66666666666666,Unisex
Elgie,1939,18,11,7,61.11111111111112,38.88888888888889,Unisex
Jacque,1939,71,54,17,76.05633802816901,23.943661971830984,Unisex
Bonny,1939,50,42,8,84.0,16.0,Unisex
Santos,1939,127,42,85,33.07086614173229,66.92913385826772,Unisex
Darris,1939,19,6,13,31.57894736842105,68.42105263157895,Unisex
Hallie,1939,105,83,22,79.04761904761905,20.95238095238096,Unisex
Lorenza,1939,67,26,41,38.80597014925373,61.19402985074627,Unisex
Myrl,1939,39,11,28,28.205128205128204,71.7948717948718,Unisex
Cary,1939,117,20,97,17.094017094017094,82.90598290598291,Unisex
Lavelle,1939,38,27,11,71.05263157894737,28.94736842105264,Unisex
Lorain,1939,17,11,6,64.70588235294117,35.294117647058826,Unisex
Ladell,1939,12,6,6,50.0,50.0,Unisex
Jonnie,1939,135,83,52,61.48148148148148,38.51851851851852,Unisex
Meryle,1939,14,9,5,64.28571428571429,35.714285714285715,Unisex
Robin,1939,297,131,166,44.1077441077441,55.892255892255896,Unisex
Larue,1939,92,74,18,80.43478260869566,19.565217391304348,Unisex
Sevilla,1940,5,5,0,100.0,0.0,Female
Cinderella,1940,9,9,0,100.0,0.0,Female
Ricki,1940,7,7,0,100.0,0.0,Female
Joline,1940,14,14,0,100.0,0.0,Female
Eliza,1940,148,148,0,100.0,0.0,Female
San,1940,6,6,0,100.0,0.0,Female
Shella,1940,11,11,0,100.0,0.0,Female
Morene,1940,8,8,0,100.0,0.0,Female
Blondie,1940,12,12,0,100.0,0.0,Female
Alvah,1940,17,0,17,0.0,100.0,Male
Bennett,1940,99,0,99,0.0,100.0,Male
Gerome,1940,14,0,14,0.0,100.0,Male
Thermon,1940,15,0,15,0.0,100.0,Male
Saint,1940,7,0,7,0.0,100.0,Male
Buell,1940,12,0,12,0.0,100.0,Male
Alwin,1940,10,0,10,0.0,100.0,Male
Manly,1940,17,0,17,0.0,100.0,Male
Saunders,1940,6,0,6,0.0,100.0,Male
Wadie,1940,13,7,6,53.84615384615385,46.15384615384615,Unisex
Ivory,1940,130,50,80,38.46153846153847,61.53846153846154,Unisex
Raye,1940,29,22,7,75.86206896551724,24.13793103448276,Unisex
Arlee,1940,18,9,9,50.0,50.0,Unisex
Caroll,1940,65,42,23,64.61538461538461,35.38461538461539,Unisex
Ivy,1940,88,66,22,75.0,25.0,Unisex
Maryland,1940,19,12,7,63.1578947368421,36.84210526315789,Unisex
Jerre,1940,49,29,20,59.18367346938776,40.81632653061224,Unisex
Dayle,1940,46,29,17,63.04347826086957,36.95652173913043,Unisex
Afton,1940,23,13,10,56.52173913043478,43.47826086956522,Unisex
Marlowe,1940,20,5,15,25.0,75.0,Unisex
Ollie,1940,621,423,198,68.11594202898551,31.88405797101449,Unisex
Hilary,1940,41,12,29,29.268292682926827,70.73170731707317,Unisex
Lyn,1940,86,59,27,68.6046511627907,31.3953488372093,Unisex
Marion,1940,3160,2111,1049,66.80379746835443,33.19620253164557,Unisex
Cledith,1940,16,5,11,31.25,68.75,Unisex
Teddie,1940,49,16,33,32.6530612244898,67.3469387755102,Unisex
Meredith,1940,254,172,82,67.71653543307087,32.28346456692913,Unisex
Johnie,1940,276,46,230,16.666666666666664,83.33333333333334,Unisex
Lyndell,1940,43,11,32,25.58139534883721,74.4186046511628,Unisex
Bobie,1940,18,7,11,38.88888888888889,61.11111111111112,Unisex
Audry,1940,49,38,11,77.55102040816327,22.448979591836736,Unisex
Carley,1940,26,12,14,46.15384615384615,53.84615384615385,Unisex
Ova,1940,17,5,12,29.411764705882355,70.58823529411765,Unisex
Arvis,1940,27,13,14,48.14814814814815,51.85185185185185,Unisex
Verlie,1940,30,24,6,80.0,20.0,Unisex
Little,1940,21,6,15,28.57142857142857,71.42857142857143,Unisex
Fern,1941,306,301,5,98.36601307189542,1.6339869281045754,Female
Cinda,1941,39,39,0,100.0,0.0,Female
Evlyn,1941,7,7,0,100.0,0.0,Female
Vanita,1941,19,19,0,100.0,0.0,Female
Juanita,1941,3070,3044,26,99.15309446254072,0.8469055374592834,Female
Charla,1941,37,37,0,100.0,0.0,Female
Lorell,1941,6,6,0,100.0,0.0,Female
Joan,1941,13456,13381,75,99.44262782401904,0.557372175980975,Female
Normajean,1941,11,11,0,100.0,0.0,Female
Jannet,1941,7,7,0,100.0,0.0,Female
Gracy,1941,9,9,0,100.0,0.0,Female
Monroe,1941,182,0,182,0.0,100.0,Male
Lonnie,1941,1301,98,1203,7.532667179093005,92.467332820907,Male
Lane,1941,77,7,70,9.090909090909092,90.9090909090909,Male
Randle,1941,40,0,40,0.0,100.0,Male
Kent,1941,676,0,676,0.0,100.0,Male
Emile,1941,84,0,84,0.0,100.0,Male
Bertis,1941,9,0,9,0.0,100.0,Male
Leston,1941,8,0,8,0.0,100.0,Male
Geary,1941,26,0,26,0.0,100.0,Male
Barney,1941,178,0,178,0.0,100.0,Male
Britton,1941,6,0,6,0.0,100.0,Male
Kenyon,1941,12,0,12,0.0,100.0,Male
Pierre,1941,70,0,70,0.0,100.0,Male
Gustave,1941,29,0,29,0.0,100.0,Male
Rondel,1941,6,0,6,0.0,100.0,Male
Clair,1941,194,29,165,14.948453608247425,85.05154639175258,Male
Ozell,1941,37,16,21,43.24324324324324,56.75675675675676,Unisex
Ivy,1941,107,69,38,64.48598130841121,35.51401869158878,Unisex
Dana,1941,426,282,144,66.19718309859155,33.80281690140845,Unisex
Ferrell,1941,45,8,37,17.77777777777778,82.22222222222221,Unisex
Hilary,1941,50,24,26,48.0,52.0,Unisex
Glendell,1941,22,8,14,36.36363636363637,63.63636363636363,Unisex
Llewellyn,1941,48,8,40,16.666666666666664,83.33333333333334,Unisex
Dorian,1941,19,5,14,26.31578947368421,73.68421052631578,Unisex
Gale,1941,626,339,287,54.153354632587856,45.846645367412144,Unisex
Lynell,1941,16,8,8,50.0,50.0,Unisex
Nollie,1941,12,6,6,50.0,50.0,Unisex
Hollie,1941,28,11,17,39.285714285714285,60.71428571428571,Unisex
Vernell,1941,162,115,47,70.98765432098766,29.01234567901235,Unisex
Conny,1941,14,7,7,50.0,50.0,Unisex
Loye,1941,21,6,15,28.57142857142857,71.42857142857143,Unisex
Lindsay,1941,46,9,37,19.565217391304348,80.43478260869566,Unisex
Jule,1941,36,17,19,47.22222222222222,52.77777777777778,Unisex
Carlin,1941,17,5,12,29.411764705882355,70.58823529411765,Unisex
Christy,1941,63,38,25,60.31746031746032,39.68253968253968,Unisex
Willie,1941,8389,1860,6529,22.171891763023005,77.82810823697699,Unisex
Vernie,1941,62,33,29,53.2258064516129,46.774193548387096,Unisex
Robbin,1941,19,9,10,47.368421052631575,52.63157894736842,Unisex
Ardell,1941,66,36,30,54.54545454545454,45.45454545454545,Unisex
Sheridan,1941,83,31,52,37.34939759036144,62.65060240963856,Unisex
Lindy,1941,34,17,17,50.0,50.0,Unisex
Willia,1942,87,77,10,88.50574712643679,11.494252873563218,Female
Kathern,1942,46,46,0,100.0,0.0,Female
Eliza,1942,156,151,5,96.7948717948718,3.205128205128205,Female
Pamala,1942,37,37,0,100.0,0.0,Female
Luanna,1942,18,18,0,100.0,0.0,Female
Greta,1942,135,135,0,100.0,0.0,Female
Bruna,1942,6,6,0,100.0,0.0,Female
Elizabeth,1942,11237,11185,52,99.5372430363976,0.4627569636023849,Female
Juleen,1942,7,7,0,100.0,0.0,Female
Jodee,1942,6,6,0,100.0,0.0,Female
Emmet,1942,40,0,40,0.0,100.0,Male
Fortunato,1942,10,0,10,0.0,100.0,Male
Rollie,1942,63,6,57,9.523809523809524,90.47619047619048,Male
Andy,1942,329,6,323,1.82370820668693,98.17629179331308,Male
Faris,1942,5,0,5,0.0,100.0,Male
Danial,1942,59,0,59,0.0,100.0,Male
Alfredo,1942,198,0,198,0.0,100.0,Male
Joffre,1942,5,0,5,0.0,100.0,Male
Rochester,1942,14,0,14,0.0,100.0,Male
Doug,1942,229,0,229,0.0,100.0,Male
Jimmie,1942,3068,528,2540,17.209908735332462,82.79009126466754,Unisex
Ozell,1942,34,9,25,26.47058823529412,73.52941176470588,Unisex
Jodie,1942,59,25,34,42.3728813559322,57.6271186440678,Unisex
Whitney,1942,53,11,42,20.75471698113208,79.24528301886792,Unisex
Hallie,1942,90,74,16,82.22222222222221,17.77777777777778,Unisex
Jessie,1942,2394,1391,1003,58.10359231411864,41.89640768588137,Unisex
Tomie,1942,19,9,10,47.368421052631575,52.63157894736842,Unisex
Darby,1942,27,18,9,66.66666666666666,33.33333333333333,Unisex
Luverne,1942,25,12,13,48.0,52.0,Unisex
Merlyn,1942,102,27,75,26.47058823529412,73.52941176470588,Unisex
Carrol,1942,267,140,127,52.43445692883895,47.565543071161045,Unisex
Johnnie,1942,2627,1069,1558,40.692805481537874,59.307194518462126,Unisex
Arie,1942,22,12,10,54.54545454545454,45.45454545454545,Unisex
Ozie,1942,12,6,6,50.0,50.0,Unisex
Rea,1942,24,17,7,70.83333333333334,29.166666666666668,Unisex
Lindy,1942,34,22,12,64.70588235294117,35.294117647058826,Unisex
Onie,1942,20,14,6,70.0,30.0,Unisex
Lavaughn,1942,21,15,6,71.42857142857143,28.57142857142857,Unisex
Noel,1942,462,94,368,20.346320346320347,79.65367965367966,Unisex
Lyndal,1942,17,6,11,35.294117647058826,64.70588235294117,Unisex
Bethel,1942,46,38,8,82.6086956521739,17.391304347826086,Unisex
Cameron,1942,65,14,51,21.53846153846154,78.46153846153847,Unisex
Carlee,1942,13,8,5,61.53846153846154,38.46153846153847,Unisex
Rickie,1942,22,6,16,27.27272727272727,72.72727272727273,Unisex
Curley,1942,52,11,41,21.15384615384616,78.84615384615384,Unisex
Roye,1942,10,5,5,50.0,50.0,Unisex
Ossie,1942,66,42,24,63.63636363636363,36.36363636363637,Unisex
Lannie,1942,61,18,43,29.508196721311474,70.49180327868852,Unisex
Lennis,1942,26,5,21,19.23076923076924,80.76923076923077,Unisex
Sari,1943,18,18,0,100.0,0.0,Female
Beth,1943,785,785,0,100.0,0.0,Female
Shirlee,1943,119,119,0,100.0,0.0,Female
Imo,1943,12,12,0,100.0,0.0,Female
Sudie,1943,32,32,0,100.0,0.0,Female
Maxcine,1943,34,34,0,100.0,0.0,Female
Collette,1943,44,44,0,100.0,0.0,Female
Sharyn,1943,131,131,0,100.0,0.0,Female
Rony,1943,5,0,5,0.0,100.0,Male
Marcello,1943,7,0,7,0.0,100.0,Male
Oakley,1943,22,0,22,0.0,100.0,Male
Terrel,1943,19,0,19,0.0,100.0,Male
Haven,1943,13,0,13,0.0,100.0,Male
Alfredo,1943,226,0,226,0.0,100.0,Male
Marcial,1943,9,0,9,0.0,100.0,Male
Burnice,1943,34,17,17,50.0,50.0,Unisex
Lindley,1943,11,5,6,45.45454545454545,54.54545454545454,Unisex
Temple,1943,19,9,10,47.368421052631575,52.63157894736842,Unisex
Mickie,1943,71,59,12,83.09859154929578,16.901408450704224,Unisex
Lyn,1943,133,104,29,78.19548872180451,21.804511278195488,Unisex
Kerry,1943,298,87,211,29.194630872483224,70.80536912751678,Unisex
Lovell,1943,39,7,32,17.94871794871795,82.05128205128204,Unisex
Teryl,1943,12,5,7,41.66666666666667,58.333333333333336,Unisex
Ardie,1943,26,12,14,46.15384615384615,53.84615384615385,Unisex
Avon,1943,24,10,14,41.66666666666667,58.333333333333336,Unisex
Clemmie,1943,42,26,16,61.90476190476191,38.095238095238095,Unisex
Meryl,1943,44,31,13,70.45454545454545,29.545454545454547,Unisex
Gale,1943,728,425,303,58.37912087912088,41.62087912087912,Unisex
Darby,1943,26,18,8,69.23076923076923,30.76923076923077,Unisex
Leotha,1943,13,7,6,53.84615384615385,46.15384615384615,Unisex
Alva,1943,245,97,148,39.59183673469388,60.40816326530612,Unisex
Shawn,1943,39,12,27,30.76923076923077,69.23076923076923,Unisex
Audie,1943,27,19,8,70.37037037037037,29.629629629629623,Unisex
Marlo,1943,30,14,16,46.66666666666666,53.333333333333336,Unisex
Kyle,1943,143,22,121,15.384615384615383,84.61538461538461,Unisex
Foy,1943,49,9,40,18.367346938775512,81.63265306122449,Unisex
Daryle,1943,36,7,29,19.444444444444446,80.55555555555556,Unisex
Orie,1943,20,5,15,25.0,75.0,Unisex
Myrl,1943,40,19,21,47.5,52.5,Unisex
Arliss,1943,29,20,9,68.96551724137932,31.03448275862069,Unisex
Nieves,1943,13,6,7,46.15384615384615,53.84615384615385,Unisex
Cleotha,1943,23,5,18,21.73913043478261,78.26086956521739,Unisex
Lyndell,1943,51,22,29,43.13725490196079,56.86274509803921,Unisex
Carnell,1943,35,7,28,20.0,80.0,Unisex
Verlie,1944,22,22,0,100.0,0.0,Female
Thelma,1944,2010,1996,14,99.30348258706468,0.6965174129353234,Female
Bethany,1944,34,34,0,100.0,0.0,Female
Laveda,1944,13,13,0,100.0,0.0,Female
Charla,1944,120,120,0,100.0,0.0,Female
Annita,1944,28,28,0,100.0,0.0,Female
Danna,1944,87,87,0,100.0,0.0,Female
Harryette,1944,6,6,0,100.0,0.0,Female
Annice,1944,31,31,0,100.0,0.0,Female
Steven,1944,5122,10,5112,0.1952362358453729,99.80476376415464,Male
Kenneth,1944,18143,49,18094,0.2700766135699719,99.72992338643004,Male
Corry,1944,5,0,5,0.0,100.0,Male
Marvin,1944,3594,25,3569,0.6956037840845853,99.30439621591542,Male
Haywood,1944,82,0,82,0.0,100.0,Male
Rumaldo,1944,10,0,10,0.0,100.0,Male
Quinten,1944,5,0,5,0.0,100.0,Male
Adalberto,1944,11,0,11,0.0,100.0,Male
Sidney,1944,986,85,901,8.620689655172415,91.3793103448276,Male
Ernie,1944,285,8,277,2.807017543859649,97.19298245614036,Male
Horace,1944,649,0,649,0.0,100.0,Male
Coye,1944,8,0,8,0.0,100.0,Male
Hale,1944,10,0,10,0.0,100.0,Male
Dawson,1944,28,0,28,0.0,100.0,Male
Cameron,1944,61,12,49,19.672131147540984,80.32786885245902,Unisex
Lennis,1944,29,11,18,37.93103448275862,62.06896551724138,Unisex
Jene,1944,18,8,10,44.44444444444444,55.55555555555556,Unisex
Unknown,1944,87,60,27,68.96551724137932,31.03448275862069,Unisex
Marvis,1944,39,27,12,69.23076923076923,30.76923076923077,Unisex
Valentine,1944,69,18,51,26.08695652173913,73.91304347826086,Unisex
Elvie,1944,31,17,14,54.83870967741935,45.16129032258064,Unisex
Jerre,1944,49,30,19,61.224489795918366,38.775510204081634,Unisex
Onnie,1944,23,16,7,69.56521739130434,30.434782608695656,Unisex
Jodie,1944,55,31,24,56.36363636363636,43.63636363636363,Unisex
Vertis,1944,18,12,6,66.66666666666666,33.33333333333333,Unisex
Earnie,1944,35,10,25,28.57142857142857,71.42857142857143,Unisex
Timmie,1944,24,8,16,33.33333333333333,66.66666666666666,Unisex
Delaine,1944,38,32,6,84.21052631578947,15.789473684210526,Unisex
Loy,1944,62,14,48,22.58064516129032,77.41935483870968,Unisex
Rolla,1944,27,7,20,25.925925925925924,74.07407407407408,Unisex
Leslie,1944,3173,1202,1971,37.88213047589032,62.11786952410967,Unisex
Nicky,1944,110,17,93,15.454545454545451,84.54545454545455,Unisex
Lavelle,1944,20,12,8,60.0,40.0,Unisex
Lacy,1944,115,26,89,22.60869565217392,77.39130434782608,Unisex
Jude,1944,35,8,27,22.857142857142858,77.14285714285715,Unisex
Aris,1944,14,6,8,42.85714285714285,57.14285714285714,Unisex
Charle,1944,18,6,12,33.33333333333333,66.66666666666666,Unisex
Bernis,1944,13,6,7,46.15384615384615,53.84615384615385,Unisex
Hollie,1944,47,26,21,55.319148936170215,44.680851063829785,Unisex
Ova,1944,19,6,13,31.57894736842105,68.42105263157895,Unisex
Maryland,1944,28,20,8,71.42857142857143,28.57142857142857,Unisex
Kary,1944,20,6,14,30.0,70.0,Unisex
Zoe,1945,45,45,0,100.0,0.0,Female
Dorothie,1945,6,6,0,100.0,0.0,Female
Elva,1945,245,239,6,97.55102040816328,2.4489795918367347,Female
Dessie,1945,93,86,7,92.47311827956987,7.526881720430108,Female
India,1945,21,21,0,100.0,0.0,Female
Sari,1945,13,13,0,100.0,0.0,Female
Milagros,1945,16,16,0,100.0,0.0,Female
Era,1945,38,38,0,100.0,0.0,Female
Aubry,1945,19,0,19,0.0,100.0,Male
Jess,1945,167,0,167,0.0,100.0,Male
Obie,1945,58,8,50,13.79310344827586,86.20689655172413,Male
Keith,1945,2171,7,2164,0.322432058959005,99.677567941041,Male
Cephus,1945,12,0,12,0.0,100.0,Male
Gilmore,1945,13,0,13,0.0,100.0,Male
Jonn,1945,7,0,7,0.0,100.0,Male
Hansford,1945,15,0,15,0.0,100.0,Male
Turhan,1945,6,0,6,0.0,100.0,Male
Salvator,1945,10,0,10,0.0,100.0,Male
Myron,1945,491,0,491,0.0,100.0,Male
Lindon,1945,15,0,15,0.0,100.0,Male
Marsden,1945,5,0,5,0.0,100.0,Male
Laverne,1945,757,598,159,78.99603698811096,21.003963011889034,Unisex
Trinidad,1945,89,31,58,34.831460674157306,65.1685393258427,Unisex
Dorian,1945,49,17,32,34.69387755102041,65.3061224489796,Unisex
Deane,1945,49,14,35,28.57142857142857,71.42857142857143,Unisex
Blythe,1945,13,8,5,61.53846153846154,38.46153846153847,Unisex
Pat,1945,2012,1520,492,75.54671968190854,24.45328031809145,Unisex
Marion,1945,2443,1602,841,65.57511256651658,34.42488743348342,Unisex
Victory,1945,54,36,18,66.66666666666666,33.33333333333333,Unisex
Ivey,1945,30,9,21,30.0,70.0,Unisex
Marlowe,1945,13,5,8,38.46153846153847,61.53846153846154,Unisex
Shelby,1945,486,333,153,68.51851851851852,31.48148148148148,Unisex
Garrie,1945,22,5,17,22.727272727272727,77.27272727272727,Unisex
Randie,1945,17,8,9,47.05882352941176,52.94117647058824,Unisex
Ivy,1945,98,61,37,62.24489795918368,37.755102040816325,Unisex
Ottie,1945,20,10,10,50.0,50.0,Unisex
Gentry,1945,16,5,11,31.25,68.75,Unisex
Allison,1945,83,47,36,56.62650602409639,43.373493975903614,Unisex
Dennie,1945,92,16,76,17.391304347826086,82.6086956521739,Unisex
Carlin,1945,18,9,9,50.0,50.0,Unisex
Woodie,1945,44,7,37,15.909090909090908,84.0909090909091,Unisex
Glennie,1945,30,22,8,73.33333333333333,26.666666666666668,Unisex
Foy,1945,31,5,26,16.129032258064516,83.87096774193549,Unisex
Starr,1945,49,39,10,79.59183673469387,20.40816326530612,Unisex
Unknown,1945,96,54,42,56.25,43.75,Unisex
Landis,1945,33,5,28,15.151515151515152,84.84848484848484,Unisex
Dene,1945,12,7,5,58.333333333333336,41.66666666666667,Unisex
Lupe,1945,522,376,146,72.03065134099617,27.969348659003828,Unisex
Carmon,1945,28,11,17,39.285714285714285,60.71428571428571,Unisex
Kirsten,1946,34,34,0,100.0,0.0,Female
Pollie,1946,13,13,0,100.0,0.0,Female
Elena,1946,241,241,0,100.0,0.0,Female
Roselee,1946,21,21,0,100.0,0.0,Female
Lelah,1946,8,8,0,100.0,0.0,Female
Bell,1946,6,6,0,100.0,0.0,Female
Clarinda,1946,10,10,0,100.0,0.0,Female
An,1946,6,6,0,100.0,0.0,Female
Violeta,1946,8,8,0,100.0,0.0,Female
Joie,1946,8,8,0,100.0,0.0,Female
Carollee,1946,11,11,0,100.0,0.0,Female
Melvine,1946,5,5,0,100.0,0.0,Female
Maryella,1946,8,8,0,100.0,0.0,Female
Cathryn,1946,160,160,0,100.0,0.0,Female
Marilu,1946,17,17,0,100.0,0.0,Female
Shanda,1946,10,10,0,100.0,0.0,Female
Lucy,1946,1241,1236,5,99.59709911361804,0.40290088638195,Female
Doug,1946,310,0,310,0.0,100.0,Male
Theadore,1946,47,0,47,0.0,100.0,Male
Lonnie,1946,1916,141,1775,7.359081419624217,92.64091858037578,Male
Ceasar,1946,13,0,13,0.0,100.0,Male
Eluterio,1946,10,0,10,0.0,100.0,Male
Jess,1946,220,0,220,0.0,100.0,Male
Maxey,1946,9,0,9,0.0,100.0,Male
Rozell,1946,10,0,10,0.0,100.0,Male
Shawn,1946,43,21,22,48.837209302325576,51.16279069767442,Unisex
Ara,1946,26,20,6,76.92307692307693,23.07692307692308,Unisex
Noel,1946,439,105,334,23.917995444191344,76.08200455580865,Unisex
Carley,1946,15,8,7,53.333333333333336,46.66666666666666,Unisex
Unknown,1946,147,104,43,70.74829931972789,29.25170068027211,Unisex
Marzell,1946,10,5,5,50.0,50.0,Unisex
Henri,1946,46,14,32,30.434782608695656,69.56521739130434,Unisex
Foye,1946,12,7,5,58.333333333333336,41.66666666666667,Unisex
Audry,1946,37,30,7,81.08108108108108,18.91891891891892,Unisex
Greer,1946,30,23,7,76.66666666666667,23.33333333333333,Unisex
Tobey,1946,10,5,5,50.0,50.0,Unisex
Carlin,1946,28,11,17,39.285714285714285,60.71428571428571,Unisex
Robin,1946,1202,773,429,64.30948419301164,35.69051580698835,Unisex
Cleo,1946,333,203,130,60.96096096096096,39.03903903903904,Unisex
Lannie,1946,70,27,43,38.57142857142858,61.42857142857143,Unisex
Jammie,1946,15,9,6,60.0,40.0,Unisex
Ronell,1946,11,6,5,54.54545454545454,45.45454545454545,Unisex
Lennie,1946,108,63,45,58.333333333333336,41.66666666666667,Unisex
Garrie,1946,16,6,10,37.5,62.5,Unisex
Cleotha,1946,15,7,8,46.66666666666666,53.333333333333336,Unisex
Marvis,1946,33,24,9,72.72727272727273,27.27272727272727,Unisex
Tandy,1946,16,7,9,43.75,56.25,Unisex
Landis,1946,29,5,24,17.24137931034483,82.75862068965517,Unisex
Le,1946,17,11,6,64.70588235294117,35.294117647058826,Unisex
Laney,1946,18,8,10,44.44444444444444,55.55555555555556,Unisex
Jerri,1947,212,212,0,100.0,0.0,Female
Francena,1947,18,18,0,100.0,0.0,Female
Madeline,1947,972,972,0,100.0,0.0,Female
Precious,1947,16,16,0,100.0,0.0,Female
Clare,1947,309,267,42,86.40776699029125,13.592233009708735,Female
Penelope,1947,796,796,0,100.0,0.0,Female
Belinda,1947,242,242,0,100.0,0.0,Female
Milly,1947,8,8,0,100.0,0.0,Female
Dreama,1947,62,62,0,100.0,0.0,Female
Arthur,1947,8283,30,8253,0.3621876131836291,99.63781238681636,Male
Osborne,1947,28,0,28,0.0,100.0,Male
Lowery,1947,6,0,6,0.0,100.0,Male
Finley,1947,18,0,18,0.0,100.0,Male
Marin,1947,6,0,6,0.0,100.0,Male
Orlan,1947,11,0,11,0.0,100.0,Male
Curtis,1947,3064,27,3037,0.881201044386423,99.11879895561356,Male
Selby,1947,10,0,10,0.0,100.0,Male
Lloyd,1947,2637,7,2630,0.2654531664770572,99.73454683352294,Male
Alexander,1947,1080,0,1080,0.0,100.0,Male
Maxey,1947,6,0,6,0.0,100.0,Male
Watson,1947,36,0,36,0.0,100.0,Male
Audy,1947,5,0,5,0.0,100.0,Male
Mel,1947,104,6,98,5.769230769230769,94.23076923076924,Male
Rivers,1947,7,0,7,0.0,100.0,Male
Clenton,1947,10,0,10,0.0,100.0,Male
Gwynn,1947,32,25,7,78.125,21.875,Unisex
Glennie,1947,35,25,10,71.42857142857143,28.57142857142857,Unisex
Garnet,1947,88,59,29,67.04545454545455,32.95454545454545,Unisex
Kary,1947,31,12,19,38.70967741935484,61.29032258064516,Unisex
Whitney,1947,50,13,37,26.0,74.0,Unisex
Lyndel,1947,15,8,7,53.333333333333336,46.66666666666666,Unisex
Gael,1947,44,28,16,63.63636363636363,36.36363636363637,Unisex
Arliss,1947,18,13,5,72.22222222222221,27.77777777777778,Unisex
Derry,1947,28,7,21,25.0,75.0,Unisex
Orrie,1947,11,5,6,45.45454545454545,54.54545454545454,Unisex
Terrel,1947,48,12,36,25.0,75.0,Unisex
Jonnie,1947,186,136,50,73.11827956989248,26.881720430107524,Unisex
Robin,1947,1501,936,565,62.35842771485676,37.64157228514324,Unisex
Regan,1947,30,10,20,33.33333333333333,66.66666666666666,Unisex
Carnell,1947,70,13,57,18.571428571428573,81.42857142857143,Unisex
Lupe,1947,511,365,146,71.42857142857143,28.57142857142857,Unisex
Alvia,1947,15,7,8,46.66666666666666,53.333333333333336,Unisex
Maurie,1947,13,7,6,53.84615384615385,46.15384615384615,Unisex
Dene,1947,16,6,10,37.5,62.5,Unisex
Mackie,1947,35,13,22,37.142857142857146,62.85714285714285,Unisex
Kelsey,1947,16,8,8,50.0,50.0,Unisex
Courtney,1947,130,41,89,31.538461538461537,68.46153846153847,Unisex
Monta,1947,13,8,5,61.53846153846154,38.46153846153847,Unisex
Delma,1947,129,105,24,81.3953488372093,18.6046511627907,Unisex
Brooke,1947,59,41,18,69.49152542372882,30.508474576271187,Unisex
Lyndal,1947,29,18,11,62.06896551724138,37.93103448275862,Unisex
Jere,1947,163,43,120,26.380368098159508,73.61963190184049,Unisex
Roe,1947,20,7,13,35.0,65.0,Unisex
Dayle,1947,103,77,26,74.75728155339806,25.24271844660194,Unisex
Netta,1948,17,17,0,100.0,0.0,Female
Benita,1948,163,163,0,100.0,0.0,Female
Jaci,1948,8,8,0,100.0,0.0,Female
Christal,1948,9,9,0,100.0,0.0,Female
Rochell,1948,5,5,0,100.0,0.0,Female
Noble,1948,79,0,79,0.0,100.0,Male
Turhan,1948,6,0,6,0.0,100.0,Male
Avery,1948,89,12,77,13.48314606741573,86.51685393258427,Male
Keenan,1948,10,0,10,0.0,100.0,Male
Stevens,1948,24,0,24,0.0,100.0,Male
Elson,1948,15,0,15,0.0,100.0,Male
Kyle,1948,146,16,130,10.95890410958904,89.04109589041096,Male
Primitivo,1948,6,0,6,0.0,100.0,Male
Zachary,1948,91,0,91,0.0,100.0,Male
Marcello,1948,10,0,10,0.0,100.0,Male
Clenton,1948,11,0,11,0.0,100.0,Male
Saunders,1948,8,0,8,0.0,100.0,Male
Ollie,1948,527,352,175,66.79316888045541,33.2068311195446,Unisex
Jule,1948,38,21,17,55.26315789473685,44.73684210526316,Unisex
Mozell,1948,42,28,14,66.66666666666666,33.33333333333333,Unisex
Vernal,1948,24,6,18,25.0,75.0,Unisex
Earlie,1948,49,22,27,44.89795918367347,55.10204081632652,Unisex
Daryle,1948,46,10,36,21.73913043478261,78.26086956521739,Unisex
Toby,1948,253,117,136,46.24505928853755,53.75494071146245,Unisex
Hollis,1948,249,96,153,38.55421686746988,61.44578313253012,Unisex
Orie,1948,30,7,23,23.33333333333333,76.66666666666667,Unisex
Ardell,1948,51,29,22,56.86274509803921,43.13725490196079,Unisex
Laney,1948,20,6,14,30.0,70.0,Unisex
Rozell,1948,15,5,10,33.33333333333333,66.66666666666666,Unisex
Arrie,1948,19,14,5,73.68421052631578,26.31578947368421,Unisex
Lavone,1948,26,20,6,76.92307692307693,23.07692307692308,Unisex
Dorris,1948,112,88,24,78.57142857142857,21.428571428571427,Unisex
Jonnie,1948,157,112,45,71.3375796178344,28.662420382165603,Unisex
Allyn,1948,67,15,52,22.388059701492537,77.61194029850746,Unisex
Ashley,1948,79,13,66,16.455696202531644,83.54430379746836,Unisex
Adrian,1948,371,66,305,17.78975741239892,82.21024258760107,Unisex
Valery,1948,23,18,5,78.26086956521739,21.73913043478261,Unisex
Curlie,1948,12,6,6,50.0,50.0,Unisex
Arie,1948,17,11,6,64.70588235294117,35.294117647058826,Unisex
Montie,1948,60,14,46,23.33333333333333,76.66666666666667,Unisex
Carley,1948,21,6,15,28.57142857142857,71.42857142857143,Unisex
Loyce,1948,84,69,15,82.14285714285714,17.857142857142858,Unisex
Teddie,1948,37,18,19,48.64864864864865,51.35135135135135,Unisex
Derry,1948,30,5,25,16.666666666666664,83.33333333333334,Unisex
Judith,1949,17634,17610,24,99.86389928547123,0.1361007145287512,Female
Paulina,1949,21,21,0,100.0,0.0,Female
Mimi,1949,86,86,0,100.0,0.0,Female
Lysbeth,1949,6,6,0,100.0,0.0,Female
Alexia,1949,16,16,0,100.0,0.0,Female
Christie,1949,344,327,17,95.05813953488372,4.941860465116279,Female
Charletta,1949,12,12,0,100.0,0.0,Female
Candyce,1949,91,91,0,100.0,0.0,Female
Blondie,1949,10,10,0,100.0,0.0,Female
Lelah,1949,8,8,0,100.0,0.0,Female
Abbey,1949,8,8,0,100.0,0.0,Female
Feliz,1949,8,8,0,100.0,0.0,Female
Melvina,1949,79,79,0,100.0,0.0,Female
Kinley,1949,6,0,6,0.0,100.0,Male
Joesph,1949,177,0,177,0.0,100.0,Male
Walter,1949,8327,30,8297,0.3602738080941515,99.63972619190584,Male
Rumaldo,1949,13,0,13,0.0,100.0,Male
Cosme,1949,10,0,10,0.0,100.0,Male
Denzel,1949,14,0,14,0.0,100.0,Male
Standley,1949,7,0,7,0.0,100.0,Male
Clide,1949,5,0,5,0.0,100.0,Male
Sergio,1949,75,0,75,0.0,100.0,Male
Emmet,1949,33,0,33,0.0,100.0,Male
Gardner,1949,32,0,32,0.0,100.0,Male
Garey,1949,39,0,39,0.0,100.0,Male
Verner,1949,17,5,12,29.411764705882355,70.58823529411765,Unisex
Johnell,1949,22,6,16,27.27272727272727,72.72727272727273,Unisex
Kelly,1949,627,117,510,18.66028708133972,81.3397129186603,Unisex
Erie,1949,28,9,19,32.142857142857146,67.85714285714286,Unisex
Ardell,1949,53,25,28,47.16981132075472,52.83018867924528,Unisex
Allie,1949,95,76,19,80.0,20.0,Unisex
Waverly,1949,35,7,28,20.0,80.0,Unisex
Sandy,1949,876,689,187,78.65296803652969,21.34703196347032,Unisex
Lael,1949,25,20,5,80.0,20.0,Unisex
Hilary,1949,120,86,34,71.66666666666667,28.33333333333333,Unisex
Carey,1949,240,45,195,18.75,81.25,Unisex
Le,1949,20,11,9,55.00000000000001,45.0,Unisex
Lexie,1949,31,25,6,80.64516129032258,19.35483870967742,Unisex
Kary,1949,25,10,15,40.0,60.0,Unisex
Monnie,1949,24,16,8,66.66666666666666,33.33333333333333,Unisex
Karel,1949,44,35,9,79.54545454545455,20.454545454545457,Unisex
Carlis,1949,26,8,18,30.76923076923077,69.23076923076923,Unisex
Shirl,1949,26,12,14,46.15384615384615,53.84615384615385,Unisex
Rene,1949,526,177,349,33.65019011406844,66.34980988593155,Unisex
Laney,1949,23,13,10,56.52173913043478,43.47826086956522,Unisex
Burnell,1949,51,8,43,15.68627450980392,84.31372549019608,Unisex
Sherrel,1949,31,26,5,83.87096774193549,16.129032258064516,Unisex
Jewell,1949,307,260,47,84.69055374592834,15.309446254071664,Unisex
Carroll,1949,771,148,623,19.1958495460441,80.8041504539559,Unisex
Dorris,1949,85,66,19,77.64705882352942,22.35294117647059,Unisex
Leotha,1949,15,6,9,40.0,60.0,Unisex
Ardie,1949,16,10,6,62.5,37.5,Unisex
Shane,1949,34,7,27,20.588235294117645,79.41176470588235,Unisex
Normajean,1950,5,5,0,100.0,0.0,Female
Tonya,1950,153,153,0,100.0,0.0,Female
Tonita,1950,13,13,0,100.0,0.0,Female
Ramona,1950,1036,1036,0,100.0,0.0,Female
Evlyn,1950,11,11,0,100.0,0.0,Female
Donzell,1950,12,0,12,0.0,100.0,Male
Elie,1950,12,0,12,0.0,100.0,Male
Randol,1950,17,0,17,0.0,100.0,Male
Melvyn,1950,39,0,39,0.0,100.0,Male
Zenon,1950,8,0,8,0.0,100.0,Male
Rainey,1950,13,0,13,0.0,100.0,Male
Vertis,1950,5,0,5,0.0,100.0,Male
Jimmie,1950,2176,274,1902,12.591911764705882,87.40808823529412,Male
Sampson,1950,27,0,27,0.0,100.0,Male
Walker,1950,54,0,54,0.0,100.0,Male
Keenan,1950,13,0,13,0.0,100.0,Male
Braulio,1950,11,0,11,0.0,100.0,Male
Conrad,1950,383,0,383,0.0,100.0,Male
Kendrick,1950,26,0,26,0.0,100.0,Male
Horace,1950,687,0,687,0.0,100.0,Male
Graig,1950,10,0,10,0.0,100.0,Male
Pernell,1950,34,12,22,35.294117647058826,64.70588235294117,Unisex
Tracy,1950,403,178,225,44.168734491315135,55.83126550868487,Unisex
Gale,1950,995,662,333,66.53266331658291,33.46733668341709,Unisex
Glendell,1950,14,7,7,50.0,50.0,Unisex
Lovell,1950,38,6,32,15.789473684210526,84.21052631578947,Unisex
Carlon,1950,20,8,12,40.0,60.0,Unisex
Monnie,1950,26,21,5,80.76923076923077,19.23076923076924,Unisex
Lavaughn,1950,17,7,10,41.17647058823529,58.82352941176471,Unisex
Clair,1950,157,44,113,28.02547770700637,71.97452229299363,Unisex
Delma,1950,117,94,23,80.34188034188034,19.65811965811966,Unisex
Jule,1950,27,14,13,51.85185185185185,48.14814814814815,Unisex
Robbin,1950,69,39,30,56.52173913043478,43.47826086956522,Unisex
Kris,1950,210,104,106,49.523809523809526,50.47619047619048,Unisex
Brook,1950,19,9,10,47.368421052631575,52.63157894736842,Unisex
Selby,1950,14,5,9,35.714285714285715,64.28571428571429,Unisex
Jerre,1950,33,16,17,48.48484848484848,51.51515151515152,Unisex
Curley,1950,71,17,54,23.943661971830984,76.05633802816901,Unisex
Donnis,1950,37,24,13,64.86486486486487,35.13513513513514,Unisex
Kerry,1950,1541,478,1063,31.018818948734587,68.98118105126542,Unisex
Hollis,1950,214,71,143,33.177570093457945,66.82242990654206,Unisex
Kriss,1950,18,5,13,27.77777777777778,72.22222222222221,Unisex
Ivey,1950,32,12,20,37.5,62.5,Unisex
Shannon,1950,474,382,92,80.59071729957806,19.40928270042194,Unisex
Feliz,1950,10,5,5,50.0,50.0,Unisex
Sandy,1950,704,515,189,73.1534090909091,26.84659090909091,Unisex
Odessa,1951,150,150,0,100.0,0.0,Female
Paulina,1951,25,25,0,100.0,0.0,Female
Sudie,1951,31,31,0,100.0,0.0,Female
Thelma,1951,1529,1529,0,100.0,0.0,Female
Leola,1951,228,228,0,100.0,0.0,Female
Senaida,1951,11,11,0,100.0,0.0,Female
Darcia,1951,12,12,0,100.0,0.0,Female
Bell,1951,6,6,0,100.0,0.0,Female
Evie,1951,48,48,0,100.0,0.0,Female
Edd,1951,32,0,32,0.0,100.0,Male
Clinton,1951,902,5,897,0.5543237250554324,99.44567627494456,Male
Cy,1951,15,0,15,0.0,100.0,Male
Uriel,1951,5,0,5,0.0,100.0,Male
Phil,1951,288,0,288,0.0,100.0,Male
Cephus,1951,15,0,15,0.0,100.0,Male
Timothy,1951,12716,12,12704,0.0943692985215476,99.90563070147846,Male
Clifton,1951,954,0,954,0.0,100.0,Male
Dorance,1951,8,0,8,0.0,100.0,Male
Rolland,1951,104,0,104,0.0,100.0,Male
Rey,1951,19,0,19,0.0,100.0,Male
Cristobal,1951,21,0,21,0.0,100.0,Male
Levern,1951,58,9,49,15.517241379310343,84.48275862068965,Unisex
Marice,1951,12,7,5,58.333333333333336,41.66666666666667,Unisex
Ariel,1951,19,7,12,36.84210526315789,63.1578947368421,Unisex
Rue,1951,13,6,7,46.15384615384615,53.84615384615385,Unisex
Stormy,1951,16,9,7,56.25,43.75,Unisex
Bryn,1951,12,7,5,58.333333333333336,41.66666666666667,Unisex
Karel,1951,43,35,8,81.3953488372093,18.6046511627907,Unisex
Santos,1951,164,30,134,18.29268292682927,81.70731707317073,Unisex
Laverne,1951,745,622,123,83.48993288590604,16.51006711409396,Unisex
Carrol,1951,146,82,64,56.16438356164384,43.83561643835616,Unisex
Audry,1951,28,22,6,78.57142857142857,21.428571428571427,Unisex
Rikki,1951,24,16,8,66.66666666666666,33.33333333333333,Unisex
Johnell,1951,29,10,19,34.48275862068966,65.51724137931035,Unisex
Tandy,1951,15,8,7,53.333333333333336,46.66666666666666,Unisex
Rande,1951,40,15,25,37.5,62.5,Unisex
Erie,1951,35,12,23,34.285714285714285,65.71428571428571,Unisex
Mallory,1951,46,25,21,54.34782608695652,45.65217391304348,Unisex
Lyndall,1951,22,15,7,68.18181818181817,31.818181818181817,Unisex
Kerry,1951,1674,491,1183,29.33094384707288,70.66905615292713,Unisex
Abbey,1951,23,16,7,69.56521739130434,30.434782608695656,Unisex
Carmon,1951,28,11,17,39.285714285714285,60.71428571428571,Unisex
Regan,1951,42,10,32,23.809523809523807,76.19047619047619,Unisex
Robie,1951,16,6,10,37.5,62.5,Unisex
Theo,1951,64,18,46,28.125,71.875,Unisex
Jae,1951,12,5,7,41.66666666666667,58.333333333333336,Unisex
Odessa,1952,137,132,5,96.35036496350364,3.64963503649635,Female
Bee,1952,5,5,0,100.0,0.0,Female
Tracey,1952,148,129,19,87.16216216216216,12.837837837837837,Female
Elia,1952,52,52,0,100.0,0.0,Female
Adair,1952,15,15,0,100.0,0.0,Female
Avalon,1952,7,7,0,100.0,0.0,Female
Elizabeth,1952,16051,16022,29,99.8193258986979,0.1806741013020995,Female
Judith,1952,14086,14063,23,99.83671730796534,0.1632826920346443,Female
Godfrey,1952,34,0,34,0.0,100.0,Male
Raynaldo,1952,28,0,28,0.0,100.0,Male
Lafe,1952,6,0,6,0.0,100.0,Male
Johnson,1952,45,0,45,0.0,100.0,Male
Britton,1952,11,0,11,0.0,100.0,Male
Phil,1952,262,6,256,2.2900763358778624,97.70992366412212,Male
Winston,1952,262,0,262,0.0,100.0,Male
Ammon,1952,7,0,7,0.0,100.0,Male
Dirk,1952,109,0,109,0.0,100.0,Male
Rex,1952,1505,7,1498,0.4651162790697674,99.53488372093024,Male
Natale,1952,11,0,11,0.0,100.0,Male
Farrell,1952,73,0,73,0.0,100.0,Male
Vernal,1952,21,6,15,28.57142857142857,71.42857142857143,Unisex
Lacey,1952,37,10,27,27.027027027027028,72.97297297297297,Unisex
Trinidad,1952,99,28,71,28.28282828282828,71.71717171717171,Unisex
Cory,1952,62,16,46,25.806451612903224,74.19354838709677,Unisex
Fabian,1952,49,12,37,24.489795918367346,75.51020408163265,Unisex
Carmel,1952,86,72,14,83.72093023255815,16.27906976744186,Unisex
Monnie,1952,41,31,10,75.60975609756098,24.390243902439025,Unisex
Stacy,1952,231,128,103,55.41125541125541,44.58874458874459,Unisex
Shane,1952,52,15,37,28.846153846153843,71.15384615384616,Unisex
Dominique,1952,21,16,5,76.19047619047619,23.809523809523807,Unisex
Garrie,1952,33,6,27,18.181818181818183,81.81818181818183,Unisex
Frankie,1952,1081,428,653,39.59296947271046,60.40703052728955,Unisex
Rosario,1952,153,122,31,79.73856209150327,20.26143790849673,Unisex
Jackie,1952,3569,1560,2009,43.70972261137573,56.29027738862427,Unisex
Jammie,1952,17,6,11,35.294117647058826,64.70588235294117,Unisex
Alpha,1952,47,31,16,65.95744680851064,34.04255319148936,Unisex
Laury,1952,16,11,5,68.75,31.25,Unisex
Lee,1952,4602,948,3654,20.59973924380704,79.40026075619296,Unisex
Cameron,1952,135,23,112,17.037037037037038,82.96296296296296,Unisex
Marshell,1952,23,5,18,21.73913043478261,78.26086956521739,Unisex
Augustine,1952,133,46,87,34.58646616541353,65.41353383458647,Unisex
Nickie,1952,73,42,31,57.53424657534247,42.465753424657535,Unisex
Gael,1952,26,18,8,69.23076923076923,30.76923076923077,Unisex
Alva,1952,178,81,97,45.50561797752809,54.49438202247191,Unisex
Hiawatha,1952,19,8,11,42.10526315789473,57.89473684210527,Unisex
Kristan,1952,29,24,5,82.75862068965517,17.24137931034483,Unisex
Arlee,1952,11,6,5,54.54545454545454,45.45454545454545,Unisex
Dayle,1952,115,96,19,83.47826086956522,16.52173913043478,Unisex
Melvine,1953,9,9,0,100.0,0.0,Female
Jeananne,1953,6,6,0,100.0,0.0,Female
Vanita,1953,37,37,0,100.0,0.0,Female
Jerlean,1953,14,14,0,100.0,0.0,Female
Elinor,1953,100,100,0,100.0,0.0,Female
Terrie,1953,552,543,9,98.36956521739133,1.6304347826086956,Female
Rosalia,1953,47,47,0,100.0,0.0,Female
Wendy,1953,3627,3616,11,99.69671905155776,0.3032809484422387,Female
Lenise,1953,13,13,0,100.0,0.0,Female
Lloyd,1953,2175,7,2168,0.3218390804597701,99.67816091954025,Male
Sergio,1953,131,0,131,0.0,100.0,Male
Roy,1953,6687,32,6655,0.4785404516225512,99.52145954837744,Male
Raul,1953,746,8,738,1.0723860589812333,98.92761394101876,Male
Joe,1953,5988,191,5797,3.1897127588510354,96.81028724114896,Male
Garnell,1953,10,0,10,0.0,100.0,Male
Marlen,1953,12,0,12,0.0,100.0,Male
Arnoldo,1953,40,0,40,0.0,100.0,Male
Clide,1953,7,0,7,0.0,100.0,Male
Halbert,1953,17,0,17,0.0,100.0,Male
Ahmad,1953,7,0,7,0.0,100.0,Male
Sherman,1953,605,0,605,0.0,100.0,Male
Mannie,1953,19,0,19,0.0,100.0,Male
Gardner,1953,32,0,32,0.0,100.0,Male
Waverly,1953,38,14,24,36.84210526315789,63.1578947368421,Unisex
Jayme,1953,48,38,10,79.16666666666666,20.833333333333336,Unisex
Adair,1953,18,13,5,72.22222222222221,27.77777777777778,Unisex
Merrill,1953,200,51,149,25.5,74.5,Unisex
Jodie,1953,206,171,35,83.00970873786407,16.990291262135923,Unisex
Kelly,1953,1071,226,845,21.10177404295052,78.89822595704949,Unisex
Pepper,1953,15,8,7,53.333333333333336,46.66666666666666,Unisex
Jude,1953,61,14,47,22.950819672131143,77.04918032786885,Unisex
Maris,1953,16,11,5,68.75,31.25,Unisex
Kimber,1953,30,17,13,56.66666666666666,43.333333333333336,Unisex
Avon,1953,45,23,22,51.11111111111111,48.888888888888886,Unisex
Merlyn,1953,46,14,32,30.434782608695656,69.56521739130434,Unisex
Brook,1953,21,10,11,47.61904761904761,52.38095238095239,Unisex
Lugene,1953,45,30,15,66.66666666666666,33.33333333333333,Unisex
Merle,1953,448,123,325,27.455357142857142,72.54464285714286,Unisex
Earlie,1953,31,11,20,35.483870967741936,64.51612903225806,Unisex
Jae,1953,23,14,9,60.86956521739131,39.130434782608695,Unisex
Myrle,1953,21,14,7,66.66666666666666,33.33333333333333,Unisex
Dwan,1953,19,9,10,47.368421052631575,52.63157894736842,Unisex
Robbie,1953,591,407,184,68.8663282571912,31.1336717428088,Unisex
Erie,1953,28,16,12,57.14285714285714,42.85714285714285,Unisex
Farris,1953,42,9,33,21.428571428571427,78.57142857142857,Unisex
Mackie,1953,37,9,28,24.324324324324326,75.67567567567568,Unisex
Lavern,1953,205,102,103,49.75609756097561,50.24390243902439,Unisex
Audie,1953,101,16,85,15.84158415841584,84.15841584158416,Unisex
Ricci,1953,44,12,32,27.27272727272727,72.72727272727273,Unisex
Arvis,1953,16,11,5,68.75,31.25,Unisex
Rue,1953,16,8,8,50.0,50.0,Unisex
Ivy,1953,251,204,47,81.27490039840637,18.725099601593627,Unisex
Laury,1954,30,30,0,100.0,0.0,Female
Jacquelyn,1954,1604,1604,0,100.0,0.0,Female
Wynema,1954,11,11,0,100.0,0.0,Female
Jodee,1954,42,42,0,100.0,0.0,Female
Maree,1954,9,9,0,100.0,0.0,Female
Suzzette,1954,12,12,0,100.0,0.0,Female
Buren,1954,6,0,6,0.0,100.0,Male
Hezekiah,1954,37,0,37,0.0,100.0,Male
Alex,1954,751,8,743,1.0652463382157125,98.93475366178428,Male
Elwood,1954,192,0,192,0.0,100.0,Male
Bennett,1954,184,0,184,0.0,100.0,Male
Carvin,1954,14,0,14,0.0,100.0,Male
Barney,1954,265,6,259,2.2641509433962264,97.73584905660375,Male
Thayer,1954,5,0,5,0.0,100.0,Male
Terrell,1954,219,24,195,10.95890410958904,89.04109589041096,Male
Marvell,1954,8,0,8,0.0,100.0,Male
Kendrick,1954,24,0,24,0.0,100.0,Male
Cresencio,1954,8,0,8,0.0,100.0,Male
Collie,1954,15,5,10,33.33333333333333,66.66666666666666,Unisex
Orrie,1954,12,6,6,50.0,50.0,Unisex
Sheridan,1954,60,28,32,46.66666666666666,53.333333333333336,Unisex
Sonnie,1954,16,6,10,37.5,62.5,Unisex
Linnie,1954,61,47,14,77.04918032786885,22.950819672131143,Unisex
Regan,1954,44,15,29,34.090909090909086,65.9090909090909,Unisex
Trinidad,1954,73,21,52,28.767123287671232,71.23287671232876,Unisex
Deane,1954,48,20,28,41.66666666666667,58.333333333333336,Unisex
Robin,1954,10835,9043,1792,83.46100599907706,16.538994000922933,Unisex
Lyndel,1954,14,6,8,42.85714285714285,57.14285714285714,Unisex
Devon,1954,95,40,55,42.10526315789473,57.89473684210527,Unisex
Willia,1954,54,43,11,79.62962962962963,20.37037037037037,Unisex
Jamey,1954,39,27,12,69.23076923076923,30.76923076923077,Unisex
Mallory,1954,23,12,11,52.17391304347826,47.82608695652174,Unisex
Salome,1954,27,15,12,55.55555555555556,44.44444444444444,Unisex
Andree,1954,29,23,6,79.3103448275862,20.6896551724138,Unisex
Rozell,1954,24,8,16,33.33333333333333,66.66666666666666,Unisex
Myrle,1954,12,5,7,41.66666666666667,58.333333333333336,Unisex
Alpha,1954,35,21,14,60.0,40.0,Unisex
Maryland,1954,23,16,7,69.56521739130434,30.434782608695656,Unisex
Young,1954,31,11,20,35.483870967741936,64.51612903225806,Unisex
Dru,1954,66,53,13,80.3030303030303,19.69696969696969,Unisex
Corky,1954,20,11,9,55.00000000000001,45.0,Unisex
Varnell,1954,11,6,5,54.54545454545454,45.45454545454545,Unisex
Jacque,1954,158,132,26,83.54430379746836,16.455696202531644,Unisex
Renne,1954,18,11,7,61.11111111111112,38.88888888888889,Unisex
Gussie,1954,62,52,10,83.87096774193549,16.129032258064516,Unisex
Merrell,1954,22,5,17,22.727272727272727,77.27272727272727,Unisex
Saralyn,1955,22,22,0,100.0,0.0,Female
Netta,1955,13,13,0,100.0,0.0,Female
Fernanda,1955,10,10,0,100.0,0.0,Female
Chanie,1955,6,6,0,100.0,0.0,Female
Tally,1955,6,6,0,100.0,0.0,Female
India,1955,52,52,0,100.0,0.0,Female
Timothy,1955,20782,47,20735,0.2261572514676162,99.7738427485324,Male
Horace,1955,556,8,548,1.4388489208633095,98.56115107913668,Male
Rapheal,1955,7,0,7,0.0,100.0,Male
Perrin,1955,12,0,12,0.0,100.0,Male
Roosevelt,1955,597,9,588,1.507537688442211,98.4924623115578,Male
Derk,1955,12,0,12,0.0,100.0,Male
Climmie,1955,8,0,8,0.0,100.0,Male
Callen,1955,5,0,5,0.0,100.0,Male
Graig,1955,17,0,17,0.0,100.0,Male
Domingo,1955,173,0,173,0.0,100.0,Male
Braulio,1955,10,0,10,0.0,100.0,Male
Demorris,1955,5,0,5,0.0,100.0,Male
Val,1955,223,73,150,32.73542600896861,67.2645739910314,Unisex
Kriss,1955,27,12,15,44.44444444444444,55.55555555555556,Unisex
Robie,1955,29,12,17,41.37931034482759,58.620689655172406,Unisex
Samie,1955,12,5,7,41.66666666666667,58.333333333333336,Unisex
Landy,1955,22,6,16,27.27272727272727,72.72727272727273,Unisex
Waverly,1955,33,6,27,18.181818181818183,81.81818181818183,Unisex
Pat,1955,688,359,329,52.18023255813954,47.81976744186046,Unisex
Merrell,1955,22,10,12,45.45454545454545,54.54545454545454,Unisex
Arlis,1955,34,14,20,41.17647058823529,58.82352941176471,Unisex
Cheyenne,1955,20,15,5,75.0,25.0,Unisex
Ova,1955,14,6,8,42.85714285714285,57.14285714285714,Unisex
Marlyn,1955,98,70,28,71.42857142857143,28.57142857142857,Unisex
Clair,1955,135,36,99,26.666666666666668,73.33333333333333,Unisex
Jonnie,1955,126,93,33,73.80952380952381,26.1904761904762,Unisex
Merlyn,1955,45,17,28,37.77777777777778,62.22222222222222,Unisex
Dail,1955,19,10,9,52.63157894736842,47.368421052631575,Unisex
Burnice,1955,27,10,17,37.03703703703704,62.96296296296296,Unisex
Jimi,1955,23,13,10,56.52173913043478,43.47826086956522,Unisex
Augustine,1955,145,41,104,28.27586206896552,71.72413793103448,Unisex
Young,1955,24,7,17,29.166666666666668,70.83333333333334,Unisex
Lyndell,1955,44,14,30,31.818181818181817,68.18181818181817,Unisex
Jae,1955,21,13,8,61.90476190476191,38.095238095238095,Unisex
Refugio,1955,45,7,38,15.555555555555555,84.44444444444444,Unisex
Regan,1955,46,20,26,43.47826086956522,56.52173913043478,Unisex
Marshell,1955,15,10,5,66.66666666666666,33.33333333333333,Unisex
Dayle,1955,84,64,20,76.19047619047619,23.809523809523807,Unisex
Kim,1955,9177,5687,3490,61.97014274817478,38.02985725182522,Unisex
Morna,1956,10,10,0,100.0,0.0,Female
Jacquelyn,1956,1396,1396,0,100.0,0.0,Female
Edythe,1956,66,66,0,100.0,0.0,Female
Erline,1956,7,7,0,100.0,0.0,Female
Carollee,1956,5,5,0,100.0,0.0,Female
Rey,1956,32,0,32,0.0,100.0,Male
Ernie,1956,334,10,324,2.9940119760479043,97.0059880239521,Male
Cy,1956,25,0,25,0.0,100.0,Male
Jeffery,1956,6597,29,6568,0.4395937547370016,99.560406245263,Male
Ashby,1956,12,0,12,0.0,100.0,Male
Joe,1956,6324,196,6128,3.099304237824162,96.90069576217584,Male
Wesley,1956,2017,13,2004,0.6445215666831929,99.3554784333168,Male
Kenyon,1956,31,0,31,0.0,100.0,Male
Schuyler,1956,22,0,22,0.0,100.0,Male
Sampson,1956,42,0,42,0.0,100.0,Male
Spencer,1956,314,6,308,1.910828025477707,98.08917197452227,Male
Calvin,1956,3366,19,3347,0.5644682115270351,99.43553178847296,Male
Marshell,1956,22,10,12,45.45454545454545,54.54545454545454,Unisex
Kimmy,1956,31,11,20,35.483870967741936,64.51612903225806,Unisex
Lavaughn,1956,10,5,5,50.0,50.0,Unisex
Rikki,1956,32,13,19,40.625,59.375,Unisex
Ashley,1956,87,23,64,26.436781609195403,73.5632183908046,Unisex
Lyndal,1956,15,5,10,33.33333333333333,66.66666666666666,Unisex
Darcey,1956,25,19,6,76.0,24.0,Unisex
Deane,1956,48,13,35,27.08333333333333,72.91666666666666,Unisex
Cleo,1956,233,142,91,60.94420600858369,39.05579399141631,Unisex
Dorian,1956,96,42,54,43.75,56.25,Unisex
Adrien,1956,14,7,7,50.0,50.0,Unisex
Ludie,1956,15,10,5,66.66666666666666,33.33333333333333,Unisex
Larue,1956,46,27,19,58.69565217391305,41.30434782608695,Unisex
Lavelle,1956,26,9,17,34.61538461538461,65.38461538461539,Unisex
Arrie,1956,18,9,9,50.0,50.0,Unisex
Diamond,1956,14,7,7,50.0,50.0,Unisex
Arden,1956,88,24,64,27.27272727272727,72.72727272727273,Unisex
Johnell,1956,23,5,18,21.73913043478261,78.26086956521739,Unisex
Guadalupe,1956,841,543,298,64.56599286563615,35.43400713436385,Unisex
Lesley,1956,375,295,80,78.66666666666666,21.333333333333336,Unisex
Wallis,1956,16,8,8,50.0,50.0,Unisex
Verdell,1956,56,34,22,60.71428571428571,39.285714285714285,Unisex
Kyle,1956,657,186,471,28.31050228310502,71.68949771689498,Unisex
Jaime,1956,477,80,397,16.771488469601678,83.22851153039832,Unisex
Jude,1956,80,24,56,30.0,70.0,Unisex
Jewell,1956,209,161,48,77.03349282296651,22.96650717703349,Unisex
Carrol,1956,89,58,31,65.1685393258427,34.831460674157306,Unisex
Loyce,1956,45,35,10,77.77777777777779,22.22222222222222,Unisex
Darcia,1957,28,28,0,100.0,0.0,Female
Josie,1957,276,276,0,100.0,0.0,Female
Lanell,1957,52,52,0,100.0,0.0,Female
Estelle,1957,160,160,0,100.0,0.0,Female
Zoe,1957,143,143,0,100.0,0.0,Female
Marijo,1957,54,54,0,100.0,0.0,Female
Braxton,1957,26,0,26,0.0,100.0,Male
Saverio,1957,17,0,17,0.0,100.0,Male
Wheeler,1957,12,0,12,0.0,100.0,Male
Verle,1957,20,0,20,0.0,100.0,Male
Edmund,1957,661,0,661,0.0,100.0,Male
Casimiro,1957,13,0,13,0.0,100.0,Male
Tully,1957,9,0,9,0.0,100.0,Male
Garry,1957,2053,12,2041,0.5845104724792985,99.4154895275207,Male
Ferrell,1957,18,0,18,0.0,100.0,Male
Thayer,1957,9,0,9,0.0,100.0,Male
Salome,1957,19,9,10,47.368421052631575,52.63157894736842,Unisex
Merrill,1957,177,28,149,15.819209039548024,84.18079096045197,Unisex
Larue,1957,47,24,23,51.06382978723404,48.93617021276596,Unisex
Carmon,1957,26,16,10,61.53846153846154,38.46153846153847,Unisex
Marvis,1957,28,17,11,60.71428571428571,39.285714285714285,Unisex
Marin,1957,18,7,11,38.88888888888889,61.11111111111112,Unisex
Jackey,1957,28,5,23,17.857142857142858,82.14285714285714,Unisex
Andra,1957,99,55,44,55.55555555555556,44.44444444444444,Unisex
Myrle,1957,12,6,6,50.0,50.0,Unisex
Tracy,1957,3123,1967,1156,62.984309958373366,37.01569004162664,Unisex
Tobey,1957,24,10,14,41.66666666666667,58.333333333333336,Unisex
Carlie,1957,23,7,16,30.434782608695656,69.56521739130434,Unisex
Dann,1957,116,45,71,38.793103448275865,61.206896551724135,Unisex
Joie,1957,15,8,7,53.333333333333336,46.66666666666666,Unisex
Corby,1957,38,16,22,42.10526315789473,57.89473684210527,Unisex
Linn,1957,51,21,30,41.17647058823529,58.82352941176471,Unisex
Kerin,1957,40,25,15,62.5,37.5,Unisex
Kimber,1957,70,59,11,84.28571428571429,15.714285714285714,Unisex
Lennis,1957,29,6,23,20.6896551724138,79.3103448275862,Unisex
Elzie,1957,41,7,34,17.073170731707318,82.92682926829268,Unisex
Rikki,1957,23,18,5,78.26086956521739,21.73913043478261,Unisex
Raynell,1957,18,12,6,66.66666666666666,33.33333333333333,Unisex
Alpha,1957,35,20,15,57.14285714285714,42.85714285714285,Unisex
Bryn,1957,22,16,6,72.72727272727273,27.27272727272727,Unisex
Shon,1957,20,8,12,40.0,60.0,Unisex
Karel,1957,32,25,7,78.125,21.875,Unisex
Antonina,1958,20,20,0,100.0,0.0,Female
Bobbye,1958,19,19,0,100.0,0.0,Female
Rachel,1958,1667,1661,6,99.64007198560287,0.3599280143971206,Female
Loucinda,1958,5,5,0,100.0,0.0,Female
Pamala,1958,314,314,0,100.0,0.0,Female
Marylynn,1958,37,37,0,100.0,0.0,Female
Alison,1958,993,993,0,100.0,0.0,Female
Olympia,1958,16,16,0,100.0,0.0,Female
Mabeline,1958,9,9,0,100.0,0.0,Female
Delphia,1958,34,34,0,100.0,0.0,Female
Suzette,1958,422,422,0,100.0,0.0,Female
Marsh,1958,7,0,7,0.0,100.0,Male
Elson,1958,8,0,8,0.0,100.0,Male
Flynn,1958,13,0,13,0.0,100.0,Male
Darion,1958,5,0,5,0.0,100.0,Male
Donovan,1958,73,0,73,0.0,100.0,Male
Burrell,1958,14,0,14,0.0,100.0,Male
Schuyler,1958,21,0,21,0.0,100.0,Male
Mikle,1958,5,0,5,0.0,100.0,Male
Stirling,1958,6,0,6,0.0,100.0,Male
Udell,1958,7,0,7,0.0,100.0,Male
Nolen,1958,7,0,7,0.0,100.0,Male
Mannie,1958,8,0,8,0.0,100.0,Male
Jules,1958,68,0,68,0.0,100.0,Male
Candido,1958,19,0,19,0.0,100.0,Male
Sherman,1958,606,5,601,0.825082508250825,99.17491749174916,Male
Lonnie,1958,1886,110,1776,5.832449628844114,94.16755037115588,Male
Erle,1958,12,0,12,0.0,100.0,Male
Gerry,1958,635,111,524,17.480314960629922,82.51968503937009,Unisex
Marice,1958,12,6,6,50.0,50.0,Unisex
Carmon,1958,32,18,14,56.25,43.75,Unisex
Tonnie,1958,33,19,14,57.57575757575758,42.42424242424242,Unisex
Lacy,1958,84,20,64,23.809523809523807,76.19047619047619,Unisex
Paris,1958,67,22,45,32.83582089552239,67.16417910447761,Unisex
Cris,1958,153,57,96,37.25490196078432,62.74509803921568,Unisex
Dana,1958,3922,2388,1534,60.88730239673635,39.11269760326364,Unisex
Daryn,1958,12,7,5,58.333333333333336,41.66666666666667,Unisex
Rochell,1958,33,28,5,84.84848484848484,15.151515151515152,Unisex
Artie,1958,105,24,81,22.857142857142858,77.14285714285715,Unisex
Lennie,1958,107,29,78,27.10280373831776,72.89719626168224,Unisex
Billye,1958,21,15,6,71.42857142857143,28.57142857142857,Unisex
Jamie,1958,1956,1311,645,67.02453987730061,32.97546012269939,Unisex
Carmin,1958,12,7,5,58.333333333333336,41.66666666666667,Unisex
Arnell,1958,15,5,10,33.33333333333333,66.66666666666666,Unisex
Cory,1958,343,61,282,17.784256559766764,82.21574344023324,Unisex
Kimmy,1958,37,18,19,48.64864864864865,51.35135135135135,Unisex
Linden,1958,62,16,46,25.806451612903224,74.19354838709677,Unisex
Quincy,1958,61,12,49,19.672131147540984,80.32786885245902,Unisex
Dru,1958,61,42,19,68.85245901639344,31.14754098360656,Unisex
Lyndel,1958,16,7,9,43.75,56.25,Unisex
Arlis,1958,36,12,24,33.33333333333333,66.66666666666666,Unisex
Elisha,1958,40,8,32,20.0,80.0,Unisex
Conny,1958,22,15,7,68.18181818181817,31.818181818181817,Unisex
Golden,1958,27,5,22,18.51851851851852,81.48148148148148,Unisex
Juleen,1959,12,12,0,100.0,0.0,Female
Micha,1959,5,5,0,100.0,0.0,Female
Evelyne,1959,12,12,0,100.0,0.0,Female
Kindra,1959,15,15,0,100.0,0.0,Female
Roxie,1959,188,188,0,100.0,0.0,Female
Loris,1959,18,18,0,100.0,0.0,Female
Debora,1959,1966,1961,5,99.74567650050864,0.254323499491353,Female
Rustin,1959,40,0,40,0.0,100.0,Male
Emmet,1959,20,0,20,0.0,100.0,Male
Sergio,1959,249,0,249,0.0,100.0,Male
Lane,1959,372,30,342,8.064516129032258,91.93548387096774,Male
Nyle,1959,17,0,17,0.0,100.0,Male
Nicklos,1959,5,0,5,0.0,100.0,Male
Zollie,1959,10,0,10,0.0,100.0,Male
Raynell,1959,16,10,6,62.5,37.5,Unisex
Kelsie,1959,10,5,5,50.0,50.0,Unisex
Burdette,1959,18,5,13,27.77777777777778,72.22222222222221,Unisex
Cris,1959,162,63,99,38.88888888888889,61.11111111111112,Unisex
Kimble,1959,14,5,9,35.714285714285715,64.28571428571429,Unisex
Lennis,1959,22,7,15,31.818181818181817,68.18181818181817,Unisex
Jody,1959,2756,1860,896,67.48911465892597,32.51088534107402,Unisex
Little,1959,35,8,27,22.857142857142858,77.14285714285715,Unisex
Corky,1959,29,5,24,17.24137931034483,82.75862068965517,Unisex
Valentine,1959,45,13,32,28.88888888888889,71.11111111111111,Unisex
Onnie,1959,15,8,7,53.333333333333336,46.66666666666666,Unisex
Theo,1959,43,8,35,18.6046511627907,81.3953488372093,Unisex
Carlie,1959,19,11,8,57.89473684210527,42.10526315789473,Unisex
Bernie,1959,220,37,183,16.818181818181817,83.18181818181817,Unisex
Earlie,1959,32,10,22,31.25,68.75,Unisex
Gussie,1959,50,36,14,72.0,28.000000000000004,Unisex
Tobey,1959,23,10,13,43.47826086956522,56.52173913043478,Unisex
Lindsay,1959,185,69,116,37.2972972972973,62.70270270270271,Unisex
Rande,1959,26,6,20,23.07692307692308,76.92307692307693,Unisex
Brook,1959,46,15,31,32.608695652173914,67.3913043478261,Unisex
Pat,1959,1948,1001,947,51.38603696098563,48.61396303901437,Unisex
Larkin,1959,18,5,13,27.77777777777778,72.22222222222221,Unisex
Dru,1959,62,35,27,56.451612903225815,43.54838709677419,Unisex
Henri,1959,38,13,25,34.21052631578947,65.78947368421053,Unisex
Adrien,1959,22,9,13,40.909090909090914,59.09090909090909,Unisex
Christy,1960,1182,1164,18,98.47715736040608,1.5228426395939088,Female
Caryl,1960,122,112,10,91.8032786885246,8.19672131147541,Female
Saralyn,1960,13,13,0,100.0,0.0,Female
Jerri,1960,556,550,6,98.92086330935253,1.079136690647482,Female
Janeice,1960,5,5,0,100.0,0.0,Female
Samantha,1960,82,82,0,100.0,0.0,Female
Shawne,1960,23,23,0,100.0,0.0,Female
Leonarda,1960,8,8,0,100.0,0.0,Female
Leighanne,1960,9,9,0,100.0,0.0,Female
Abbe,1960,46,46,0,100.0,0.0,Female
Almira,1960,7,7,0,100.0,0.0,Female
Rolly,1960,7,0,7,0.0,100.0,Male
Richey,1960,12,0,12,0.0,100.0,Male
Talbert,1960,6,0,6,0.0,100.0,Male
Zvi,1960,11,0,11,0.0,100.0,Male
Candido,1960,29,0,29,0.0,100.0,Male
Woodie,1960,24,0,24,0.0,100.0,Male
Loren,1960,752,95,657,12.632978723404255,87.36702127659575,Male
Adriel,1960,6,0,6,0.0,100.0,Male
Eluterio,1960,6,0,6,0.0,100.0,Male
Jene,1960,20,15,5,75.0,25.0,Unisex
Courtney,1960,178,62,116,34.831460674157306,65.1685393258427,Unisex
Dietrich,1960,14,5,9,35.714285714285715,64.28571428571429,Unisex
Larue,1960,32,19,13,59.375,40.625,Unisex
Lauris,1960,10,5,5,50.0,50.0,Unisex
Trinidad,1960,68,29,39,42.64705882352941,57.35294117647059,Unisex
Kerry,1960,3127,952,2175,30.44451551007356,69.55548448992644,Unisex
Hallie,1960,59,50,9,84.7457627118644,15.254237288135592,Unisex
Kennie,1960,44,7,37,15.909090909090908,84.0909090909091,Unisex
Lennie,1960,103,28,75,27.184466019417474,72.81553398058253,Unisex
Ronell,1960,34,6,28,17.647058823529413,82.35294117647058,Unisex
Lin,1960,51,35,16,68.62745098039215,31.37254901960784,Unisex
Merlyn,1960,27,11,16,40.74074074074074,59.25925925925925,Unisex
Barrie,1960,133,109,24,81.95488721804512,18.045112781954884,Unisex
Caroll,1960,23,17,6,73.91304347826086,26.08695652173913,Unisex
Nieves,1960,14,9,5,64.28571428571429,35.714285714285715,Unisex
Ladell,1960,25,7,18,28.000000000000004,72.0,Unisex
Andra,1960,232,161,71,69.39655172413794,30.603448275862068,Unisex
Waverly,1960,36,7,29,19.444444444444446,80.55555555555556,Unisex
Lavern,1960,237,142,95,59.91561181434599,40.08438818565401,Unisex
Michel,1960,324,56,268,17.28395061728395,82.71604938271605,Unisex
Garnet,1960,46,28,18,60.86956521739131,39.130434782608695,Unisex
Andree,1960,65,52,13,80.0,20.0,Unisex
Marcell,1960,45,26,19,57.77777777777777,42.22222222222222,Unisex
Vada,1960,54,43,11,79.62962962962963,20.37037037037037,Unisex
Marshell,1960,32,19,13,59.375,40.625,Unisex
Ardis,1960,32,26,6,81.25,18.75,Unisex
Brook,1960,51,12,39,23.52941176470588,76.47058823529412,Unisex
Jonell,1961,34,34,0,100.0,0.0,Female
Era,1961,15,15,0,100.0,0.0,Female
Lona,1961,100,100,0,100.0,0.0,Female
Graig,1961,24,0,24,0.0,100.0,Male
Duval,1961,8,0,8,0.0,100.0,Male
Godfrey,1961,40,0,40,0.0,100.0,Male
Casey,1961,420,60,360,14.285714285714285,85.71428571428571,Male
Santos,1961,172,19,153,11.046511627906977,88.95348837209302,Male
Arick,1961,5,0,5,0.0,100.0,Male
Quinten,1961,8,0,8,0.0,100.0,Male
Eduard,1961,18,0,18,0.0,100.0,Male
Vick,1961,9,0,9,0.0,100.0,Male
Sinclair,1961,13,0,13,0.0,100.0,Male
Gilbert,1961,1715,7,1708,0.4081632653061224,99.59183673469389,Male
Adrian,1961,745,112,633,15.033557046979864,84.96644295302013,Unisex
Wynn,1961,47,13,34,27.659574468085108,72.3404255319149,Unisex
Marlowe,1961,26,5,21,19.23076923076924,80.76923076923077,Unisex
Jonnie,1961,86,60,26,69.76744186046511,30.23255813953488,Unisex
Allie,1961,55,42,13,76.36363636363637,23.63636363636364,Unisex
Monti,1961,22,6,16,27.27272727272727,72.72727272727273,Unisex
Ladell,1961,16,5,11,31.25,68.75,Unisex
Diamond,1961,12,5,7,41.66666666666667,58.333333333333336,Unisex
Jeryl,1961,33,17,16,51.51515151515152,48.48484848484848,Unisex
Kristan,1961,42,34,8,80.95238095238095,19.047619047619047,Unisex
Ivory,1961,166,48,118,28.915662650602407,71.08433734939759,Unisex
Lesly,1961,35,28,7,80.0,20.0,Unisex
Rosario,1961,205,156,49,76.09756097560975,23.902439024390244,Unisex
Valentine,1961,34,8,26,23.52941176470588,76.47058823529412,Unisex
Nickie,1961,88,57,31,64.77272727272727,35.22727272727273,Unisex
Marlen,1961,14,8,6,57.14285714285714,42.85714285714285,Unisex
Marlyn,1961,74,58,16,78.37837837837837,21.62162162162162,Unisex
Hollis,1961,141,34,107,24.113475177304963,75.88652482269504,Unisex
Vinnie,1961,29,20,9,68.96551724137932,31.03448275862069,Unisex
Carlee,1961,13,6,7,46.15384615384615,53.84615384615385,Unisex
Wallis,1961,13,7,6,53.84615384615385,46.15384615384615,Unisex
Laurin,1961,18,12,6,66.66666666666666,33.33333333333333,Unisex
Audry,1961,37,31,6,83.78378378378379,16.216216216216218,Unisex
Lyndell,1961,48,11,37,22.916666666666664,77.08333333333334,Unisex
Shon,1961,52,18,34,34.61538461538461,65.38461538461539,Unisex
Brooke,1961,172,121,51,70.34883720930233,29.65116279069768,Unisex
Lindsay,1961,183,58,125,31.693989071038253,68.30601092896174,Unisex
Britt,1961,121,22,99,18.181818181818183,81.81818181818183,Unisex
Roe,1961,16,5,11,31.25,68.75,Unisex
Dyana,1962,15,15,0,100.0,0.0,Female
Shanta,1962,16,16,0,100.0,0.0,Female
Kathern,1962,38,38,0,100.0,0.0,Female
Jeannette,1962,914,909,5,99.45295404814004,0.5470459518599562,Female
Lynee,1962,7,7,0,100.0,0.0,Female
Lynell,1962,59,52,7,88.13559322033898,11.864406779661016,Female
Bobie,1962,5,0,5,0.0,100.0,Male
Larence,1962,7,0,7,0.0,100.0,Male
Selwyn,1962,37,0,37,0.0,100.0,Male
Casimiro,1962,8,0,8,0.0,100.0,Male
Stan,1962,309,0,309,0.0,100.0,Male
Salvador,1962,292,5,287,1.7123287671232876,98.28767123287672,Male
Burt,1962,109,0,109,0.0,100.0,Male
Keith,1962,11679,56,11623,0.4794931072865828,99.5205068927134,Male
Dino,1962,308,0,308,0.0,100.0,Male
Lafe,1962,11,0,11,0.0,100.0,Male
Clenton,1962,7,0,7,0.0,100.0,Male
Glenwood,1962,24,0,24,0.0,100.0,Male
Autry,1962,13,0,13,0.0,100.0,Male
Cliffton,1962,23,0,23,0.0,100.0,Male
Salvator,1962,8,0,8,0.0,100.0,Male
Marquette,1962,17,9,8,52.94117647058824,47.05882352941176,Unisex
Clair,1962,97,34,63,35.051546391752574,64.94845360824742,Unisex
Shanon,1962,32,20,12,62.5,37.5,Unisex
Merritt,1962,52,13,39,25.0,75.0,Unisex
Deane,1962,45,15,30,33.33333333333333,66.66666666666666,Unisex
Elza,1962,21,12,9,57.14285714285714,42.85714285714285,Unisex
Aundra,1962,35,10,25,28.57142857142857,71.42857142857143,Unisex
Chesley,1962,22,5,17,22.727272727272727,77.27272727272727,Unisex
Kelly,1962,14386,11529,2857,80.14041429167246,19.85958570832754,Unisex
Leverne,1962,19,7,12,36.84210526315789,63.1578947368421,Unisex
Kem,1962,55,31,24,56.36363636363636,43.63636363636363,Unisex
Bobbie,1962,1032,876,156,84.88372093023256,15.11627906976744,Unisex
Peyton,1962,35,7,28,20.0,80.0,Unisex
Jeryl,1962,27,19,8,70.37037037037037,29.629629629629623,Unisex
Young,1962,18,6,12,33.33333333333333,66.66666666666666,Unisex
Carlis,1962,21,7,14,33.33333333333333,66.66666666666666,Unisex
Ines,1962,48,40,8,83.33333333333334,16.666666666666664,Unisex
Arlee,1962,11,5,6,45.45454545454545,54.54545454545454,Unisex
Parris,1962,32,13,19,40.625,59.375,Unisex
Sammie,1962,301,57,244,18.93687707641196,81.06312292358804,Unisex
Maurie,1962,22,15,7,68.18181818181817,31.818181818181817,Unisex
Daine,1962,13,7,6,53.84615384615385,46.15384615384615,Unisex
Toby,1962,445,85,360,19.101123595505616,80.89887640449437,Unisex
Jai,1962,15,7,8,46.66666666666666,53.333333333333336,Unisex
Darby,1962,80,44,36,55.00000000000001,45.0,Unisex
Guadalupe,1962,661,421,240,63.69137670196672,36.30862329803328,Unisex
Suzzette,1963,23,23,0,100.0,0.0,Female
Abbe,1963,22,22,0,100.0,0.0,Female
Lyndal,1963,6,0,6,0.0,100.0,Male
Gayland,1963,16,0,16,0.0,100.0,Male
Berkley,1963,14,0,14,0.0,100.0,Male
Marlowe,1963,16,0,16,0.0,100.0,Male
Scott,1963,30482,80,30402,0.2624499704743783,99.73755002952562,Male
Donnie,1963,1211,57,1154,4.706853839801816,95.29314616019818,Male
Rosendo,1963,48,0,48,0.0,100.0,Male
Ellison,1963,8,0,8,0.0,100.0,Male
Jakob,1963,5,0,5,0.0,100.0,Male
Oliver,1963,359,0,359,0.0,100.0,Male
Rony,1963,5,0,5,0.0,100.0,Male
Payton,1963,16,0,16,0.0,100.0,Male
Ariel,1963,38,9,29,23.684210526315788,76.31578947368422,Unisex
Young,1963,20,6,14,30.0,70.0,Unisex
Carmon,1963,31,26,5,83.87096774193549,16.129032258064516,Unisex
Kenyatta,1963,27,11,16,40.74074074074074,59.25925925925925,Unisex
Daniele,1963,22,12,10,54.54545454545454,45.45454545454545,Unisex
Desi,1963,54,22,32,40.74074074074074,59.25925925925925,Unisex
Corby,1963,34,8,26,23.52941176470588,76.47058823529412,Unisex
Blythe,1963,32,27,5,84.375,15.625,Unisex
Kary,1963,92,42,50,45.65217391304348,54.34782608695652,Unisex
Ricci,1963,33,8,25,24.24242424242424,75.75757575757575,Unisex
Lesley,1963,438,350,88,79.90867579908677,20.09132420091324,Unisex
Jessie,1963,1306,400,906,30.627871362940272,69.37212863705973,Unisex
Mell,1963,11,6,5,54.54545454545454,45.45454545454545,Unisex
Derry,1963,33,5,28,15.151515151515152,84.84848484848484,Unisex
Samie,1963,11,5,6,45.45454545454545,54.54545454545454,Unisex
Shayne,1963,106,21,85,19.81132075471698,80.18867924528303,Unisex
Arie,1963,17,7,10,41.17647058823529,58.82352941176471,Unisex
Kimble,1963,24,5,19,20.833333333333336,79.16666666666666,Unisex
Linden,1963,35,6,29,17.142857142857142,82.85714285714286,Unisex
Marlen,1963,20,13,7,65.0,35.0,Unisex
Golden,1963,28,7,21,25.0,75.0,Unisex
Brook,1963,101,20,81,19.8019801980198,80.19801980198021,Unisex
Cory,1963,465,71,394,15.268817204301074,84.73118279569893,Unisex
Lorenza,1963,73,25,48,34.24657534246575,65.75342465753424,Unisex
Vada,1963,59,38,21,64.40677966101694,35.59322033898305,Unisex
Ardell,1963,32,9,23,28.125,71.875,Unisex
Val,1963,156,59,97,37.82051282051282,62.17948717948718,Unisex
Maurie,1964,13,13,0,100.0,0.0,Female
Kathlee,1964,7,7,0,100.0,0.0,Female
Phoebe,1964,100,100,0,100.0,0.0,Female
Wynter,1964,8,8,0,100.0,0.0,Female
Shanda,1964,98,98,0,100.0,0.0,Female
Jerlean,1964,7,7,0,100.0,0.0,Female
Antoinett,1964,11,11,0,100.0,0.0,Female
Quinn,1964,134,14,120,10.44776119402985,89.55223880597015,Male
Cipriano,1964,20,0,20,0.0,100.0,Male
Osborne,1964,15,0,15,0.0,100.0,Male
Monroe,1964,76,0,76,0.0,100.0,Male
Bernie,1964,178,12,166,6.741573033707865,93.25842696629212,Male
Jones,1964,11,0,11,0.0,100.0,Male
Fremont,1964,8,0,8,0.0,100.0,Male
Llewellyn,1964,34,0,34,0.0,100.0,Male
Bennett,1964,189,0,189,0.0,100.0,Male
Berry,1964,92,8,84,8.695652173913043,91.30434782608695,Male
Avon,1964,10,0,10,0.0,100.0,Male
Rosevelt,1964,11,0,11,0.0,100.0,Male
Corby,1964,28,9,19,32.142857142857146,67.85714285714286,Unisex
Kem,1964,50,23,27,46.0,54.0,Unisex
Lesly,1964,45,34,11,75.55555555555556,24.444444444444443,Unisex
Adrian,1964,944,160,784,16.94915254237288,83.05084745762711,Unisex
Aundra,1964,35,8,27,22.857142857142858,77.14285714285715,Unisex
Ladon,1964,18,6,12,33.33333333333333,66.66666666666666,Unisex
Teryl,1964,25,15,10,60.0,40.0,Unisex
Terrel,1964,24,6,18,25.0,75.0,Unisex
Mallory,1964,37,19,18,51.35135135135135,48.64864864864865,Unisex
Remi,1964,15,5,10,33.33333333333333,66.66666666666666,Unisex
Hollis,1964,130,34,96,26.15384615384616,73.84615384615385,Unisex
Loy,1964,32,7,25,21.875,78.125,Unisex
Clair,1964,78,26,52,33.33333333333333,66.66666666666666,Unisex
Kit,1964,63,26,37,41.26984126984127,58.730158730158735,Unisex
Lyndell,1964,52,14,38,26.923076923076923,73.07692307692307,Unisex
Levon,1964,52,13,39,25.0,75.0,Unisex
Jamey,1964,105,25,80,23.809523809523807,76.19047619047619,Unisex
Rossie,1964,11,6,5,54.54545454545454,45.45454545454545,Unisex
Kc,1964,16,5,11,31.25,68.75,Unisex
Ashley,1964,291,181,110,62.19931271477663,37.80068728522337,Unisex
Devon,1964,178,63,115,35.39325842696629,64.60674157303372,Unisex
Dene,1964,21,14,7,66.66666666666666,33.33333333333333,Unisex
Nicola,1964,81,44,37,54.32098765432099,45.67901234567901,Unisex
Delane,1964,46,29,17,63.04347826086957,36.95652173913043,Unisex
Cam,1964,31,14,17,45.16129032258064,54.83870967741935,Unisex
Linnie,1964,24,14,10,58.333333333333336,41.66666666666667,Unisex
Cinda,1965,65,65,0,100.0,0.0,Female
Lorena,1965,344,344,0,100.0,0.0,Female
Zola,1965,16,16,0,100.0,0.0,Female
Annita,1965,21,21,0,100.0,0.0,Female
Leonor,1965,64,64,0,100.0,0.0,Female
Stefany,1965,7,7,0,100.0,0.0,Female
Annalise,1965,7,7,0,100.0,0.0,Female
Sari,1965,60,60,0,100.0,0.0,Female
Orlan,1965,7,0,7,0.0,100.0,Male
Luiz,1965,14,0,14,0.0,100.0,Male
Seymour,1965,16,0,16,0.0,100.0,Male
Vick,1965,7,0,7,0.0,100.0,Male
Salvador,1965,316,0,316,0.0,100.0,Male
Cletus,1965,54,0,54,0.0,100.0,Male
Constantino,1965,15,0,15,0.0,100.0,Male
Keir,1965,6,0,6,0.0,100.0,Male
Luke,1965,400,0,400,0.0,100.0,Male
Marlan,1965,11,0,11,0.0,100.0,Male
Alexander,1965,1331,10,1321,0.7513148009015778,99.24868519909842,Male
Andreas,1965,69,0,69,0.0,100.0,Male
Khris,1965,13,8,5,61.53846153846154,38.46153846153847,Unisex
Linnie,1965,35,25,10,71.42857142857143,28.57142857142857,Unisex
Desi,1965,39,22,17,56.41025641025641,43.58974358974359,Unisex
Parris,1965,30,12,18,40.0,60.0,Unisex
Allyn,1965,58,21,37,36.206896551724135,63.793103448275865,Unisex
Lael,1965,16,10,6,62.5,37.5,Unisex
Shanon,1965,78,49,29,62.82051282051282,37.17948717948718,Unisex
Arlyn,1965,28,8,20,28.57142857142857,71.42857142857143,Unisex
Valentine,1965,63,18,45,28.57142857142857,71.42857142857143,Unisex
Shay,1965,41,33,8,80.48780487804879,19.51219512195122,Unisex
Le,1965,24,17,7,70.83333333333334,29.166666666666668,Unisex
Jammie,1965,92,58,34,63.04347826086957,36.95652173913043,Unisex
Dana,1965,5939,4722,1217,79.50833473648763,20.491665263512377,Unisex
Romie,1965,11,5,6,45.45454545454545,54.54545454545454,Unisex
Ladon,1965,20,7,13,35.0,65.0,Unisex
Leslie,1965,6294,4876,1418,77.47060692723228,22.529393072767714,Unisex
Concepcion,1965,54,43,11,79.62962962962963,20.37037037037037,Unisex
Dell,1965,83,31,52,37.34939759036144,62.65060240963856,Unisex
Tandy,1965,53,35,18,66.0377358490566,33.9622641509434,Unisex
Glendale,1965,16,5,11,31.25,68.75,Unisex
Mallory,1965,33,17,16,51.51515151515152,48.48484848484848,Unisex
Willia,1965,18,11,7,61.11111111111112,38.88888888888889,Unisex
Yalanda,1966,13,13,0,100.0,0.0,Female
Cinderella,1966,8,8,0,100.0,0.0,Female
Cristal,1966,33,33,0,100.0,0.0,Female
Edythe,1966,28,28,0,100.0,0.0,Female
Claudia,1966,796,796,0,100.0,0.0,Female
Micha,1966,6,6,0,100.0,0.0,Female
Vittoria,1966,9,9,0,100.0,0.0,Female
Ramona,1966,1151,1146,5,99.56559513466551,0.4344048653344918,Female
Rex,1966,718,0,718,0.0,100.0,Male
Larson,1966,6,0,6,0.0,100.0,Male
Lennis,1966,12,0,12,0.0,100.0,Male
Alexander,1966,1379,8,1371,0.580130529369108,99.4198694706309,Male
Merrell,1966,12,0,12,0.0,100.0,Male
Rolly,1966,6,0,6,0.0,100.0,Male
Dawson,1966,16,0,16,0.0,100.0,Male
Fortunato,1966,7,0,7,0.0,100.0,Male
Galen,1966,179,6,173,3.35195530726257,96.64804469273744,Male
Joesph,1966,219,5,214,2.28310502283105,97.71689497716896,Male
Burdette,1966,5,0,5,0.0,100.0,Male
Myron,1966,420,5,415,1.1904761904761905,98.8095238095238,Male
Alfred,1966,1621,13,1608,0.8019740900678594,99.19802590993214,Male
Seymour,1966,18,0,18,0.0,100.0,Male
Shon,1966,113,21,92,18.58407079646018,81.41592920353983,Unisex
Rossie,1966,18,6,12,33.33333333333333,66.66666666666666,Unisex
Rosario,1966,145,102,43,70.34482758620689,29.655172413793103,Unisex
Montie,1966,33,6,27,18.181818181818183,81.81818181818183,Unisex
Dennie,1966,59,12,47,20.33898305084746,79.66101694915254,Unisex
Stephane,1966,20,14,6,70.0,30.0,Unisex
Shannon,1966,4149,2992,1157,72.11376235237407,27.886237647625933,Unisex
Danell,1966,43,36,7,83.72093023255815,16.27906976744186,Unisex
Lacey,1966,39,27,12,69.23076923076923,30.76923076923077,Unisex
Pepper,1966,22,17,5,77.27272727272727,22.727272727272727,Unisex
Donell,1966,90,19,71,21.11111111111111,78.88888888888889,Unisex
Torey,1966,18,6,12,33.33333333333333,66.66666666666666,Unisex
Cortney,1966,27,16,11,59.25925925925925,40.74074074074074,Unisex
Tally,1966,13,7,6,53.84615384615385,46.15384615384615,Unisex
Donnis,1966,14,6,8,42.85714285714285,57.14285714285714,Unisex
Delaney,1966,16,8,8,50.0,50.0,Unisex
Drue,1966,13,7,6,53.84615384615385,46.15384615384615,Unisex
Romie,1966,16,5,11,31.25,68.75,Unisex
Loran,1966,38,6,32,15.789473684210526,84.21052631578947,Unisex
Parris,1966,26,7,19,26.923076923076923,73.07692307692307,Unisex
Kalen,1966,12,6,6,50.0,50.0,Unisex
Dietrich,1966,36,8,28,22.22222222222222,77.77777777777779,Unisex
Jan,1966,1043,842,201,80.72866730584852,19.27133269415149,Unisex
Paris,1966,98,39,59,39.795918367346935,60.204081632653065,Unisex
Stormy,1966,33,28,5,84.84848484848484,15.151515151515152,Unisex
France,1966,27,20,7,74.07407407407408,25.925925925925924,Unisex
Yvon,1966,10,5,5,50.0,50.0,Unisex
Kirsten,1967,824,816,8,99.02912621359224,0.9708737864077668,Female
Sha,1967,6,6,0,100.0,0.0,Female
Marge,1967,14,14,0,100.0,0.0,Female
Concepcion,1967,53,46,7,86.79245283018868,13.20754716981132,Female
Karon,1967,77,77,0,100.0,0.0,Female
Vittoria,1967,14,14,0,100.0,0.0,Female
Marlee,1967,19,19,0,100.0,0.0,Female
Leighanne,1967,10,10,0,100.0,0.0,Female
Cornelio,1967,14,0,14,0.0,100.0,Male
Carlin,1967,14,0,14,0.0,100.0,Male
Darion,1967,28,0,28,0.0,100.0,Male
Lavance,1967,8,0,8,0.0,100.0,Male
Merrell,1967,10,0,10,0.0,100.0,Male
Carleton,1967,43,0,43,0.0,100.0,Male
Creighton,1967,25,0,25,0.0,100.0,Male
Danial,1967,165,0,165,0.0,100.0,Male
Irby,1967,6,0,6,0.0,100.0,Male
Burt,1967,97,0,97,0.0,100.0,Male
Levon,1967,22,0,22,0.0,100.0,Male
Ammon,1967,9,0,9,0.0,100.0,Male
Jessie,1967,1171,373,798,31.8531169940222,68.1468830059778,Unisex
Artie,1967,68,15,53,22.058823529411764,77.94117647058823,Unisex
Kendall,1967,484,88,396,18.181818181818183,81.81818181818183,Unisex
Merril,1967,11,5,6,45.45454545454545,54.54545454545454,Unisex
Krishna,1967,21,11,10,52.38095238095239,47.61904761904761,Unisex
Dann,1967,59,48,11,81.35593220338984,18.64406779661017,Unisex
Tonie,1967,53,42,11,79.24528301886792,20.75471698113208,Unisex
Andra,1967,243,151,92,62.13991769547325,37.86008230452675,Unisex
Sonnie,1967,15,10,5,66.66666666666666,33.33333333333333,Unisex
Danell,1967,51,43,8,84.31372549019608,15.68627450980392,Unisex
Rainey,1967,12,6,6,50.0,50.0,Unisex
Vada,1967,30,18,12,60.0,40.0,Unisex
Audie,1967,53,10,43,18.867924528301888,81.13207547169812,Unisex
Tal,1967,14,5,9,35.714285714285715,64.28571428571429,Unisex
Cary,1967,740,111,629,15.0,85.0,Unisex
Maryland,1967,24,18,6,75.0,25.0,Unisex
Valentine,1967,40,8,32,20.0,80.0,Unisex
Jeryl,1967,22,11,11,50.0,50.0,Unisex
Desi,1967,31,10,21,32.25806451612903,67.74193548387096,Unisex
Nicky,1967,181,29,152,16.022099447513813,83.97790055248619,Unisex
Marice,1967,19,10,9,52.63157894736842,47.368421052631575,Unisex
Arden,1967,37,12,25,32.432432432432435,67.56756756756756,Unisex
Kalen,1967,15,10,5,66.66666666666666,33.33333333333333,Unisex
Larue,1967,15,6,9,40.0,60.0,Unisex
Lupe,1967,198,147,51,74.24242424242425,25.75757575757576,Unisex
Lorriane,1968,22,22,0,100.0,0.0,Female
Debora,1968,581,581,0,100.0,0.0,Female
Carolynn,1968,82,82,0,100.0,0.0,Female
Ila,1968,36,36,0,100.0,0.0,Female
Rita,1968,2087,2076,11,99.47292764734068,0.5270723526593196,Female
Cristobal,1968,42,0,42,0.0,100.0,Male
Prescott,1968,17,0,17,0.0,100.0,Male
Saverio,1968,23,0,23,0.0,100.0,Male
Demone,1968,5,0,5,0.0,100.0,Male
Spencer,1968,547,7,540,1.279707495429616,98.72029250457038,Male
Primitivo,1968,8,0,8,0.0,100.0,Male
Moshe,1968,50,0,50,0.0,100.0,Male
Cedric,1968,695,5,690,0.7194244604316548,99.28057553956836,Male
Coy,1968,106,5,101,4.716981132075472,95.28301886792453,Male
Lars,1968,88,0,88,0.0,100.0,Male
Ike,1968,34,0,34,0.0,100.0,Male
Verdell,1968,34,13,21,38.23529411764706,61.76470588235294,Unisex
Laney,1968,19,12,7,63.1578947368421,36.84210526315789,Unisex
Mikell,1968,17,7,10,41.17647058823529,58.82352941176471,Unisex
Shenandoah,1968,11,5,6,45.45454545454545,54.54545454545454,Unisex
Devon,1968,247,85,162,34.41295546558704,65.58704453441295,Unisex
Devan,1968,26,6,20,23.07692307692308,76.92307692307693,Unisex
Courtenay,1968,49,41,8,83.6734693877551,16.3265306122449,Unisex
Jamy,1968,19,11,8,57.89473684210527,42.10526315789473,Unisex
Diamond,1968,17,9,8,52.94117647058824,47.05882352941176,Unisex
Lin,1968,24,11,13,45.83333333333333,54.16666666666666,Unisex
Orlanda,1968,35,14,21,40.0,60.0,Unisex
Waverly,1968,23,7,16,30.434782608695656,69.56521739130434,Unisex
Delane,1968,35,21,14,60.0,40.0,Unisex
Levon,1968,31,8,23,25.806451612903224,74.19354838709677,Unisex
Quincy,1968,109,17,92,15.59633027522936,84.40366972477065,Unisex
Unknown,1968,50,19,31,38.0,62.0,Unisex
Niko,1968,16,10,6,62.5,37.5,Unisex
Marvelle,1968,12,7,5,58.333333333333336,41.66666666666667,Unisex
Hollis,1968,105,18,87,17.142857142857142,82.85714285714286,Unisex
Marice,1968,17,5,12,29.411764705882355,70.58823529411765,Unisex
Jessie,1968,1036,320,716,30.888030888030887,69.1119691119691,Unisex
Jan,1968,833,655,178,78.63145258103242,21.368547418967587,Unisex
Dusty,1968,109,38,71,34.86238532110092,65.13761467889908,Unisex
Lynell,1968,65,53,12,81.53846153846153,18.461538461538463,Unisex
Billie,1968,968,815,153,84.19421487603306,15.805785123966942,Unisex
Andree,1968,45,34,11,75.55555555555556,24.444444444444443,Unisex
Brit,1968,19,6,13,31.57894736842105,68.42105263157895,Unisex
Guadalupe,1968,632,391,241,61.86708860759494,38.13291139240506,Unisex
Shay,1968,66,34,32,51.51515151515152,48.48484848484848,Unisex
Deshawn,1968,68,39,29,57.35294117647059,42.64705882352941,Unisex
Ninette,1969,13,13,0,100.0,0.0,Female
Violeta,1969,28,28,0,100.0,0.0,Female
Katharina,1969,28,28,0,100.0,0.0,Female
Lynee,1969,12,12,0,100.0,0.0,Female
Lue,1969,11,11,0,100.0,0.0,Female
Dessie,1969,20,20,0,100.0,0.0,Female
Suzette,1969,561,561,0,100.0,0.0,Female
Maretta,1969,12,12,0,100.0,0.0,Female
Makeba,1969,33,33,0,100.0,0.0,Female
Ilan,1969,8,0,8,0.0,100.0,Male
Yusef,1969,23,0,23,0.0,100.0,Male
Art,1969,43,0,43,0.0,100.0,Male
Pierre,1969,188,0,188,0.0,100.0,Male
Bart,1969,552,0,552,0.0,100.0,Male
Avon,1969,16,6,10,37.5,62.5,Unisex
Ronell,1969,26,13,13,50.0,50.0,Unisex
Marquette,1969,33,15,18,45.45454545454545,54.54545454545454,Unisex
Elan,1969,29,19,10,65.51724137931035,34.48275862068966,Unisex
Ashley,1969,835,641,194,76.76646706586826,23.233532934131738,Unisex
Clemmie,1969,14,7,7,50.0,50.0,Unisex
Cortney,1969,59,32,27,54.23728813559322,45.76271186440678,Unisex
Robie,1969,36,13,23,36.11111111111111,63.888888888888886,Unisex
Andree,1969,44,26,18,59.09090909090909,40.909090909090914,Unisex
Andra,1969,238,170,68,71.42857142857143,28.57142857142857,Unisex
Che,1969,75,19,56,25.333333333333336,74.66666666666667,Unisex
Tristan,1969,65,15,50,23.07692307692308,76.92307692307693,Unisex
Remi,1969,19,9,10,47.368421052631575,52.63157894736842,Unisex
Cleo,1969,72,33,39,45.83333333333333,54.16666666666666,Unisex
Yuri,1969,35,10,25,28.57142857142857,71.42857142857143,Unisex
Antoinett,1970,7,7,0,100.0,0.0,Female
Megen,1970,6,6,0,100.0,0.0,Female
Gilda,1970,65,65,0,100.0,0.0,Female
Darcey,1970,83,77,6,92.7710843373494,7.228915662650602,Female
Lorriane,1970,21,21,0,100.0,0.0,Female
Dudley,1970,56,0,56,0.0,100.0,Male
Reese,1970,71,0,71,0.0,100.0,Male
Arafat,1970,5,0,5,0.0,100.0,Male
Constantino,1970,11,0,11,0.0,100.0,Male
Merlin,1970,48,0,48,0.0,100.0,Male
Whitney,1970,430,351,79,81.62790697674419,18.37209302325581,Unisex
Dominque,1970,13,8,5,61.53846153846154,38.46153846153847,Unisex
Lou,1970,199,159,40,79.89949748743719,20.100502512562816,Unisex
Jessy,1970,21,5,16,23.809523809523807,76.19047619047619,Unisex
Marquette,1970,31,14,17,45.16129032258064,54.83870967741935,Unisex
Cleo,1970,67,32,35,47.76119402985074,52.23880597014925,Unisex
Germaine,1970,100,71,29,71.0,29.0,Unisex
Sky,1970,25,6,19,24.0,76.0,Unisex
Tobey,1970,49,26,23,53.06122448979592,46.93877551020408,Unisex
Waverly,1970,24,5,19,20.833333333333336,79.16666666666666,Unisex
Kriston,1970,24,13,11,54.16666666666666,45.83333333333333,Unisex
Cassidy,1970,25,12,13,48.0,52.0,Unisex
Jene,1970,20,13,7,65.0,35.0,Unisex
Orlanda,1970,32,7,25,21.875,78.125,Unisex
Torri,1970,39,32,7,82.05128205128204,17.94871794871795,Unisex
Dominique,1970,199,156,43,78.39195979899498,21.608040201005025,Unisex
Donta,1970,25,6,19,24.0,76.0,Unisex
Demetri,1970,26,5,21,19.23076923076924,80.76923076923077,Unisex
Laurin,1970,19,13,6,68.42105263157895,31.57894736842105,Unisex
Jade,1970,200,82,118,41.0,59.0,Unisex
Dietrich,1970,38,10,28,26.31578947368421,73.68421052631578,Unisex
Ines,1970,39,33,6,84.61538461538461,15.384615384615383,Unisex
Jackey,1970,17,5,12,29.411764705882355,70.58823529411765,Unisex
Kelsey,1970,119,48,71,40.33613445378151,59.66386554621849,Unisex
Ellison,1970,20,5,15,25.0,75.0,Unisex
Leonarda,1971,5,5,0,100.0,0.0,Female
Marine,1971,5,5,0,100.0,0.0,Female
Lovely,1971,7,7,0,100.0,0.0,Female
Damita,1971,22,22,0,100.0,0.0,Female
Indy,1971,5,5,0,100.0,0.0,Female
Arnoldo,1971,60,0,60,0.0,100.0,Male
Buell,1971,5,0,5,0.0,100.0,Male
Arlie,1971,25,0,25,0.0,100.0,Male
Darris,1971,32,0,32,0.0,100.0,Male
Wendell,1971,535,0,535,0.0,100.0,Male
Randol,1971,7,0,7,0.0,100.0,Male
Carlito,1971,7,0,7,0.0,100.0,Male
Christophor,1971,35,0,35,0.0,100.0,Male
Curtis,1971,3452,24,3428,0.6952491309385863,99.3047508690614,Male
Cipriano,1971,32,0,32,0.0,100.0,Male
Rui,1971,20,0,20,0.0,100.0,Male
Garey,1971,15,0,15,0.0,100.0,Male
Rustin,1971,36,0,36,0.0,100.0,Male
Nickie,1971,108,81,27,75.0,25.0,Unisex
Ladell,1971,16,6,10,37.5,62.5,Unisex
Torri,1971,39,32,7,82.05128205128204,17.94871794871795,Unisex
Trinity,1971,36,29,7,80.55555555555556,19.444444444444446,Unisex
Tristan,1971,112,22,90,19.642857142857142,80.35714285714286,Unisex
Lacy,1971,81,41,40,50.617283950617285,49.38271604938272,Unisex
Shawne,1971,63,37,26,58.730158730158735,41.26984126984127,Unisex
Marvel,1971,22,6,16,27.27272727272727,72.72727272727273,Unisex
Kit,1971,61,15,46,24.59016393442623,75.40983606557377,Unisex
Kelsey,1971,143,71,72,49.65034965034965,50.349650349650354,Unisex
Sky,1971,30,6,24,20.0,80.0,Unisex
Tobie,1971,52,36,16,69.23076923076923,30.76923076923077,Unisex
Barrie,1971,35,25,10,71.42857142857143,28.57142857142857,Unisex
Deondra,1971,30,21,9,70.0,30.0,Unisex
Robbie,1971,871,213,658,24.45464982778416,75.54535017221585,Unisex
Laurin,1971,20,14,6,70.0,30.0,Unisex
Delaney,1971,29,11,18,37.93103448275862,62.06896551724138,Unisex
Danie,1971,14,8,6,57.14285714285714,42.85714285714285,Unisex
Min,1971,11,5,6,45.45454545454545,54.54545454545454,Unisex
Vonnie,1972,28,28,0,100.0,0.0,Female
Shelly,1972,3326,3288,38,98.8574864702345,1.142513529765484,Female
Eleazar,1972,37,0,37,0.0,100.0,Male
Charle,1972,12,0,12,0.0,100.0,Male
Mario,1972,1956,28,1928,1.4314928425357871,98.5685071574642,Male
Hugo,1972,174,0,174,0.0,100.0,Male
Lazaro,1972,70,0,70,0.0,100.0,Male
Rand,1972,15,0,15,0.0,100.0,Male
Carmello,1972,6,0,6,0.0,100.0,Male
Quinn,1972,129,12,117,9.30232558139535,90.69767441860463,Male
Glendale,1972,5,0,5,0.0,100.0,Male
Mckay,1972,5,0,5,0.0,100.0,Male
Jc,1972,13,0,13,0.0,100.0,Male
Ahmad,1972,58,0,58,0.0,100.0,Male
Doyle,1972,160,0,160,0.0,100.0,Male
Elroy,1972,46,0,46,0.0,100.0,Male
Cordell,1972,57,0,57,0.0,100.0,Male
Shawnta,1972,38,31,7,81.57894736842105,18.421052631578945,Unisex
Sol,1972,43,17,26,39.53488372093023,60.46511627906976,Unisex
Amani,1972,21,12,9,57.14285714285714,42.85714285714285,Unisex
Cayce,1972,15,7,8,46.66666666666666,53.333333333333336,Unisex
Ali,1972,219,100,119,45.662100456621005,54.337899543379,Unisex
Holland,1972,21,9,12,42.85714285714285,57.14285714285714,Unisex
Page,1972,58,45,13,77.58620689655173,22.41379310344828,Unisex
Errin,1972,25,12,13,48.0,52.0,Unisex
Corin,1972,24,13,11,54.16666666666666,45.83333333333333,Unisex
Peyton,1972,38,15,23,39.47368421052632,60.526315789473685,Unisex
Carey,1972,763,481,282,63.04062909567497,36.95937090432504,Unisex
Shilo,1972,54,35,19,64.81481481481481,35.18518518518518,Unisex
Jackey,1972,15,5,10,33.33333333333333,66.66666666666666,Unisex
Deondra,1972,20,12,8,60.0,40.0,Unisex
Brandyn,1972,12,7,5,58.333333333333336,41.66666666666667,Unisex
Leshawn,1972,36,14,22,38.88888888888889,61.11111111111112,Unisex
Shandon,1972,22,9,13,40.909090909090914,59.09090909090909,Unisex
Rene,1972,1221,456,765,37.34643734643734,62.65356265356266,Unisex
Lavern,1972,69,33,36,47.82608695652174,52.17391304347826,Unisex
Larrie,1972,17,9,8,52.94117647058824,47.05882352941176,Unisex
Sydney,1972,124,84,40,67.74193548387096,32.25806451612903,Unisex
Maris,1972,12,6,6,50.0,50.0,Unisex
Kelsey,1972,149,76,73,51.006711409395976,48.99328859060403,Unisex
Delane,1972,24,10,14,41.66666666666667,58.333333333333336,Unisex
Jeananne,1973,10,10,0,100.0,0.0,Female
Pollie,1973,5,5,0,100.0,0.0,Female
Vonnie,1973,18,18,0,100.0,0.0,Female
Cristal,1973,108,108,0,100.0,0.0,Female
Meggan,1973,40,40,0,100.0,0.0,Female
Albert,1973,2307,19,2288,0.8235804074555699,99.17641959254443,Male
Dagan,1973,7,0,7,0.0,100.0,Male
Mickey,1973,357,38,319,10.644257703081232,89.35574229691878,Male
Omarr,1973,16,0,16,0.0,100.0,Male
Anders,1973,23,0,23,0.0,100.0,Male
Primitivo,1973,10,0,10,0.0,100.0,Male
Domenic,1973,62,0,62,0.0,100.0,Male
Rodolfo,1973,374,0,374,0.0,100.0,Male
Gaylon,1973,40,0,40,0.0,100.0,Male
Sam,1973,484,6,478,1.2396694214876034,98.7603305785124,Male
Verdell,1973,23,7,16,30.434782608695656,69.56521739130434,Unisex
Errin,1973,31,23,8,74.19354838709677,25.806451612903224,Unisex
Cam,1973,17,9,8,52.94117647058824,47.05882352941176,Unisex
Kacy,1973,80,49,31,61.25000000000001,38.75,Unisex
Andie,1973,13,7,6,53.84615384615385,46.15384615384615,Unisex
Lyndell,1973,32,8,24,25.0,75.0,Unisex
Maxie,1973,27,7,20,25.925925925925924,74.07407407407408,Unisex
Jacky,1973,51,12,39,23.52941176470588,76.47058823529412,Unisex
Iran,1973,25,7,18,28.000000000000004,72.0,Unisex
Micky,1973,75,13,62,17.333333333333336,82.66666666666667,Unisex
Sherrill,1973,44,34,10,77.27272727272727,22.727272727272727,Unisex
Renell,1973,13,7,6,53.84615384615385,46.15384615384615,Unisex
Dana,1973,5947,4934,1013,82.96620144610728,17.03379855389272,Unisex
Dashawn,1973,38,11,27,28.94736842105264,71.05263157894737,Unisex
Baby,1973,36,12,24,33.33333333333333,66.66666666666666,Unisex
Lacy,1973,105,66,39,62.85714285714285,37.142857142857146,Unisex
Glennis,1973,13,8,5,61.53846153846154,38.46153846153847,Unisex
Natale,1973,14,7,7,50.0,50.0,Unisex
Germaine,1973,210,64,146,30.47619047619048,69.52380952380952,Unisex
Tal,1973,19,6,13,31.57894736842105,68.42105263157895,Unisex
Kateri,1974,23,23,0,100.0,0.0,Female
Sheree,1974,270,270,0,100.0,0.0,Female
Shanta,1974,186,177,9,95.16129032258064,4.838709677419355,Female
Marika,1974,39,39,0,100.0,0.0,Female
Gilda,1974,40,40,0,100.0,0.0,Female
Samantha,1974,2265,2253,12,99.47019867549668,0.5298013245033113,Female
Jamala,1974,6,6,0,100.0,0.0,Female
Nealy,1974,12,12,0,100.0,0.0,Female
Jasen,1974,181,0,181,0.0,100.0,Male
Ismael,1974,365,0,365,0.0,100.0,Male
Del,1974,43,0,43,0.0,100.0,Male
Anthon,1974,7,0,7,0.0,100.0,Male
Richey,1974,9,0,9,0.0,100.0,Male
Branden,1974,172,7,165,4.069767441860465,95.93023255813954,Male
Mackie,1974,9,0,9,0.0,100.0,Male
Micahel,1974,27,0,27,0.0,100.0,Male
Kris,1974,583,167,416,28.64493996569468,71.35506003430532,Unisex
Mickie,1974,58,46,12,79.3103448275862,20.6896551724138,Unisex
Roma,1974,14,9,5,64.28571428571429,35.714285714285715,Unisex
Nikola,1974,27,14,13,51.85185185185185,48.14814814814815,Unisex
Errin,1974,54,39,15,72.22222222222221,27.77777777777778,Unisex
Michel,1974,182,53,129,29.120879120879124,70.87912087912088,Unisex
Love,1974,38,29,9,76.31578947368422,23.684210526315788,Unisex
Rene,1974,1069,344,725,32.179607109448085,67.82039289055191,Unisex
Demetric,1974,83,23,60,27.710843373493976,72.28915662650603,Unisex
Kalen,1974,21,9,12,42.85714285714285,57.14285714285714,Unisex
Ali,1974,255,97,158,38.03921568627451,61.96078431372549,Unisex
Shayne,1974,300,76,224,25.333333333333336,74.66666666666667,Unisex
Jayme,1974,259,157,102,60.61776061776062,39.38223938223938,Unisex
Kelcey,1974,39,7,32,17.94871794871795,82.05128205128204,Unisex
Ivory,1974,90,28,62,31.11111111111111,68.88888888888889,Unisex
Loy,1974,18,5,13,27.77777777777778,72.22222222222221,Unisex
Payton,1974,18,5,13,27.77777777777778,72.22222222222221,Unisex
Carman,1974,62,52,10,83.87096774193549,16.129032258064516,Unisex
Lindell,1974,32,5,27,15.625,84.375,Unisex
Daine,1975,9,9,0,100.0,0.0,Female
Ingrid,1975,352,352,0,100.0,0.0,Female
Chiquita,1975,216,216,0,100.0,0.0,Female
Monti,1975,7,0,7,0.0,100.0,Male
Christophor,1975,25,0,25,0.0,100.0,Male
Idris,1975,18,0,18,0.0,100.0,Male
Omarr,1975,19,0,19,0.0,100.0,Male
Aldo,1975,67,0,67,0.0,100.0,Male
Ernie,1975,130,0,130,0.0,100.0,Male
Hilbert,1975,6,0,6,0.0,100.0,Male
Natanael,1975,6,0,6,0.0,100.0,Male
Immanuel,1975,16,0,16,0.0,100.0,Male
Aryn,1975,24,19,5,79.16666666666666,20.833333333333336,Unisex
Kasey,1975,439,309,130,70.3872437357631,29.6127562642369,Unisex
Cris,1975,36,14,22,38.88888888888889,61.11111111111112,Unisex
Johnell,1975,23,10,13,43.47826086956522,56.52173913043478,Unisex
Rosario,1975,167,125,42,74.8502994011976,25.1497005988024,Unisex
Garrie,1975,10,5,5,50.0,50.0,Unisex
Jade,1975,252,146,106,57.93650793650794,42.06349206349206,Unisex
Daniele,1975,150,122,28,81.33333333333333,18.666666666666668,Unisex
Nickie,1975,89,70,19,78.65168539325843,21.34831460674157,Unisex
Aubry,1975,12,6,6,50.0,50.0,Unisex
Matilde,1975,35,28,7,80.0,20.0,Unisex
Javon,1975,60,10,50,16.666666666666664,83.33333333333334,Unisex
Torian,1975,25,9,16,36.0,64.0,Unisex
Tonnie,1975,22,16,6,72.72727272727273,27.27272727272727,Unisex
Linn,1975,13,6,7,46.15384615384615,53.84615384615385,Unisex
Donell,1975,95,15,80,15.789473684210526,84.21052631578947,Unisex
Karon,1975,70,52,18,74.28571428571429,25.71428571428571,Unisex
Skylar,1975,18,8,10,44.44444444444444,55.55555555555556,Unisex
Skyler,1975,31,5,26,16.129032258064516,83.87096774193549,Unisex
Arlyn,1975,22,7,15,31.818181818181817,68.18181818181817,Unisex
Shawnta,1975,46,39,7,84.78260869565217,15.217391304347828,Unisex
Amie,1976,1084,1084,0,100.0,0.0,Female
Silva,1976,12,12,0,100.0,0.0,Female
Elba,1976,40,40,0,100.0,0.0,Female
Guy,1976,513,5,508,0.9746588693957114,99.02534113060428,Male
Earnie,1976,5,0,5,0.0,100.0,Male
Sebastien,1976,8,0,8,0.0,100.0,Male
Augustin,1976,50,0,50,0.0,100.0,Male
Cordell,1976,81,0,81,0.0,100.0,Male
Kentrell,1976,23,0,23,0.0,100.0,Male
Andie,1976,10,5,5,50.0,50.0,Unisex
Pasha,1976,21,15,6,71.42857142857143,28.57142857142857,Unisex
Lannie,1976,33,18,15,54.54545454545454,45.45454545454545,Unisex
Jamey,1976,576,146,430,25.34722222222222,74.65277777777779,Unisex
Orlanda,1976,26,7,19,26.923076923076923,73.07692307692307,Unisex
Ollie,1976,77,33,44,42.85714285714285,57.14285714285714,Unisex
Elza,1976,10,5,5,50.0,50.0,Unisex
Shai,1976,13,5,8,38.46153846153847,61.53846153846154,Unisex
Kendall,1976,352,72,280,20.454545454545457,79.54545454545455,Unisex
Nakia,1976,600,490,110,81.66666666666667,18.33333333333333,Unisex
Marshell,1976,19,12,7,63.1578947368421,36.84210526315789,Unisex
Shenandoah,1976,18,7,11,38.88888888888889,61.11111111111112,Unisex
Evon,1976,23,18,5,78.26086956521739,21.73913043478261,Unisex
Cheyenne,1976,178,124,54,69.66292134831461,30.337078651685395,Unisex
Mikell,1976,29,14,15,48.27586206896552,51.72413793103448,Unisex
Shaye,1976,29,22,7,75.86206896551724,24.13793103448276,Unisex
Deshawn,1976,166,28,138,16.867469879518072,83.13253012048193,Unisex
Errin,1976,52,38,14,73.07692307692307,26.923076923076923,Unisex
Jae,1976,28,11,17,39.285714285714285,60.71428571428571,Unisex
Nica,1977,6,6,0,100.0,0.0,Female
Marylynn,1977,18,18,0,100.0,0.0,Female
Noemi,1977,222,222,0,100.0,0.0,Female
Elva,1977,87,87,0,100.0,0.0,Female
Ngoc,1977,14,14,0,100.0,0.0,Female
Ileana,1977,68,68,0,100.0,0.0,Female
Valley,1977,5,5,0,100.0,0.0,Female
Patrick,1977,8354,46,8308,0.5506344266219775,99.44936557337802,Male
Junior,1977,101,0,101,0.0,100.0,Male
Mikle,1977,9,0,9,0.0,100.0,Male
Antwain,1977,61,0,61,0.0,100.0,Male
Sebastien,1977,5,0,5,0.0,100.0,Male
Delwin,1977,17,0,17,0.0,100.0,Male
Samir,1977,80,0,80,0.0,100.0,Male
Micahel,1977,33,0,33,0.0,100.0,Male
Carvin,1977,6,0,6,0.0,100.0,Male
Hameed,1977,9,0,9,0.0,100.0,Male
Meir,1977,17,0,17,0.0,100.0,Male
Rashem,1977,5,0,5,0.0,100.0,Male
Joffre,1977,5,0,5,0.0,100.0,Male
Rosevelt,1977,7,0,7,0.0,100.0,Male
Elie,1977,15,0,15,0.0,100.0,Male
Guadalupe,1977,845,549,296,64.97041420118343,35.02958579881657,Unisex
Regan,1977,252,195,57,77.38095238095238,22.61904761904762,Unisex
Ricci,1977,31,16,15,51.61290322580645,48.38709677419355,Unisex
Chevelle,1977,12,6,6,50.0,50.0,Unisex
Lavaughn,1977,18,7,11,38.88888888888889,61.11111111111112,Unisex
Nakia,1977,433,364,69,84.06466512702079,15.935334872979215,Unisex
Corby,1977,50,9,41,18.0,82.0,Unisex
Iran,1977,40,11,29,27.500000000000004,72.5,Unisex
Mikell,1977,19,8,11,42.10526315789473,57.89473684210527,Unisex
Dietrich,1977,38,7,31,18.421052631578945,81.57894736842105,Unisex
Monta,1977,21,5,16,23.809523809523807,76.19047619047619,Unisex
Kenyatta,1977,313,153,160,48.8817891373802,51.11821086261981,Unisex
Shaine,1977,30,6,24,20.0,80.0,Unisex
Verdell,1977,17,5,12,29.411764705882355,70.58823529411765,Unisex
Demetri,1977,37,10,27,27.027027027027028,72.97297297297297,Unisex
Chancey,1977,24,7,17,29.166666666666668,70.83333333333334,Unisex
Delane,1977,20,8,12,40.0,60.0,Unisex
Gale,1977,56,36,20,64.28571428571429,35.714285714285715,Unisex
Robbin,1977,83,69,14,83.13253012048193,16.867469879518072,Unisex
Tory,1977,466,180,286,38.62660944206009,61.37339055793991,Unisex
Shalom,1977,26,11,15,42.30769230769231,57.692307692307686,Unisex
Keir,1977,28,5,23,17.857142857142858,82.14285714285714,Unisex
Shea,1977,211,118,93,55.92417061611374,44.07582938388626,Unisex
Katharina,1978,16,16,0,100.0,0.0,Female
Pepper,1978,63,63,0,100.0,0.0,Female
Maree,1978,6,6,0,100.0,0.0,Female
Kyna,1978,43,43,0,100.0,0.0,Female
Makeba,1978,33,33,0,100.0,0.0,Female
Alethia,1978,32,32,0,100.0,0.0,Female
Dyana,1978,32,32,0,100.0,0.0,Female
Delphia,1978,6,6,0,100.0,0.0,Female
Timoty,1978,6,0,6,0.0,100.0,Male
Demorris,1978,9,0,9,0.0,100.0,Male
Luiz,1978,22,0,22,0.0,100.0,Male
Bernie,1978,53,0,53,0.0,100.0,Male
Braxton,1978,32,0,32,0.0,100.0,Male
Anders,1978,42,0,42,0.0,100.0,Male
Grover,1978,48,0,48,0.0,100.0,Male
Clifton,1978,870,7,863,0.8045977011494253,99.19540229885058,Male
Keith,1978,6201,29,6172,0.4676665054023544,99.53233349459764,Male
Shea,1978,232,130,102,56.03448275862068,43.96551724137931,Unisex
Clancy,1978,20,8,12,40.0,60.0,Unisex
Andra,1978,144,96,48,66.66666666666666,33.33333333333333,Unisex
Valentine,1978,37,6,31,16.216216216216218,83.78378378378379,Unisex
Shalom,1978,21,11,10,52.38095238095239,47.61904761904761,Unisex
Micky,1978,48,10,38,20.833333333333336,79.16666666666666,Unisex
Kai,1978,141,67,74,47.5177304964539,52.4822695035461,Unisex
Arien,1978,28,11,17,39.285714285714285,60.71428571428571,Unisex
Renell,1978,15,10,5,66.66666666666666,33.33333333333333,Unisex
Skylar,1978,23,7,16,30.434782608695656,69.56521739130434,Unisex
Niko,1978,13,5,8,38.46153846153847,61.53846153846154,Unisex
Marvis,1978,23,5,18,21.73913043478261,78.26086956521739,Unisex
Mickie,1978,32,21,11,65.625,34.375,Unisex
Vernell,1978,47,15,32,31.91489361702128,68.08510638297872,Unisex
Marlowe,1978,17,6,11,35.294117647058826,64.70588235294117,Unisex
Elon,1978,19,5,14,26.31578947368421,73.68421052631578,Unisex
Shenandoah,1978,14,9,5,64.28571428571429,35.714285714285715,Unisex
Che,1978,70,11,59,15.714285714285714,84.28571428571429,Unisex
Corry,1978,87,14,73,16.091954022988507,83.9080459770115,Unisex
Carmon,1978,30,24,6,80.0,20.0,Unisex
Dell,1978,25,6,19,24.0,76.0,Unisex
Noel,1978,598,185,413,30.93645484949833,69.06354515050167,Unisex
Britt,1978,153,106,47,69.28104575163398,30.71895424836601,Unisex
Mishael,1979,5,5,0,100.0,0.0,Female
Chanie,1979,11,11,0,100.0,0.0,Female
Kemo,1979,5,0,5,0.0,100.0,Male
Rudi,1979,15,0,15,0.0,100.0,Male
Dagan,1979,18,0,18,0.0,100.0,Male
Ventura,1979,24,5,19,20.833333333333336,79.16666666666666,Unisex
Aryn,1979,31,25,6,80.64516129032258,19.35483870967742,Unisex
Mikah,1979,11,5,6,45.45454545454545,54.54545454545454,Unisex
Montana,1979,21,11,10,52.38095238095239,47.61904761904761,Unisex
Keyonta,1979,10,5,5,50.0,50.0,Unisex
Angel,1979,3001,1697,1304,56.547817394201935,43.45218260579807,Unisex
Haven,1979,53,19,34,35.84905660377358,64.15094339622641,Unisex
Little,1979,27,5,22,18.51851851851852,81.48148148148148,Unisex
Shaye,1979,31,20,11,64.51612903225806,35.483870967741936,Unisex
Concepcion,1979,61,51,10,83.60655737704919,16.39344262295082,Unisex
Demetrice,1979,107,64,43,59.813084112149525,40.18691588785047,Unisex
Ricki,1979,74,52,22,70.27027027027027,29.72972972972973,Unisex
Brittan,1979,18,11,7,61.11111111111112,38.88888888888889,Unisex
Breck,1979,23,5,18,21.73913043478261,78.26086956521739,Unisex
Aidan,1979,27,6,21,22.22222222222222,77.77777777777779,Unisex
Ever,1979,18,6,12,33.33333333333333,66.66666666666666,Unisex
Coley,1979,37,6,31,16.216216216216218,83.78378378378379,Unisex
Micha,1979,35,21,14,60.0,40.0,Unisex
Linn,1979,16,9,7,56.25,43.75,Unisex
Regan,1979,301,212,89,70.43189368770764,29.56810631229236,Unisex
Ara,1979,44,23,21,52.27272727272727,47.72727272727273,Unisex
Germaine,1979,115,39,76,33.91304347826087,66.08695652173913,Unisex
Iran,1979,37,13,24,35.13513513513514,64.86486486486487,Unisex
Cris,1979,31,11,20,35.483870967741936,64.51612903225806,Unisex
Breeann,1980,30,30,0,100.0,0.0,Female
Ninette,1980,12,12,0,100.0,0.0,Female
Sakeena,1980,19,19,0,100.0,0.0,Female
Letisia,1980,38,38,0,100.0,0.0,Female
Bette,1980,17,17,0,100.0,0.0,Female
Corydon,1980,9,0,9,0.0,100.0,Male
Kemo,1980,6,0,6,0.0,100.0,Male
Derk,1980,17,0,17,0.0,100.0,Male
Elon,1980,14,0,14,0.0,100.0,Male
Aden,1980,25,0,25,0.0,100.0,Male
Newton,1980,19,0,19,0.0,100.0,Male
Nashon,1980,7,0,7,0.0,100.0,Male
Anthon,1980,7,0,7,0.0,100.0,Male
Marsh,1980,5,0,5,0.0,100.0,Male
Tavarus,1980,25,0,25,0.0,100.0,Male
Samir,1980,86,0,86,0.0,100.0,Male
Perrin,1980,11,0,11,0.0,100.0,Male
Sherron,1980,45,26,19,57.77777777777777,42.22222222222222,Unisex
Mishael,1980,10,5,5,50.0,50.0,Unisex
Marshell,1980,15,9,6,60.0,40.0,Unisex
Golden,1980,26,6,20,23.07692307692308,76.92307692307693,Unisex
Lin,1980,20,15,5,75.0,25.0,Unisex
Laney,1980,33,27,6,81.81818181818183,18.181818181818183,Unisex
Corin,1980,65,52,13,80.0,20.0,Unisex
Naseem,1980,14,7,7,50.0,50.0,Unisex
Payton,1980,38,8,30,21.052631578947366,78.94736842105263,Unisex
Dashawn,1980,51,13,38,25.49019607843137,74.50980392156863,Unisex
Jere,1980,26,8,18,30.76923076923077,69.23076923076923,Unisex
Alix,1980,29,23,6,79.3103448275862,20.6896551724138,Unisex
Courtenay,1980,73,51,22,69.86301369863014,30.136986301369863,Unisex
Johnnie,1980,528,82,446,15.530303030303031,84.46969696969697,Unisex
Kerry,1980,1431,1000,431,69.88120195667365,30.118798043326343,Unisex
Peyton,1980,42,17,25,40.47619047619048,59.523809523809526,Unisex
Sol,1980,44,22,22,50.0,50.0,Unisex
Carey,1980,510,342,168,67.05882352941175,32.94117647058823,Unisex
Arlie,1980,23,6,17,26.08695652173913,73.91304347826086,Unisex
Cassidy,1980,195,131,64,67.17948717948717,32.82051282051282,Unisex
Daryn,1980,44,7,37,15.909090909090908,84.0909090909091,Unisex
Demetric,1980,84,17,67,20.23809523809524,79.76190476190477,Unisex
Sandy,1981,898,802,96,89.30957683741649,10.69042316258352,Female
Yalanda,1981,24,24,0,100.0,0.0,Female
Alayne,1981,17,17,0,100.0,0.0,Female
Jerri,1981,156,150,6,96.15384615384616,3.8461538461538463,Female
Marlan,1981,6,0,6,0.0,100.0,Male
Javell,1981,7,0,7,0.0,100.0,Male
Dashawn,1981,51,5,46,9.803921568627452,90.19607843137256,Male
Lamonte,1981,24,0,24,0.0,100.0,Male
Westly,1981,16,0,16,0.0,100.0,Male
Owen,1981,381,0,381,0.0,100.0,Male
Raynaldo,1981,25,0,25,0.0,100.0,Male
Jackson,1981,301,0,301,0.0,100.0,Male
Corydon,1981,5,0,5,0.0,100.0,Male
Johny,1981,26,0,26,0.0,100.0,Male
Dirk,1981,121,0,121,0.0,100.0,Male
Kalen,1981,52,14,38,26.923076923076923,73.07692307692307,Unisex
Cleo,1981,50,25,25,50.0,50.0,Unisex
Kiran,1981,37,22,15,59.45945945945946,40.54054054054054,Unisex
Binh,1981,27,6,21,22.22222222222222,77.77777777777779,Unisex
Lorenza,1981,51,21,30,41.17647058823529,58.82352941176471,Unisex
Brandyn,1981,61,22,39,36.0655737704918,63.934426229508205,Unisex
Casey,1981,5939,2420,3519,40.747600606162656,59.25239939383735,Unisex
Andra,1981,166,112,54,67.46987951807229,32.53012048192771,Unisex
Dann,1981,18,12,6,66.66666666666666,33.33333333333333,Unisex
Blakely,1981,39,13,26,33.33333333333333,66.66666666666666,Unisex
Rosario,1981,178,134,44,75.28089887640449,24.719101123595504,Unisex
Kit,1981,44,9,35,20.454545454545457,79.54545454545455,Unisex
Chai,1981,17,6,11,35.294117647058826,64.70588235294117,Unisex
Clair,1981,43,31,12,72.09302325581395,27.906976744186046,Unisex
Karey,1981,73,57,16,78.08219178082192,21.91780821917808,Unisex
Deane,1981,19,10,9,52.63157894736842,47.368421052631575,Unisex
Adriel,1981,61,16,45,26.229508196721312,73.77049180327869,Unisex
Alva,1981,49,33,16,67.3469387755102,32.6530612244898,Unisex
Remi,1981,22,8,14,36.36363636363637,63.63636363636363,Unisex
Marlen,1981,48,40,8,83.33333333333334,16.666666666666664,Unisex
Marlee,1982,16,16,0,100.0,0.0,Female
Roselee,1982,7,7,0,100.0,0.0,Female
Lamonte,1982,37,0,37,0.0,100.0,Male
Bengamin,1982,6,0,6,0.0,100.0,Male
Lovell,1982,21,0,21,0.0,100.0,Male
Joon,1982,10,0,10,0.0,100.0,Male
Oliver,1982,455,0,455,0.0,100.0,Male
Chong,1982,28,6,22,21.428571428571427,78.57142857142857,Unisex
Dakota,1982,57,14,43,24.561403508771928,75.43859649122807,Unisex
Mckay,1982,16,5,11,31.25,68.75,Unisex
Cheyenne,1982,246,190,56,77.23577235772358,22.76422764227642,Unisex
Karry,1982,33,21,12,63.63636363636363,36.36363636363637,Unisex
Errin,1982,34,28,6,82.35294117647058,17.647058823529413,Unisex
Rhyan,1982,21,5,16,23.809523809523807,76.19047619047619,Unisex
Arion,1982,18,8,10,44.44444444444444,55.55555555555556,Unisex
Ivie,1982,14,9,5,64.28571428571429,35.714285714285715,Unisex
Marlyn,1982,43,36,7,83.72093023255815,16.27906976744186,Unisex
Regan,1982,114,82,32,71.9298245614035,28.07017543859649,Unisex
Jan,1982,306,163,143,53.26797385620915,46.73202614379085,Unisex
Tashawn,1982,13,8,5,61.53846153846154,38.46153846153847,Unisex
Vanna,1982,13,7,6,53.84615384615385,46.15384615384615,Unisex
Jin,1982,23,9,14,39.130434782608695,60.86956521739131,Unisex
Avery,1982,286,69,217,24.125874125874127,75.87412587412588,Unisex
Omega,1982,25,16,9,64.0,36.0,Unisex
Jackie,1982,1132,756,376,66.78445229681978,33.215547703180206,Unisex
Kc,1982,37,10,27,27.027027027027028,72.97297297297297,Unisex
Marquette,1982,45,24,21,53.333333333333336,46.66666666666666,Unisex
Davi,1982,14,5,9,35.714285714285715,64.28571428571429,Unisex
Chiquita,1983,173,173,0,100.0,0.0,Female
Pansy,1983,10,10,0,100.0,0.0,Female
Renne,1983,12,12,0,100.0,0.0,Female
Ophelia,1983,24,24,0,100.0,0.0,Female
Kindra,1983,89,89,0,100.0,0.0,Female
Clarinda,1983,6,6,0,100.0,0.0,Female
Clementina,1983,10,10,0,100.0,0.0,Female
Moshe,1983,134,0,134,0.0,100.0,Male
Mackey,1983,5,0,5,0.0,100.0,Male
Lovell,1983,22,0,22,0.0,100.0,Male
Odis,1983,33,0,33,0.0,100.0,Male
Winfred,1983,27,0,27,0.0,100.0,Male
Ismael,1983,431,7,424,1.6241299303944314,98.37587006960555,Male
Jermiah,1983,37,0,37,0.0,100.0,Male
Cornelio,1983,20,0,20,0.0,100.0,Male
Donta,1983,117,7,110,5.982905982905983,94.017094017094,Male
Francisco,1983,1832,10,1822,0.5458515283842794,99.45414847161572,Male
Shalom,1983,19,6,13,31.57894736842105,68.42105263157895,Unisex
Jaden,1983,22,7,15,31.818181818181817,68.18181818181817,Unisex
Quin,1983,13,5,8,38.46153846153847,61.53846153846154,Unisex
Hasani,1983,17,6,11,35.294117647058826,64.70588235294117,Unisex
Kassidy,1983,55,46,9,83.63636363636363,16.363636363636363,Unisex
Binh,1983,18,5,13,27.77777777777778,72.22222222222221,Unisex
Ariel,1983,965,650,315,67.35751295336787,32.64248704663213,Unisex
Kerry,1983,1169,786,383,67.23695466210437,32.76304533789563,Unisex
Parris,1983,39,11,28,28.205128205128204,71.7948717948718,Unisex
Callen,1983,18,9,9,50.0,50.0,Unisex
Baby,1983,114,60,54,52.63157894736842,47.368421052631575,Unisex
Aubry,1983,31,23,8,74.19354838709677,25.806451612903224,Unisex
Kim,1983,493,402,91,81.54158215010142,18.45841784989858,Unisex
Torrey,1983,113,21,92,18.58407079646018,81.41592920353983,Unisex
Coley,1983,23,5,18,21.73913043478261,78.26086956521739,Unisex
Kc,1983,60,14,46,23.33333333333333,76.66666666666667,Unisex
Tristian,1983,32,9,23,28.125,71.875,Unisex
Ever,1983,16,5,11,31.25,68.75,Unisex
Ngoc,1983,45,35,10,77.77777777777779,22.22222222222222,Unisex
Merrill,1983,54,13,41,24.07407407407408,75.92592592592592,Unisex
Kodi,1983,51,35,16,68.62745098039215,31.37254901960784,Unisex
Naseem,1984,12,12,0,100.0,0.0,Female
Kadi,1984,15,15,0,100.0,0.0,Female
Elena,1984,542,542,0,100.0,0.0,Female
Tianna,1984,127,127,0,100.0,0.0,Female
Despina,1984,23,23,0,100.0,0.0,Female
Westly,1984,16,0,16,0.0,100.0,Male
Hector,1984,1352,16,1336,1.183431952662722,98.81656804733728,Male
Winfred,1984,25,0,25,0.0,100.0,Male
Clinton,1984,1869,18,1851,0.9630818619582664,99.03691813804171,Male
Jonn,1984,7,0,7,0.0,100.0,Male
Bart,1984,139,0,139,0.0,100.0,Male
Marcelino,1984,60,0,60,0.0,100.0,Male
Kentrell,1984,43,0,43,0.0,100.0,Male
Azariah,1984,5,0,5,0.0,100.0,Male
Tashawn,1984,20,7,13,35.0,65.0,Unisex
Jacque,1984,66,30,36,45.45454545454545,54.54545454545454,Unisex
Courtenay,1984,40,32,8,80.0,20.0,Unisex
Danie,1984,25,6,19,24.0,76.0,Unisex
Kiran,1984,33,18,15,54.54545454545454,45.45454545454545,Unisex
Chaney,1984,17,11,6,64.70588235294117,35.294117647058826,Unisex
Shaheen,1984,24,12,12,50.0,50.0,Unisex
An,1984,48,23,25,47.91666666666667,52.083333333333336,Unisex
Jackie,1984,834,546,288,65.46762589928058,34.53237410071942,Unisex
Jessie,1984,2087,992,1095,47.53234307618591,52.46765692381409,Unisex
Carroll,1984,60,13,47,21.666666666666668,78.33333333333333,Unisex
Jaime,1984,2679,1505,1174,56.177678238148566,43.82232176185144,Unisex
Teryl,1984,13,6,7,46.15384615384615,53.84615384615385,Unisex
Arley,1984,26,15,11,57.692307692307686,42.30769230769231,Unisex
Emory,1984,65,11,54,16.923076923076923,83.07692307692308,Unisex
Cam,1984,12,5,7,41.66666666666667,58.333333333333336,Unisex
Shayne,1984,142,29,113,20.422535211267608,79.5774647887324,Unisex
Lavern,1984,32,12,20,37.5,62.5,Unisex
Toria,1985,17,17,0,100.0,0.0,Female
Elba,1985,39,39,0,100.0,0.0,Female
Hayley,1985,663,663,0,100.0,0.0,Female
Timoty,1985,7,0,7,0.0,100.0,Male
Ilan,1985,17,0,17,0.0,100.0,Male
Junius,1985,14,0,14,0.0,100.0,Male
Flynn,1985,16,0,16,0.0,100.0,Male
Neville,1985,19,0,19,0.0,100.0,Male
Othello,1985,6,0,6,0.0,100.0,Male
Immanuel,1985,49,0,49,0.0,100.0,Male
Gray,1985,26,0,26,0.0,100.0,Male
Harper,1985,26,13,13,50.0,50.0,Unisex
Khristian,1985,30,16,14,53.333333333333336,46.66666666666666,Unisex
Paris,1985,348,204,144,58.620689655172406,41.37931034482759,Unisex
Ora,1985,43,34,9,79.06976744186046,20.930232558139537,Unisex
Arion,1985,26,7,19,26.923076923076923,73.07692307692307,Unisex
Kelcey,1985,31,21,10,67.74193548387096,32.25806451612903,Unisex
Kenyatta,1985,151,118,33,78.1456953642384,21.85430463576159,Unisex
Marion,1985,322,168,154,52.17391304347826,47.82608695652174,Unisex
Chancey,1985,33,11,22,33.33333333333333,66.66666666666666,Unisex
Temple,1985,13,6,7,46.15384615384615,53.84615384615385,Unisex
Kinley,1985,14,9,5,64.28571428571429,35.714285714285715,Unisex
Audie,1985,35,7,28,20.0,80.0,Unisex
Diamond,1985,187,139,48,74.33155080213903,25.66844919786097,Unisex
Stephane,1985,55,40,15,72.72727272727273,27.27272727272727,Unisex
Natividad,1985,36,17,19,47.22222222222222,52.77777777777778,Unisex
Loran,1985,36,17,19,47.22222222222222,52.77777777777778,Unisex
Adriel,1985,56,14,42,25.0,75.0,Unisex
Nicola,1985,121,87,34,71.900826446281,28.09917355371901,Unisex
Krishna,1985,31,17,14,54.83870967741935,45.16129032258064,Unisex
Ellison,1985,14,5,9,35.714285714285715,64.28571428571429,Unisex
Aki,1985,14,8,6,57.14285714285714,42.85714285714285,Unisex
Dene,1986,6,6,0,100.0,0.0,Female
Jalyn,1986,14,14,0,100.0,0.0,Female
Carlon,1986,6,0,6,0.0,100.0,Male
Naveed,1986,7,0,7,0.0,100.0,Male
Burl,1986,11,0,11,0.0,100.0,Male
Guadalupe,1986,885,607,278,68.58757062146893,31.41242937853108,Unisex
Farris,1986,19,10,9,52.63157894736842,47.368421052631575,Unisex
Lane,1986,283,64,219,22.61484098939929,77.3851590106007,Unisex
Elan,1986,72,23,49,31.944444444444443,68.05555555555556,Unisex
Shea,1986,486,206,280,42.38683127572017,57.61316872427984,Unisex
Nicola,1986,110,81,29,73.63636363636363,26.36363636363636,Unisex
Lupe,1986,64,46,18,71.875,28.125,Unisex
Kriston,1986,48,34,14,70.83333333333334,29.166666666666668,Unisex
Natale,1986,16,11,5,68.75,31.25,Unisex
Ashby,1986,18,10,8,55.55555555555556,44.44444444444444,Unisex
Ryley,1986,20,7,13,35.0,65.0,Unisex
Lorenza,1986,48,23,25,47.91666666666667,52.083333333333336,Unisex
Javon,1986,210,33,177,15.714285714285714,84.28571428571429,Unisex
Deni,1986,13,7,6,53.84615384615385,46.15384615384615,Unisex
Clancy,1986,31,10,21,32.25806451612903,67.74193548387096,Unisex
Chong,1986,23,5,18,21.73913043478261,78.26086956521739,Unisex
Tobie,1986,20,14,6,70.0,30.0,Unisex
Garnet,1986,20,12,8,60.0,40.0,Unisex
Kerin,1986,38,27,11,71.05263157894737,28.94736842105264,Unisex
Chaney,1986,25,18,7,72.0,28.000000000000004,Unisex
Marilu,1987,29,29,0,100.0,0.0,Female
Jamala,1987,5,5,0,100.0,0.0,Female
Sakeena,1987,10,10,0,100.0,0.0,Female
Laban,1987,9,0,9,0.0,100.0,Male
Johnson,1987,104,5,99,4.807692307692308,95.1923076923077,Male
Koy,1987,6,0,6,0.0,100.0,Male
Boyd,1987,54,0,54,0.0,100.0,Male
Yusef,1987,20,0,20,0.0,100.0,Male
Rafael,1987,1233,17,1216,1.37875101378751,98.62124898621248,Male
Donzell,1987,11,0,11,0.0,100.0,Male
Crayton,1987,7,0,7,0.0,100.0,Male
Britt,1987,121,51,70,42.14876033057851,57.85123966942148,Unisex
Shaheen,1987,24,8,16,33.33333333333333,66.66666666666666,Unisex
Breck,1987,38,9,29,23.684210526315788,76.31578947368422,Unisex
Shaine,1987,50,11,39,22.0,78.0,Unisex
Sidney,1987,418,96,322,22.96650717703349,77.03349282296651,Unisex
Amani,1987,29,24,5,82.75862068965517,17.24137931034483,Unisex
Jacobi,1987,28,5,23,17.857142857142858,82.14285714285714,Unisex
Jaylin,1987,15,10,5,66.66666666666666,33.33333333333333,Unisex
Natividad,1987,30,15,15,50.0,50.0,Unisex
Osiris,1987,17,8,9,47.05882352941176,52.94117647058824,Unisex
San,1987,27,11,16,40.74074074074074,59.25925925925925,Unisex
Jammie,1987,99,77,22,77.77777777777779,22.22222222222222,Unisex
Min,1987,15,6,9,40.0,60.0,Unisex
Mykal,1987,20,10,10,50.0,50.0,Unisex
Annice,1988,8,8,0,100.0,0.0,Female
Lucy,1988,513,513,0,100.0,0.0,Female
Eliza,1988,329,329,0,100.0,0.0,Female
Tonita,1988,15,15,0,100.0,0.0,Female
Aerin,1988,10,10,0,100.0,0.0,Female
Stefany,1988,88,88,0,100.0,0.0,Female
Ferrell,1988,9,0,9,0.0,100.0,Male
Scott,1988,9413,59,9354,0.6267927334537342,99.37320726654627,Male
Harris,1988,99,0,99,0.0,100.0,Male
Enos,1988,29,0,29,0.0,100.0,Male
Randle,1988,24,0,24,0.0,100.0,Male
Domenick,1988,38,0,38,0.0,100.0,Male
Dudley,1988,20,0,20,0.0,100.0,Male
Franz,1988,27,0,27,0.0,100.0,Male
Jarell,1988,82,0,82,0.0,100.0,Male
Benito,1988,139,0,139,0.0,100.0,Male
Arsalan,1988,10,0,10,0.0,100.0,Male
Neftali,1988,37,5,32,13.513513513513514,86.48648648648648,Male
Kiante,1988,17,9,8,52.94117647058824,47.05882352941176,Unisex
Carey,1988,288,121,167,42.01388888888889,57.98611111111112,Unisex
Demetrice,1988,85,27,58,31.76470588235294,68.23529411764706,Unisex
Tristian,1988,83,14,69,16.867469879518072,83.13253012048193,Unisex
Robbie,1988,267,56,211,20.973782771535586,79.02621722846442,Unisex
Lennie,1988,20,5,15,25.0,75.0,Unisex
Randie,1988,36,29,7,80.55555555555556,19.444444444444446,Unisex
Arie,1988,38,21,17,55.26315789473685,44.73684210526316,Unisex
Lupe,1988,52,38,14,73.07692307692307,26.923076923076923,Unisex
Milan,1988,78,27,51,34.61538461538461,65.38461538461539,Unisex
Dione,1988,38,26,12,68.42105263157895,31.57894736842105,Unisex
Allyn,1988,68,36,32,52.94117647058824,47.05882352941176,Unisex
Salem,1988,39,11,28,28.205128205128204,71.7948717948718,Unisex
Kc,1988,103,32,71,31.06796116504854,68.93203883495146,Unisex
Tory,1988,301,101,200,33.5548172757475,66.44518272425249,Unisex
Wynn,1988,22,7,15,31.818181818181817,68.18181818181817,Unisex
Arin,1988,86,54,32,62.7906976744186,37.2093023255814,Unisex
Caylen,1988,13,8,5,61.53846153846154,38.46153846153847,Unisex
Kasey,1988,1696,1298,398,76.53301886792453,23.46698113207547,Unisex
Lynn,1988,552,469,83,84.96376811594203,15.03623188405797,Unisex
Merritt,1988,39,21,18,53.84615384615385,46.15384615384615,Unisex
Allyce,1989,39,39,0,100.0,0.0,Female
Kendyl,1989,33,33,0,100.0,0.0,Female
Karmon,1989,5,5,0,100.0,0.0,Female
Terrie,1989,25,25,0,100.0,0.0,Female
Adrianne,1989,302,296,6,98.01324503311258,1.9867549668874167,Female
Alexia,1989,318,318,0,100.0,0.0,Female
Candyce,1989,63,63,0,100.0,0.0,Female
Olympia,1989,28,28,0,100.0,0.0,Female
Sulaiman,1989,10,0,10,0.0,100.0,Male
Marshall,1989,858,11,847,1.282051282051282,98.71794871794872,Male
Arley,1989,29,0,29,0.0,100.0,Male
Ansel,1989,23,0,23,0.0,100.0,Male
Raul,1989,1369,10,1359,0.7304601899196494,99.26953981008036,Male
Elwood,1989,29,0,29,0.0,100.0,Male
Bee,1989,37,9,28,24.324324324324326,75.67567567567568,Unisex
Yuri,1989,139,106,33,76.2589928057554,23.7410071942446,Unisex
Jayden,1989,30,8,22,26.666666666666668,73.33333333333333,Unisex
Micha,1989,38,24,14,63.1578947368421,36.84210526315789,Unisex
Sol,1989,24,14,10,58.333333333333336,41.66666666666667,Unisex
Teddie,1989,18,6,12,33.33333333333333,66.66666666666666,Unisex
Loran,1989,51,42,9,82.35294117647058,17.647058823529413,Unisex
Ivory,1989,161,104,57,64.59627329192547,35.40372670807454,Unisex
Dwan,1989,36,6,30,16.666666666666664,83.33333333333334,Unisex
Lin,1989,11,6,5,54.54545454545454,45.45454545454545,Unisex
Mickie,1989,27,21,6,77.77777777777779,22.22222222222222,Unisex
Mykal,1989,36,11,25,30.55555555555556,69.44444444444444,Unisex
Cary,1989,219,47,172,21.461187214611872,78.53881278538812,Unisex
Merrill,1989,38,17,21,44.73684210526316,55.26315789473685,Unisex
Kirby,1989,349,153,196,43.83954154727794,56.16045845272206,Unisex
Temple,1989,15,10,5,66.66666666666666,33.33333333333333,Unisex
Nikola,1989,36,9,27,25.0,75.0,Unisex
Ala,1989,26,18,8,69.23076923076923,30.76923076923077,Unisex
Karry,1989,25,15,10,60.0,40.0,Unisex
Karey,1989,35,24,11,68.57142857142857,31.428571428571427,Unisex
Deaven,1989,17,6,11,35.294117647058826,64.70588235294117,Unisex
Shade,1989,59,44,15,74.57627118644068,25.42372881355932,Unisex
Marili,1990,11,11,0,100.0,0.0,Female
Jesie,1990,5,5,0,100.0,0.0,Female
Meggan,1990,115,115,0,100.0,0.0,Female
Branden,1990,857,8,849,0.9334889148191364,99.06651108518086,Male
Galen,1990,195,19,176,9.743589743589745,90.25641025641026,Male
Zoltan,1990,6,0,6,0.0,100.0,Male
Jabri,1990,5,0,5,0.0,100.0,Male
Phelan,1990,16,0,16,0.0,100.0,Male
Cosme,1990,23,0,23,0.0,100.0,Male
Tien,1990,37,15,22,40.54054054054054,59.45945945945946,Unisex
Jessey,1990,54,12,42,22.22222222222222,77.77777777777779,Unisex
Brandis,1990,19,13,6,68.42105263157895,31.57894736842105,Unisex
Kiante,1990,14,9,5,64.28571428571429,35.714285714285715,Unisex
Ivey,1990,40,33,7,82.5,17.5,Unisex
Hartley,1990,15,9,6,60.0,40.0,Unisex
Raine,1990,32,27,5,84.375,15.625,Unisex
Quincey,1990,56,15,41,26.785714285714285,73.21428571428571,Unisex
Rain,1990,24,12,12,50.0,50.0,Unisex
Adrien,1990,140,30,110,21.428571428571427,78.57142857142857,Unisex
Koy,1990,12,5,7,41.66666666666667,58.333333333333336,Unisex
Concepcion,1990,56,46,10,82.14285714285714,17.857142857142858,Unisex
Coree,1990,32,15,17,46.875,53.125,Unisex
Mika,1990,103,83,20,80.58252427184466,19.41747572815534,Unisex
Ying,1990,19,12,7,63.1578947368421,36.84210526315789,Unisex
Hollis,1990,89,45,44,50.56179775280899,49.43820224719101,Unisex
Victory,1990,12,7,5,58.333333333333336,41.66666666666667,Unisex
Islam,1990,29,7,22,24.13793103448276,75.86206896551724,Unisex
Raynell,1990,22,9,13,40.909090909090914,59.09090909090909,Unisex
Letisia,1991,15,15,0,100.0,0.0,Female
Belinda,1991,356,356,0,100.0,0.0,Female
Amon,1991,22,0,22,0.0,100.0,Male
Sulaiman,1991,12,0,12,0.0,100.0,Male
Keone,1991,12,0,12,0.0,100.0,Male
Lovell,1991,26,0,26,0.0,100.0,Male
Erich,1991,193,0,193,0.0,100.0,Male
Lendon,1991,6,0,6,0.0,100.0,Male
Javell,1991,14,0,14,0.0,100.0,Male
Forest,1991,140,9,131,6.428571428571428,93.57142857142856,Male
Jeriah,1991,8,0,8,0.0,100.0,Male
Gavin,1991,853,5,848,0.5861664712778429,99.41383352872217,Male
Jonte,1991,52,9,43,17.307692307692307,82.6923076923077,Unisex
Kenyatta,1991,199,151,48,75.87939698492463,24.12060301507537,Unisex
Marlo,1991,63,32,31,50.79365079365079,49.2063492063492,Unisex
Leshawn,1991,27,7,20,25.925925925925924,74.07407407407408,Unisex
Naseem,1991,18,11,7,61.11111111111112,38.88888888888889,Unisex
Coree,1991,22,16,6,72.72727272727273,27.27272727272727,Unisex
Avion,1991,19,6,13,31.57894736842105,68.42105263157895,Unisex
Deane,1991,18,7,11,38.88888888888889,61.11111111111112,Unisex
Danell,1991,24,17,7,70.83333333333334,29.166666666666668,Unisex
Dwan,1991,21,5,16,23.809523809523807,76.19047619047619,Unisex
Chevelle,1991,31,26,5,83.87096774193549,16.129032258064516,Unisex
Aden,1991,33,7,26,21.21212121212121,78.78787878787878,Unisex
Elisha,1991,436,297,139,68.11926605504587,31.880733944954127,Unisex
Dannie,1991,39,11,28,28.205128205128204,71.7948717948718,Unisex
Adrien,1991,114,18,96,15.789473684210526,84.21052631578947,Unisex
Aundra,1991,18,7,11,38.88888888888889,61.11111111111112,Unisex
Jin,1991,35,14,21,40.0,60.0,Unisex
Megen,1992,18,18,0,100.0,0.0,Female
Breeann,1992,72,72,0,100.0,0.0,Female
Damita,1992,9,9,0,100.0,0.0,Female
Janita,1992,30,30,0,100.0,0.0,Female
Jaci,1992,84,84,0,100.0,0.0,Female
Alexia,1992,456,456,0,100.0,0.0,Female
Hiram,1992,64,0,64,0.0,100.0,Male
Lavance,1992,14,0,14,0.0,100.0,Male
Rashem,1992,6,0,6,0.0,100.0,Male
Larue,1992,6,0,6,0.0,100.0,Male
Zenon,1992,15,0,15,0.0,100.0,Male
Prescott,1992,25,0,25,0.0,100.0,Male
Meir,1992,42,0,42,0.0,100.0,Male
Burrell,1992,6,0,6,0.0,100.0,Male
Mykal,1992,40,12,28,30.0,70.0,Unisex
Auburn,1992,41,34,7,82.92682926829268,17.073170731707318,Unisex
Infantof,1992,56,35,21,62.5,37.5,Unisex
Jaden,1992,150,48,102,32.0,68.0,Unisex
Alla,1992,17,12,5,70.58823529411765,29.411764705882355,Unisex
Deaven,1992,19,6,13,31.57894736842105,68.42105263157895,Unisex
Arien,1992,23,15,8,65.21739130434783,34.78260869565217,Unisex
Robbie,1992,201,47,154,23.383084577114428,76.61691542288557,Unisex
Berkley,1992,20,13,7,65.0,35.0,Unisex
Torey,1992,163,57,106,34.96932515337423,65.03067484662577,Unisex
Loren,1992,660,405,255,61.36363636363637,38.63636363636363,Unisex
Carlin,1992,102,40,62,39.21568627450981,60.78431372549019,Unisex
Chi,1992,30,18,12,60.0,40.0,Unisex
Shandon,1992,17,7,10,41.17647058823529,58.82352941176471,Unisex
Tonnie,1992,15,9,6,60.0,40.0,Unisex
Letisia,1993,12,12,0,100.0,0.0,Female
Lenise,1993,8,8,0,100.0,0.0,Female
Allyce,1993,11,11,0,100.0,0.0,Female
Nelia,1993,8,8,0,100.0,0.0,Female
Christen,1993,338,289,49,85.50295857988166,14.497041420118345,Female
Nila,1993,10,10,0,100.0,0.0,Female
Lawrence,1993,1551,0,1551,0.0,100.0,Male
Jarell,1993,78,0,78,0.0,100.0,Male
Sam,1993,573,12,561,2.094240837696335,97.90575916230368,Male
Zenon,1993,9,0,9,0.0,100.0,Male
Aniceto,1993,5,0,5,0.0,100.0,Male
Marshall,1993,897,14,883,1.560758082497213,98.43924191750278,Male
Gavin,1993,951,6,945,0.6309148264984227,99.3690851735016,Male
Keyonta,1993,16,7,9,43.75,56.25,Unisex
Sherron,1993,29,15,14,51.72413793103448,48.27586206896552,Unisex
Chancey,1993,32,17,15,53.125,46.875,Unisex
Kacy,1993,152,127,25,83.55263157894737,16.447368421052634,Unisex
Jalyn,1993,147,112,35,76.19047619047619,23.809523809523807,Unisex
Ora,1993,19,14,5,73.68421052631578,26.31578947368421,Unisex
Shadow,1993,58,22,36,37.93103448275862,62.06896551724138,Unisex
Tobey,1993,15,6,9,40.0,60.0,Unisex
Trenell,1993,17,7,10,41.17647058823529,58.82352941176471,Unisex
Britain,1993,30,11,19,36.66666666666666,63.33333333333333,Unisex
Jamy,1993,17,12,5,70.58823529411765,29.411764705882355,Unisex
Quinlan,1993,38,6,32,15.789473684210526,84.21052631578947,Unisex
Kit,1993,26,7,19,26.923076923076923,73.07692307692307,Unisex
Yuri,1993,92,62,30,67.3913043478261,32.608695652173914,Unisex
Daryn,1993,67,20,47,29.85074626865672,70.1492537313433,Unisex
Chi,1993,22,13,9,59.09090909090909,40.909090909090914,Unisex
Fern,1994,13,13,0,100.0,0.0,Female
Despina,1994,14,14,0,100.0,0.0,Female
Coy,1994,101,5,96,4.950495049504951,95.04950495049503,Male
Hale,1994,7,0,7,0.0,100.0,Male
Amon,1994,25,0,25,0.0,100.0,Male
Ira,1994,124,15,109,12.096774193548388,87.90322580645162,Male
Walton,1994,18,0,18,0.0,100.0,Male
Tajee,1994,26,13,13,50.0,50.0,Unisex
Jonell,1994,20,9,11,45.0,55.00000000000001,Unisex
Phoenix,1994,202,80,122,39.6039603960396,60.3960396039604,Unisex
Allyn,1994,40,24,16,60.0,40.0,Unisex
Sha,1994,38,32,6,84.21052631578947,15.789473684210526,Unisex
Mychal,1994,49,8,41,16.3265306122449,83.6734693877551,Unisex
Dru,1994,50,13,37,26.0,74.0,Unisex
Ricci,1994,25,19,6,76.0,24.0,Unisex
Micha,1994,45,32,13,71.11111111111111,28.88888888888889,Unisex
Raine,1994,46,37,9,80.43478260869566,19.565217391304348,Unisex
Rhyan,1994,48,17,31,35.41666666666667,64.58333333333334,Unisex
Jimi,1994,22,9,13,40.909090909090914,59.09090909090909,Unisex
Hartley,1994,16,10,6,62.5,37.5,Unisex
Infantof,1994,12,7,5,58.333333333333336,41.66666666666667,Unisex
Leianna,1995,13,13,0,100.0,0.0,Female
Ayan,1995,15,15,0,100.0,0.0,Female
Levon,1995,57,0,57,0.0,100.0,Male
Tavarus,1995,28,0,28,0.0,100.0,Male
Christo,1995,12,0,12,0.0,100.0,Male
Jerry,1995,1533,16,1517,1.0437051532941943,98.9562948467058,Male
Jarrett,1995,559,0,559,0.0,100.0,Male
Ala,1995,12,7,5,58.333333333333336,41.66666666666667,Unisex
Aden,1995,59,11,48,18.64406779661017,81.35593220338984,Unisex
Lucky,1995,51,11,40,21.5686274509804,78.43137254901961,Unisex
Jona,1995,24,18,6,75.0,25.0,Unisex
Noam,1995,35,6,29,17.142857142857142,82.85714285714286,Unisex
Tajee,1995,15,5,10,33.33333333333333,66.66666666666666,Unisex
Karol,1995,44,32,12,72.72727272727273,27.27272727272727,Unisex
Jayden,1995,313,74,239,23.642172523961666,76.35782747603834,Unisex
Berkley,1995,39,26,13,66.66666666666666,33.33333333333333,Unisex
Arin,1995,116,76,40,65.51724137931035,34.48275862068966,Unisex
Dannie,1995,55,15,40,27.27272727272727,72.72727272727273,Unisex
Jules,1995,60,9,51,15.0,85.0,Unisex
Osiris,1995,48,22,26,45.83333333333333,54.16666666666666,Unisex
Andree,1995,17,6,11,35.294117647058826,64.70588235294117,Unisex
Angel,1995,5467,1733,3734,31.69928662886409,68.3007133711359,Unisex
Michel,1995,118,53,65,44.91525423728814,55.08474576271186,Unisex
Mikell,1995,29,11,18,37.93103448275862,62.06896551724138,Unisex
Kymani,1996,6,6,0,100.0,0.0,Female
Anette,1996,26,26,0,100.0,0.0,Female
Walton,1996,10,0,10,0.0,100.0,Male
Benito,1996,198,0,198,0.0,100.0,Male
Yisrael,1996,13,0,13,0.0,100.0,Male
Mikhail,1996,69,0,69,0.0,100.0,Male
Ceasar,1996,66,0,66,0.0,100.0,Male
Lindon,1996,9,0,9,0.0,100.0,Male
Ara,1996,26,16,10,61.53846153846154,38.46153846153847,Unisex
Emile,1996,40,13,27,32.5,67.5,Unisex
Chai,1996,14,6,8,42.85714285714285,57.14285714285714,Unisex
Jona,1996,26,17,9,65.38461538461539,34.61538461538461,Unisex
Jacque,1996,28,5,23,17.857142857142858,82.14285714285714,Unisex
Zia,1996,29,23,6,79.3103448275862,20.6896551724138,Unisex
Codie,1996,218,65,153,29.81651376146789,70.18348623853211,Unisex
Lorenza,1996,25,11,14,44.0,56.00000000000001,Unisex
Sinclair,1996,30,18,12,60.0,40.0,Unisex
Robbie,1996,160,43,117,26.875,73.125,Unisex
Raynell,1996,14,9,5,64.28571428571429,35.714285714285715,Unisex
Nyle,1996,24,5,19,20.833333333333336,79.16666666666666,Unisex
Merlin,1996,52,13,39,25.0,75.0,Unisex
Trysten,1996,70,22,48,31.428571428571427,68.57142857142857,Unisex
Talyn,1996,22,15,7,68.18181818181817,31.818181818181817,Unisex
Loren,1996,463,311,152,67.170626349892,32.82937365010799,Unisex
Ollie,1996,30,11,19,36.66666666666666,63.33333333333333,Unisex
Jabri,1996,12,5,7,41.66666666666667,58.333333333333336,Unisex
Kennie,1996,10,5,5,50.0,50.0,Unisex
Edlyn,1997,8,8,0,100.0,0.0,Female
Newton,1997,19,0,19,0.0,100.0,Male
Obie,1997,8,0,8,0.0,100.0,Male
Stevens,1997,14,0,14,0.0,100.0,Male
Columbus,1997,13,0,13,0.0,100.0,Male
Mario,1997,2304,9,2295,0.390625,99.609375,Male
Baby,1997,475,235,240,49.47368421052632,50.526315789473685,Unisex
Mishael,1997,20,10,10,50.0,50.0,Unisex
Payton,1997,2019,1335,684,66.12184249628528,33.87815750371471,Unisex
Blakely,1997,70,42,28,60.0,40.0,Unisex
Landy,1997,11,5,6,45.45454545454545,54.54545454545454,Unisex
Deni,1997,17,12,5,70.58823529411765,29.411764705882355,Unisex
Jezreel,1997,20,9,11,45.0,55.00000000000001,Unisex
Justice,1997,1482,680,802,45.88394062078272,54.11605937921728,Unisex
Errin,1997,22,14,8,63.63636363636363,36.36363636363637,Unisex
Farrell,1997,25,5,20,20.0,80.0,Unisex
Sinclair,1997,22,12,10,54.54545454545454,45.45454545454545,Unisex
Reda,1997,12,6,6,50.0,50.0,Unisex
Jordan,1997,21927,7166,14761,32.6811693346103,67.31883066538971,Unisex
Torre,1997,29,9,20,31.03448275862069,68.96551724137932,Unisex
Lavern,1997,16,6,10,37.5,62.5,Unisex
Alaa,1997,40,28,12,70.0,30.0,Unisex
Yani,1997,10,5,5,50.0,50.0,Unisex
Dakotah,1997,222,69,153,31.08108108108108,68.91891891891892,Unisex
Lou,1997,21,7,14,33.33333333333333,66.66666666666666,Unisex
Megyn,1998,23,23,0,100.0,0.0,Female
Fay,1998,19,19,0,100.0,0.0,Female
Jannet,1998,35,35,0,100.0,0.0,Female
Acie,1998,7,0,7,0.0,100.0,Male
Idris,1998,44,0,44,0.0,100.0,Male
Jasen,1998,52,0,52,0.0,100.0,Male
Sawyer,1998,489,60,429,12.269938650306749,87.73006134969326,Male
Lukas,1998,630,0,630,0.0,100.0,Male
Ivo,1998,9,0,9,0.0,100.0,Male
Greggory,1998,55,0,55,0.0,100.0,Male
Neema,1998,19,12,7,63.1578947368421,36.84210526315789,Unisex
Montana,1998,678,496,182,73.15634218289085,26.843657817109147,Unisex
Jonell,1998,13,8,5,61.53846153846154,38.46153846153847,Unisex
Noell,1998,12,7,5,58.333333333333336,41.66666666666667,Unisex
Tal,1998,38,13,25,34.21052631578947,65.78947368421053,Unisex
Tristyn,1998,127,76,51,59.84251968503938,40.15748031496063,Unisex
Evon,1998,16,8,8,50.0,50.0,Unisex
Mc,1998,27,19,8,70.37037037037037,29.629629629629623,Unisex
Ying,1998,13,8,5,61.53846153846154,38.46153846153847,Unisex
Yan,1998,16,7,9,43.75,56.25,Unisex
Tracy,1998,546,346,200,63.369963369963365,36.63003663003663,Unisex
Chaney,1998,65,42,23,64.61538461538461,35.38461538461539,Unisex
Teal,1998,23,17,6,73.91304347826086,26.08695652173913,Unisex
Margie,1999,32,32,0,100.0,0.0,Female
Zareen,1999,9,9,0,100.0,0.0,Female
Rita,1999,228,228,0,100.0,0.0,Female
Carleton,1999,15,0,15,0.0,100.0,Male
Christo,1999,5,0,5,0.0,100.0,Male
Sulaiman,1999,19,0,19,0.0,100.0,Male
Nashon,1999,11,0,11,0.0,100.0,Male
Karry,1999,13,8,5,61.53846153846154,38.46153846153847,Unisex
Holland,1999,121,101,20,83.47107438016529,16.528925619834713,Unisex
Jonnie,1999,26,19,7,73.07692307692307,26.923076923076923,Unisex
Tory,1999,160,77,83,48.125,51.87500000000001,Unisex
Ayan,1999,38,26,12,68.42105263157895,31.57894736842105,Unisex
Salem,1999,76,41,35,53.94736842105263,46.05263157894737,Unisex
Tajae,1999,43,27,16,62.7906976744186,37.2093023255814,Unisex
Terrian,1999,17,6,11,35.294117647058826,64.70588235294117,Unisex
Lupe,1999,19,13,6,68.42105263157895,31.57894736842105,Unisex
Pasha,1999,15,8,7,53.333333333333336,46.66666666666666,Unisex
Dannie,1999,54,18,36,33.33333333333333,66.66666666666666,Unisex
Kelcey,1999,67,54,13,80.59701492537313,19.402985074626866,Unisex
Drue,1999,50,26,24,52.0,48.0,Unisex
Ingrid,2000,257,257,0,100.0,0.0,Female
Victory,2000,13,13,0,100.0,0.0,Female
Hasani,2000,34,0,34,0.0,100.0,Male
Carson,2000,3616,377,3239,10.425884955752212,89.57411504424779,Male
Marcoantonio,2000,71,0,71,0.0,100.0,Male
Jackson,2000,5918,15,5903,0.2534640081108483,99.74653599188916,Male
Shraga,2000,10,0,10,0.0,100.0,Male
Roy,2000,638,0,638,0.0,100.0,Male
Najae,2000,37,29,8,78.37837837837837,21.62162162162162,Unisex
Kymani,2000,76,17,59,22.36842105263158,77.63157894736842,Unisex
Anmol,2000,39,25,14,64.1025641025641,35.8974358974359,Unisex
Aris,2000,75,30,45,40.0,60.0,Unisex
Finley,2000,55,17,38,30.909090909090907,69.0909090909091,Unisex
Kasen,2000,58,9,49,15.517241379310343,84.48275862068965,Unisex
Nakia,2000,156,127,29,81.41025641025641,18.58974358974359,Unisex
Gentry,2000,60,25,35,41.66666666666667,58.333333333333336,Unisex
Arlen,2000,49,26,23,53.06122448979592,46.93877551020408,Unisex
Jai,2000,132,35,97,26.51515151515152,73.48484848484848,Unisex
Mychal,2000,21,7,14,33.33333333333333,66.66666666666666,Unisex
Marlyn,2000,56,47,9,83.92857142857143,16.071428571428573,Unisex
Joan,2000,333,163,170,48.94894894894895,51.051051051051054,Unisex
Torrey,2000,73,29,44,39.72602739726028,60.273972602739725,Unisex
Torian,2000,45,9,36,20.0,80.0,Unisex
Trinity,2001,4587,4481,106,97.68912143012862,2.310878569871376,Female
Shayda,2001,6,6,0,100.0,0.0,Female
Marty,2001,78,9,69,11.538461538461538,88.46153846153845,Male
Dravin,2001,16,0,16,0.0,100.0,Male
Reza,2001,13,0,13,0.0,100.0,Male
Tejay,2001,7,0,7,0.0,100.0,Male
Jesie,2001,5,0,5,0.0,100.0,Male
Bodie,2001,29,0,29,0.0,100.0,Male
Lynn,2001,180,153,27,85.0,15.0,Unisex
Jaidyn,2001,263,217,46,82.50950570342205,17.490494296577946,Unisex
Sully,2001,20,5,15,25.0,75.0,Unisex
Haiden,2001,101,34,67,33.663366336633665,66.33663366336634,Unisex
Samar,2001,33,17,16,51.51515151515152,48.48484848484848,Unisex
Brittan,2001,36,22,14,61.11111111111112,38.88888888888889,Unisex
Sidney,2001,1368,1053,315,76.97368421052632,23.026315789473685,Unisex
Ricki,2001,80,68,12,85.0,15.0,Unisex
Stevie,2001,236,173,63,73.30508474576271,26.69491525423729,Unisex
Rand,2001,13,5,8,38.46153846153847,61.53846153846154,Unisex
Makiah,2001,115,97,18,84.34782608695653,15.65217391304348,Unisex
Auburn,2001,32,26,6,81.25,18.75,Unisex
Deedra,2002,14,14,0,100.0,0.0,Female
Shayra,2002,8,8,0,100.0,0.0,Female
Marili,2002,7,7,0,100.0,0.0,Female
Alfred,2002,284,0,284,0.0,100.0,Male
Marcoantonio,2002,64,0,64,0.0,100.0,Male
Naveed,2002,16,0,16,0.0,100.0,Male
Jonte,2002,26,0,26,0.0,100.0,Male
Christo,2002,10,0,10,0.0,100.0,Male
Lennie,2002,12,5,7,41.66666666666667,58.333333333333336,Unisex
Phelan,2002,19,7,12,36.84210526315789,63.1578947368421,Unisex
Lior,2002,18,8,10,44.44444444444444,55.55555555555556,Unisex
Torre,2002,26,15,11,57.692307692307686,42.30769230769231,Unisex
Azariah,2002,153,107,46,69.93464052287581,30.065359477124183,Unisex
Ariel,2002,1989,1548,441,77.82805429864254,22.171945701357465,Unisex
Jerri,2002,25,17,8,68.0,32.0,Unisex
Milan,2002,228,130,98,57.01754385964912,42.98245614035088,Unisex
Trysten,2002,81,20,61,24.69135802469136,75.30864197530865,Unisex
Samar,2002,38,26,12,68.42105263157895,31.57894736842105,Unisex
Tien,2002,37,17,20,45.94594594594595,54.054054054054056,Unisex
Mckay,2002,91,17,74,18.68131868131868,81.31868131868131,Unisex
Takoda,2002,51,10,41,19.607843137254903,80.3921568627451,Unisex
Madaline,2003,71,71,0,100.0,0.0,Female
Aerin,2003,29,29,0,100.0,0.0,Female
Audie,2003,19,0,19,0.0,100.0,Male
Carlito,2003,24,0,24,0.0,100.0,Male
Nicklos,2003,7,0,7,0.0,100.0,Male
Wendell,2003,90,0,90,0.0,100.0,Male
Demone,2003,7,0,7,0.0,100.0,Male
Arick,2003,23,0,23,0.0,100.0,Male
Joon,2003,16,0,16,0.0,100.0,Male
Rylin,2003,39,15,24,38.46153846153847,61.53846153846154,Unisex
Sammie,2003,47,17,30,36.17021276595745,63.82978723404256,Unisex
Bela,2003,28,21,7,75.0,25.0,Unisex
Mana,2003,24,19,5,79.16666666666666,20.833333333333336,Unisex
Devan,2003,612,93,519,15.196078431372548,84.80392156862744,Unisex
Lorenza,2003,29,21,8,72.41379310344827,27.58620689655172,Unisex
Onyx,2003,29,12,17,41.37931034482759,58.620689655172406,Unisex
Natividad,2003,18,9,9,50.0,50.0,Unisex
Haven,2003,574,462,112,80.48780487804879,19.51219512195122,Unisex
Adair,2003,79,14,65,17.72151898734177,82.27848101265823,Unisex
Merlin,2003,74,30,44,40.54054054054054,59.45945945945946,Unisex
Arley,2003,22,12,10,54.54545454545454,45.45454545454545,Unisex
Jammie,2003,21,15,6,71.42857142857143,28.57142857142857,Unisex
Annalise,2004,351,351,0,100.0,0.0,Female
Kristine,2004,212,212,0,100.0,0.0,Female
Deedra,2004,5,5,0,100.0,0.0,Female
Jayvion,2004,79,0,79,0.0,100.0,Male
Issak,2004,25,0,25,0.0,100.0,Male
Angel,2004,12129,2614,9515,21.55165306290708,78.44834693709292,Unisex
Skylar,2004,2713,2176,537,80.20641356431994,19.79358643568006,Unisex
Terrian,2004,15,5,10,33.33333333333333,66.66666666666666,Unisex
Amari,2004,1334,696,638,52.17391304347826,47.82608695652174,Unisex
Yan,2004,31,5,26,16.129032258064516,83.87096774193549,Unisex
Neema,2004,17,12,5,70.58823529411765,29.411764705882355,Unisex
Britain,2004,33,17,16,51.51515151515152,48.48484848484848,Unisex
Ryley,2004,329,165,164,50.15197568389058,49.848024316109424,Unisex
Mikell,2004,45,11,34,24.444444444444443,75.55555555555556,Unisex
Dominque,2004,56,26,30,46.42857142857143,53.57142857142857,Unisex
Karry,2004,10,5,5,50.0,50.0,Unisex
Harper,2004,351,274,77,78.06267806267806,21.937321937321936,Unisex
Edlyn,2005,10,10,0,100.0,0.0,Female
Petrina,2005,6,6,0,100.0,0.0,Female
Elinor,2005,65,65,0,100.0,0.0,Female
Antonina,2005,28,28,0,100.0,0.0,Female
Omega,2005,11,0,11,0.0,100.0,Male
Wiliam,2005,8,0,8,0.0,100.0,Male
Zakari,2005,26,0,26,0.0,100.0,Male
Demetric,2005,31,0,31,0.0,100.0,Male
Xavian,2005,61,0,61,0.0,100.0,Male
Walter,2005,770,0,770,0.0,100.0,Male
Marvel,2005,11,0,11,0.0,100.0,Male
Takoda,2005,68,7,61,10.294117647058822,89.70588235294117,Male
Jae,2005,50,18,32,36.0,64.0,Unisex
Nicky,2005,50,21,29,42.0,57.99999999999999,Unisex
Alaa,2005,37,31,6,83.78378378378379,16.216216216216218,Unisex
Kirin,2005,26,14,12,53.84615384615385,46.15384615384615,Unisex
Skyler,2005,2422,1019,1403,42.07266721717588,57.92733278282412,Unisex
Diamante,2005,20,10,10,50.0,50.0,Unisex
Reda,2005,19,8,11,42.10526315789473,57.89473684210527,Unisex
Jin,2005,50,11,39,22.0,78.0,Unisex
Clancy,2005,30,10,20,33.33333333333333,66.66666666666666,Unisex
Alyx,2005,30,25,5,83.33333333333334,16.666666666666664,Unisex
Aamari,2005,10,5,5,50.0,50.0,Unisex
Rylin,2005,77,41,36,53.24675324675325,46.75324675324675,Unisex
Jezreel,2005,31,15,16,48.38709677419355,51.61290322580645,Unisex
Avion,2005,99,18,81,18.181818181818183,81.81818181818183,Unisex
Torrey,2005,47,17,30,36.17021276595745,63.82978723404256,Unisex
Tracey,2005,73,55,18,75.34246575342466,24.65753424657534,Unisex
Garnet,2005,14,9,5,64.28571428571429,35.714285714285715,Unisex
Zyon,2005,136,34,102,25.0,75.0,Unisex
Toria,2006,14,14,0,100.0,0.0,Female
Ophelia,2006,47,47,0,100.0,0.0,Female
Shanta,2006,6,6,0,100.0,0.0,Female
Marigold,2006,9,9,0,100.0,0.0,Female
Bruna,2006,17,17,0,100.0,0.0,Female
Leianna,2006,24,24,0,100.0,0.0,Female
Kasen,2006,219,6,213,2.73972602739726,97.26027397260276,Male
Khristian,2006,98,9,89,9.183673469387756,90.81632653061224,Male
Willie,2006,507,0,507,0.0,100.0,Male
Noell,2006,15,8,7,53.333333333333336,46.66666666666666,Unisex
Ryley,2006,297,141,156,47.474747474747474,52.52525252525253,Unisex
Tajae,2006,23,12,11,52.17391304347826,47.82608695652174,Unisex
Elia,2006,115,96,19,83.47826086956522,16.52173913043478,Unisex
Riley,2006,9452,5056,4396,53.49132458738891,46.50867541261109,Unisex
Arie,2006,54,31,23,57.407407407407405,42.5925925925926,Unisex
Azariah,2006,274,199,75,72.62773722627736,27.37226277372263,Unisex
Lael,2006,50,42,8,84.0,16.0,Unisex
Zakari,2006,31,8,23,25.806451612903224,74.19354838709677,Unisex
Trystin,2006,53,16,37,30.18867924528302,69.81132075471697,Unisex
Talyn,2006,156,70,86,44.87179487179488,55.12820512820513,Unisex
Elon,2006,47,20,27,42.5531914893617,57.44680851063831,Unisex
Sevilla,2007,8,8,0,100.0,0.0,Female
Bette,2007,6,6,0,100.0,0.0,Female
Spirit,2007,38,38,0,100.0,0.0,Female
Geo,2007,8,0,8,0.0,100.0,Male
Greggory,2007,18,0,18,0.0,100.0,Male
Hameed,2007,5,0,5,0.0,100.0,Male
Emory,2007,330,178,152,53.939393939393945,46.06060606060606,Unisex
Merlin,2007,68,25,43,36.76470588235294,63.23529411764706,Unisex
Naziah,2007,30,21,9,70.0,30.0,Unisex
Kit,2007,14,6,8,42.85714285714285,57.14285714285714,Unisex
Shilo,2007,47,33,14,70.2127659574468,29.78723404255319,Unisex
Neftali,2007,81,21,60,25.925925925925924,74.07407407407408,Unisex
Ariel,2007,2303,1782,521,77.37733391228832,22.62266608771168,Unisex
Micha,2007,58,22,36,37.93103448275862,62.06896551724138,Unisex
Kirby,2007,84,20,64,23.809523809523807,76.19047619047619,Unisex
Braylyn,2007,43,26,17,60.46511627906976,39.53488372093023,Unisex
Trystin,2007,65,15,50,23.07692307692308,76.92307692307693,Unisex
Jerusalem,2007,17,12,5,70.58823529411765,29.411764705882355,Unisex
Jody,2007,141,40,101,28.368794326241137,71.63120567375887,Unisex
Jayd,2007,18,13,5,72.22222222222221,27.77777777777778,Unisex
Caylen,2007,47,31,16,65.95744680851064,34.04255319148936,Unisex
Romie,2007,12,6,6,50.0,50.0,Unisex
Jerri,2007,21,15,6,71.42857142857143,28.57142857142857,Unisex
Mel,2007,24,10,14,41.66666666666667,58.333333333333336,Unisex
Haya,2008,47,47,0,100.0,0.0,Female
Bodie,2008,138,0,138,0.0,100.0,Male
Guy,2008,163,0,163,0.0,100.0,Male
Ardell,2008,6,0,6,0.0,100.0,Male
Noam,2008,98,8,90,8.16326530612245,91.83673469387756,Male
Zia,2008,86,71,15,82.55813953488372,17.441860465116278,Unisex
Aidyn,2008,408,71,337,17.401960784313726,82.59803921568627,Unisex
Jayd,2008,17,9,8,52.94117647058824,47.05882352941176,Unisex
Maycen,2008,11,6,5,54.54545454545454,45.45454545454545,Unisex
Averey,2008,23,15,8,65.21739130434783,34.78260869565217,Unisex
Najae,2008,34,25,9,73.52941176470588,26.47058823529412,Unisex
Mikah,2008,184,43,141,23.369565217391305,76.63043478260869,Unisex
Parris,2008,51,34,17,66.66666666666666,33.33333333333333,Unisex
Phoenix,2008,1168,425,743,36.38698630136986,63.61301369863014,Unisex
Kriston,2008,23,7,16,30.434782608695656,69.56521739130434,Unisex
Stevie,2008,217,176,41,81.10599078341014,18.89400921658986,Unisex
Brandis,2008,14,9,5,64.28571428571429,35.714285714285715,Unisex
Dakotah,2008,136,70,66,51.47058823529412,48.52941176470589,Unisex
Juliana,2009,2074,2074,0,100.0,0.0,Female
Leonor,2009,29,29,0,100.0,0.0,Female
Kassidy,2009,720,706,14,98.05555555555556,1.9444444444444444,Female
Terrell,2009,451,0,451,0.0,100.0,Male
Neftali,2009,79,15,64,18.9873417721519,81.0126582278481,Unisex
Kodi,2009,137,73,64,53.28467153284672,46.71532846715328,Unisex
Baby,2009,42,26,16,61.90476190476191,38.095238095238095,Unisex
Dakota,2009,2579,1195,1384,46.33578906552928,53.66421093447072,Unisex
Kaylan,2009,149,119,30,79.86577181208054,20.13422818791946,Unisex
Kirin,2009,25,6,19,24.0,76.0,Unisex
Jayme,2009,163,127,36,77.91411042944786,22.085889570552148,Unisex
Autry,2009,11,6,5,54.54545454545454,45.45454545454545,Unisex
Indigo,2009,88,68,20,77.27272727272727,22.727272727272727,Unisex
Frankie,2009,451,129,322,28.60310421286031,71.3968957871397,Unisex
Karel,2009,26,9,17,34.61538461538461,65.38461538461539,Unisex
Shadow,2009,16,8,8,50.0,50.0,Unisex
Allyn,2009,30,15,15,50.0,50.0,Unisex
Dione,2009,14,6,8,42.85714285714285,57.14285714285714,Unisex
Nelia,2010,17,17,0,100.0,0.0,Female
Thalia,2010,272,272,0,100.0,0.0,Female
Amadeo,2010,18,0,18,0.0,100.0,Male
Ronaldo,2010,204,0,204,0.0,100.0,Male
Tristyn,2010,245,106,139,43.26530612244898,56.734693877551024,Unisex
Lorenza,2010,25,18,7,72.0,28.000000000000004,Unisex
Arie,2010,101,64,37,63.366336633663366,36.63366336633664,Unisex
Emrys,2010,16,7,9,43.75,56.25,Unisex
Elan,2010,135,26,109,19.25925925925926,80.74074074074075,Unisex
Merrill,2010,22,10,12,45.45454545454545,54.54545454545454,Unisex
Zyon,2010,185,33,152,17.83783783783784,82.16216216216216,Unisex
Mylin,2010,24,15,9,62.5,37.5,Unisex
Damoni,2010,58,23,35,39.6551724137931,60.3448275862069,Unisex
Yan,2010,32,5,27,15.625,84.375,Unisex
Maycen,2010,14,6,8,42.85714285714285,57.14285714285714,Unisex
Greer,2010,75,53,22,70.66666666666667,29.33333333333333,Unisex
Robin,2010,266,158,108,59.3984962406015,40.6015037593985,Unisex
Jodie,2010,64,49,15,76.5625,23.4375,Unisex
Averey,2010,30,16,14,53.333333333333336,46.66666666666666,Unisex
Quinlan,2010,137,48,89,35.03649635036496,64.96350364963503,Unisex
Nica,2011,7,7,0,100.0,0.0,Female
Oluwatomisin,2011,9,9,0,100.0,0.0,Female
Timiyah,2011,15,15,0,100.0,0.0,Female
Junior,2011,285,0,285,0.0,100.0,Male
Jermiah,2011,122,0,122,0.0,100.0,Male
Keilon,2011,13,0,13,0.0,100.0,Male
Raynaldo,2011,6,0,6,0.0,100.0,Male
Jordan,2011,9726,1637,8089,16.83117417232161,83.16882582767839,Unisex
Haiden,2011,291,86,205,29.553264604811,70.44673539518901,Unisex
Kris,2011,70,15,55,21.428571428571427,78.57142857142857,Unisex
Alix,2011,55,38,17,69.0909090909091,30.909090909090907,Unisex
Lucky,2011,55,13,42,23.63636363636364,76.36363636363637,Unisex
Islam,2011,21,5,16,23.809523809523807,76.19047619047619,Unisex
Alika,2011,31,26,5,83.87096774193549,16.129032258064516,Unisex
Ira,2011,156,46,110,29.48717948717949,70.51282051282051,Unisex
Shade,2011,27,9,18,33.33333333333333,66.66666666666666,Unisex
Zen,2011,76,13,63,17.105263157894736,82.89473684210526,Unisex
Regan,2011,338,277,61,81.95266272189349,18.04733727810651,Unisex
Elisha,2011,450,139,311,30.88888888888889,69.11111111111111,Unisex
Hayley,2012,678,678,0,100.0,0.0,Female
Marika,2012,21,21,0,100.0,0.0,Female
Ileana,2012,81,81,0,100.0,0.0,Female
Sheree,2012,10,10,0,100.0,0.0,Female
Reza,2012,17,0,17,0.0,100.0,Male
Sadler,2012,8,0,8,0.0,100.0,Male
Jeffery,2012,373,0,373,0.0,100.0,Male
Timmie,2012,7,0,7,0.0,100.0,Male
Giovanni,2012,3104,13,3091,0.4188144329896907,99.58118556701032,Male
Mikhail,2012,124,0,124,0.0,100.0,Male
Jan,2012,115,8,107,6.956521739130435,93.04347826086956,Male
Kodi,2012,131,87,44,66.41221374045801,33.587786259541986,Unisex
Oakley,2012,429,189,240,44.05594405594406,55.94405594405595,Unisex
Yuri,2012,102,61,41,59.80392156862745,40.19607843137255,Unisex
Jona,2012,33,18,15,54.54545454545454,45.45454545454545,Unisex
Mayan,2012,23,12,11,52.17391304347826,47.82608695652174,Unisex
Alexius,2012,19,14,5,73.68421052631578,26.31578947368421,Unisex
Peyton,2012,6551,4476,2075,68.32544649671806,31.674553503281945,Unisex
Dee,2012,19,7,12,36.84210526315789,63.1578947368421,Unisex
Lorenza,2013,19,19,0,100.0,0.0,Female
Kendyl,2013,243,236,7,97.119341563786,2.880658436213992,Female
Janeice,2013,6,6,0,100.0,0.0,Female
Noble,2013,121,7,114,5.785123966942149,94.21487603305783,Male
Merle,2013,16,0,16,0.0,100.0,Male
Ferrell,2013,7,0,7,0.0,100.0,Male
Francisco,2013,1700,0,1700,0.0,100.0,Male
Maddix,2013,133,17,116,12.781954887218044,87.21804511278195,Male
Clifton,2013,110,0,110,0.0,100.0,Male
Natanael,2013,50,0,50,0.0,100.0,Male
Islam,2013,19,0,19,0.0,100.0,Male
Khris,2013,13,0,13,0.0,100.0,Male
Kimi,2013,44,21,23,47.72727272727273,52.27272727272727,Unisex
Patrice,2013,34,28,6,82.35294117647058,17.647058823529413,Unisex
Dempsey,2013,114,37,77,32.45614035087719,67.54385964912281,Unisex
Echo,2013,80,66,14,82.5,17.5,Unisex
Temple,2013,29,24,5,82.75862068965517,17.24137931034483,Unisex
Mylin,2013,15,6,9,40.0,60.0,Unisex
Jessy,2013,85,32,53,37.64705882352941,62.35294117647059,Unisex
Makiah,2013,93,79,14,84.94623655913979,15.053763440860216,Unisex
Noell,2013,13,8,5,61.53846153846154,38.46153846153847,Unisex
Anmol,2013,29,7,22,24.13793103448276,75.86206896551724,Unisex
Berkley,2013,284,234,50,82.3943661971831,17.6056338028169,Unisex
Kaylan,2013,77,62,15,80.51948051948052,19.480519480519483,Unisex
Deni,2013,11,6,5,54.54545454545454,45.45454545454545,Unisex
Emrys,2013,76,16,60,21.052631578947366,78.94736842105263,Unisex
Riley,2013,7497,4939,2558,65.8796852074163,34.1203147925837,Unisex
Madeline,2014,3444,3444,0,100.0,0.0,Female
Pheobe,2014,21,21,0,100.0,0.0,Female
Madaline,2014,42,42,0,100.0,0.0,Female
Milagros,2014,169,169,0,100.0,0.0,Female
Ethelyn,2014,5,5,0,100.0,0.0,Female
Karmon,2014,6,6,0,100.0,0.0,Female
Larence,2014,6,0,6,0.0,100.0,Male
Lukas,2014,1633,0,1633,0.0,100.0,Male
Tejay,2014,5,0,5,0.0,100.0,Male
Cardell,2014,21,0,21,0.0,100.0,Male
Creighton,2014,60,0,60,0.0,100.0,Male
Jewell,2014,60,49,11,81.66666666666667,18.33333333333333,Unisex
Dannie,2014,38,24,14,63.1578947368421,36.84210526315789,Unisex
Schuyler,2014,32,17,15,53.125,46.875,Unisex
Indigo,2014,145,111,34,76.55172413793103,23.448275862068964,Unisex
Bentlie,2014,16,9,7,56.25,43.75,Unisex
Tracey,2014,47,39,8,82.97872340425532,17.02127659574468,Unisex
Arlyn,2014,45,35,10,77.77777777777779,22.22222222222222,Unisex
Arien,2014,38,13,25,34.21052631578947,65.78947368421053,Unisex
Blessed,2014,15,9,6,60.0,40.0,Unisex
Wynn,2014,108,48,60,44.44444444444444,55.55555555555556,Unisex
Aki,2014,12,5,7,41.66666666666667,58.333333333333336,Unisex
Jonni,2014,13,8,5,61.53846153846154,38.46153846153847,Unisex
Jalyn,2014,92,64,28,69.56521739130434,30.434782608695656,Unisex
Haya,2015,69,69,0,100.0,0.0,Female
Vera,2015,1052,1052,0,100.0,0.0,Female
Kadi,2015,11,11,0,100.0,0.0,Female
Marine,2015,6,6,0,100.0,0.0,Female
Garry,2015,26,0,26,0.0,100.0,Male
Trenell,2015,5,0,5,0.0,100.0,Male
Jacobi,2015,142,6,136,4.225352112676056,95.77464788732394,Male
Marzell,2015,6,0,6,0.0,100.0,Male
Sanay,2015,9,0,9,0.0,100.0,Male
Zvi,2015,7,0,7,0.0,100.0,Male
Oluwatamilore,2015,28,19,9,67.85714285714286,32.142857142857146,Unisex
Gray,2015,186,45,141,24.193548387096776,75.80645161290323,Unisex
Scottie,2015,62,44,18,70.96774193548387,29.03225806451613,Unisex
Shai,2015,81,31,50,38.2716049382716,61.72839506172839,Unisex
Jeriah,2015,70,13,57,18.571428571428573,81.42857142857143,Unisex
Indy,2015,76,46,30,60.526315789473685,39.47368421052632,Unisex
Sawyer,2015,5490,1220,4270,22.22222222222222,77.77777777777779,Unisex
Bentlie,2015,14,7,7,50.0,50.0,Unisex
Kree,2015,72,37,35,51.388888888888886,48.61111111111111,Unisex
Rain,2015,128,94,34,73.4375,26.5625,Unisex
Kapri,2016,45,45,0,100.0,0.0,Female
Kyna,2016,17,17,0,100.0,0.0,Female
Megyn,2016,9,9,0,100.0,0.0,Female
Tonya,2016,18,18,0,100.0,0.0,Female
Amadeo,2016,34,0,34,0.0,100.0,Male
Johny,2016,24,0,24,0.0,100.0,Male
Yisrael,2016,68,0,68,0.0,100.0,Male
Bertrand,2016,11,0,11,0.0,100.0,Male
Jayvion,2016,185,0,185,0.0,100.0,Male
Xavian,2016,64,0,64,0.0,100.0,Male
Lawrence,2016,614,0,614,0.0,100.0,Male
Yonis,2016,12,0,12,0.0,100.0,Male
Hugo,2016,722,0,722,0.0,100.0,Male
Eli,2016,7155,33,7122,0.4612159329140461,99.53878406708596,Male
Aidan,2016,2133,20,2113,0.9376465072667604,99.06235349273324,Male
Gilbert,2016,214,0,214,0.0,100.0,Male
Shraga,2016,32,0,32,0.0,100.0,Male
Elie,2016,54,16,38,29.629629629629623,70.37037037037037,Unisex
Aamari,2016,20,5,15,25.0,75.0,Unisex
Kaidence,2016,237,194,43,81.85654008438819,18.14345991561181,Unisex
Blessed,2016,24,13,11,54.16666666666666,45.83333333333333,Unisex
Aris,2016,141,56,85,39.71631205673759,60.28368794326241,Unisex
Jaylin,2016,389,244,145,62.724935732647815,37.275064267352185,Unisex
Yani,2016,21,14,7,66.66666666666666,33.33333333333333,Unisex
Gentry,2016,207,110,97,53.14009661835749,46.85990338164252,Unisex
Victory,2016,64,48,16,75.0,25.0,Unisex
Tristyn,2016,146,55,91,37.67123287671233,62.32876712328768,Unisex
Mika,2016,231,183,48,79.22077922077922,20.77922077922078,Unisex
Yuri,2016,147,92,55,62.58503401360544,37.41496598639456,Unisex
Kiran,2016,138,33,105,23.91304347826087,76.08695652173914,Unisex
Brandyn,2016,38,9,29,23.684210526315788,76.31578947368422,Unisex
Wallis,2017,8,8,0,100.0,0.0,Female
Kateri,2017,48,48,0,100.0,0.0,Female
Foster,2017,239,16,223,6.694560669456067,93.30543933054392,Male
Yonis,2017,20,0,20,0.0,100.0,Male
Jakob,2017,404,0,404,0.0,100.0,Male
Len,2017,8,0,8,0.0,100.0,Male
Freddie,2017,77,0,77,0.0,100.0,Male
Kodi,2017,175,95,80,54.285714285714285,45.71428571428572,Unisex
Alexius,2017,14,8,6,57.14285714285714,42.85714285714285,Unisex
Honest,2017,36,29,7,80.55555555555556,19.444444444444446,Unisex
Jaylin,2017,381,237,144,62.20472440944882,37.79527559055118,Unisex
Joan,2017,300,128,172,42.66666666666667,57.333333333333336,Unisex
Haru,2017,29,9,20,31.03448275862069,68.96551724137932,Unisex
Jacky,2017,34,7,27,20.588235294117645,79.41176470588235,Unisex
Larkin,2017,152,96,56,63.1578947368421,36.84210526315789,Unisex
Amari,2017,2070,748,1322,36.135265700483096,63.86473429951691,Unisex
Kree,2017,50,24,26,48.0,52.0,Unisex
Jody,2017,66,18,48,27.27272727272727,72.72727272727273,Unisex
Lael,2017,81,59,22,72.8395061728395,27.160493827160494,Unisex
Rylen,2017,212,38,174,17.92452830188679,82.0754716981132,Unisex
Teal,2017,24,15,9,62.5,37.5,Unisex
Jessey,2017,12,5,7,41.66666666666667,58.333333333333336,Unisex
Joline,2018,5,5,0,100.0,0.0,Female
Elizabeth,2018,8588,8588,0,100.0,0.0,Female
Tianna,2018,130,130,0,100.0,0.0,Female
Oluwatomisin,2018,5,5,0,100.0,0.0,Female
Fernanda,2018,630,630,0,100.0,0.0,Female
Adrianne,2018,48,48,0,100.0,0.0,Female
Colman,2018,5,0,5,0.0,100.0,Male
Issak,2018,12,0,12,0.0,100.0,Male
Aldo,2018,266,0,266,0.0,100.0,Male
Forest,2018,220,8,212,3.636363636363636,96.36363636363636,Male
Tully,2018,12,6,6,50.0,50.0,Unisex
Oluwatamilore,2018,30,22,8,73.33333333333333,26.666666666666668,Unisex
Mana,2018,29,22,7,75.86206896551724,24.13793103448276,Unisex
Jaylin,2018,340,211,129,62.05882352941177,37.94117647058823,Unisex
Mahari,2018,40,23,17,57.49999999999999,42.5,Unisex
Naziah,2018,16,8,8,50.0,50.0,Unisex
Onyx,2018,331,77,254,23.26283987915408,76.73716012084593,Unisex
Darby,2018,120,89,31,74.16666666666667,25.833333333333336,Unisex
Aris,2018,145,57,88,39.310344827586206,60.689655172413794,Unisex
Noel,2018,979,191,788,19.5097037793667,80.4902962206333,Unisex
Timiyah,2019,5,5,0,100.0,0.0,Female
Zareen,2019,14,14,0,100.0,0.0,Female
Jonni,2019,7,7,0,100.0,0.0,Female
Keilon,2019,6,0,6,0.0,100.0,Male
Arsalan,2019,21,0,21,0.0,100.0,Male
Fenton,2019,22,0,22,0.0,100.0,Male
Marcial,2019,16,0,16,0.0,100.0,Male
Ollie,2019,237,90,147,37.9746835443038,62.0253164556962,Unisex
Lior,2019,51,11,40,21.5686274509804,78.43137254901961,Unisex
Christen,2019,29,16,13,55.172413793103445,44.82758620689656,Unisex
Mahari,2019,44,27,17,61.36363636363637,38.63636363636363,Unisex
Davi,2019,102,16,86,15.68627450980392,84.31372549019608,Unisex
Jaidyn,2019,165,71,94,43.03030303030303,56.96969696969697,Unisex
Lupe,2019,12,5,7,41.66666666666667,58.333333333333336,Unisex
Echo,2019,118,95,23,80.50847457627118,19.491525423728813,Unisex
Emory,2019,938,652,286,69.5095948827292,30.49040511727079,Unisex
Rivers,2019,130,35,95,26.923076923076923,73.07692307692307,Unisex
Quin,2019,71,30,41,42.25352112676056,57.74647887323944,Unisex
Indiana,2019,190,106,84,55.78947368421052,44.21052631578947,Unisex
Zen,2019,173,45,128,26.011560693641616,73.98843930635837,Unisex
Kimi,2019,31,10,21,32.25806451612903,67.74193548387096,Unisex
Alla,2020,10,10,0,100.0,0.0,Female
Giovanni,2020,3058,13,3045,0.4251144538914323,99.57488554610858,Male
Arafat,2020,12,0,12,0.0,100.0,Male
Delfino,2020,13,0,13,0.0,100.0,Male
Sadler,2020,9,0,9,0.0,100.0,Male
Nashon,2020,7,0,7,0.0,100.0,Male
Keone,2020,5,0,5,0.0,100.0,Male
Ferris,2020,41,6,35,14.634146341463412,85.36585365853658,Male
Sanay,2020,5,0,5,0.0,100.0,Male
Chesley,2020,17,5,12,29.411764705882355,70.58823529411765,Unisex
Rui,2020,37,7,30,18.91891891891892,81.08108108108108,Unisex
Honest,2020,44,24,20,54.54545454545454,45.45454545454545,Unisex
Kapri,2020,142,120,22,84.50704225352112,15.492957746478872,Unisex
Braylyn,2020,63,31,32,49.2063492063492,50.79365079365079,Unisex
Emrys,2020,110,26,84,23.63636363636364,76.36363636363637,Unisex
Spirit,2020,28,22,6,78.57142857142857,21.428571428571427,Unisex
Altair,2020,17,8,9,47.05882352941176,52.94117647058824,Unisex
Sully,2020,30,9,21,30.0,70.0,Unisex
Alika,2020,25,14,11,56.00000000000001,44.0,Unisex
Macie,2021,595,595,0,100.0,0.0,Female
Ivey,2021,149,144,5,96.64429530201345,3.355704697986577,Female
Carmin,2021,6,6,0,100.0,0.0,Female
Wynter,2021,943,925,18,98.09119830328738,1.90880169671262,Female
Macy,2021,468,468,0,100.0,0.0,Female
Dravin,2021,8,0,8,0.0,100.0,Male
Santos,2021,273,0,273,0.0,100.0,Male
Hezekiah,2021,491,0,491,0.0,100.0,Male
Richie,2021,65,0,65,0.0,100.0,Male
Tristian,2021,128,0,128,0.0,100.0,Male
Seth,2021,602,0,602,0.0,100.0,Male
Marvelle,2021,7,0,7,0.0,100.0,Male
Kree,2021,103,31,72,30.097087378640776,69.90291262135922,Unisex
Indiana,2021,186,112,74,60.215053763440864,39.784946236559136,Unisex
Carmel,2021,19,13,6,68.42105263157895,31.57894736842105,Unisex
Stirling,2021,21,8,13,38.095238095238095,61.90476190476191,Unisex
Damoni,2021,115,24,91,20.869565217391305,79.13043478260869,Unisex
Rylen,2021,173,32,141,18.4971098265896,81.5028901734104,Unisex
Altair,2021,24,5,19,20.833333333333336,79.16666666666666,Unisex
Reese,2021,2264,1889,375,83.43639575971731,16.563604240282686,Unisex
Diamante,2021,14,5,9,35.714285714285715,64.28571428571429,Unisex
Jaye,2021,28,15,13,53.57142857142857,46.42857142857143,Unisex
Noel,2021,960,176,784,18.33333333333333,81.66666666666667,Unisex
Codie,2021,35,29,6,82.85714285714286,17.142857142857142,Unisex
Jaylin,2021,372,257,115,69.08602150537635,30.913978494623656,Unisex
Maddix,2021,83,15,68,18.072289156626507,81.92771084337349,Unisex
Ella,2022,6243,6243,0,100.0,0.0,Female
Shayra,2022,8,8,0,100.0,0.0,Female
Shayda,2022,5,5,0,100.0,0.0,Female
Florina,2022,8,8,0,100.0,0.0,Female
Elvie,2022,34,34,0,100.0,0.0,Female
Darnell,2022,95,0,95,0.0,100.0,Male
Franz,2022,11,0,11,0.0,100.0,Male
Antwain,2022,9,0,9,0.0,100.0,Male
Merlin,2022,59,11,48,18.64406779661017,81.35593220338984,Unisex
Amani,2022,604,513,91,84.93377483443709,15.066225165562914,Unisex
Mayan,2022,56,32,24,57.14285714285714,42.85714285714285,Unisex
Arin,2022,109,32,77,29.357798165137616,70.64220183486239,Unisex
Kaidence,2022,83,52,31,62.65060240963856,37.34939759036144,Unisex
Jerusalem,2022,16,8,8,50.0,50.0,Unisex
Merritt,2022,216,138,78,63.888888888888886,36.11111111111111,Unisex
Aidyn,2022,102,16,86,15.68627450980392,84.31372549019608,Unisex
Alyx,2022,25,17,8,68.0,32.0,Unisex
Cayce,2022,27,10,17,37.03703703703704,62.96296296296296,Unisex
